Nicolaus Copernicus|নিক'লাচ ক'পাৰ্নিকাচ
Narendra Modi|নৰেন্দ্ৰ মোডী
Indira Gandhi|ইন্দিৰা গান্ধী
Albrecht Dürer|এলব্ৰেখট ড্যুৰাৰ
Katsushika Hokusai|কাটুশ্বিকা হ'কচাই
Mao Zedong|মাও জে দঙ
Marie Curie|মেডাম কুৰী
Ingmar Bergman|ইংমাৰ বাৰ্গমেন
Archimedes|আৰ্কিমিডিছ
Muhammad|মুহাম্মাদ
A. P. J. Abdul Kalam|এ. পি. জে. আব্দুল কালাম
Salman Rashid Khan|চলমান খান
Harivansh Rai Bachchan|হৰিবংশ ৰায় বচ্চন
Émile Durkheim|ইমাইল ডুৰখেইম
Steve Jobs|ষ্টীভ জব্‌চ
Hermann Hesse|হেৰমান হেস
Taylor Swift|টেইলৰ ছুইফ্ট
Sonali Bendre|সোণালী বেন্দ্ৰে
Malala Yousafzai|মালালা ইউছুফজাই
Benjamin Franklin|বেঞ্জামিন ফ্ৰেংকলিন
Helen Keller|হেলেন কেলাৰ
Edward Jenner|এডৱাৰ্ড জেনাৰ
Daniel Defoe|ডেনিয়েল ডিফো
Genelia D'Souza|জেনেলিয়া ডিছুজা
Abdul Hamid Khan Bhashani|মৌলানা আব্দুল হামিদ খান ভাষাণী
Tenzing Norgay|টেনজিং নৰ্গে
Sidney Sheldon|ছিডনী শ্বেলডন
Mirza Ghalib|মিৰ্জা গালিব
Sania Mirza|ছানিয়া মিৰ্জা
Mahasweta Devi|মহাশ্বেতা দেৱী
Baby Halder|বেবী হালদাৰ
John Bosco|জন বস্ক'
Albert Bandura|এলবাৰ্ট বান্দুৰা
Aruna Irani|অৰুণা ইৰানী
Manoj Bajpai|মনোজ বাজপেয়ী
Robert Frost|ৰবাৰ্ট ফ্ৰ'ষ্ট
Ramakrishna|ৰামকৃষ্ণ পৰমহংস
Preity Zinta|প্ৰীতি জিণ্টা
Amir Khosrow|আমিৰ খশ্ৰু
Bhimrao Ramji Ambedkar|ভীমৰাও ৰামজী আম্বেদকাৰ
Mumtaz Mahal|মমতাজ মহল
Madhuri Dixit|মাধুৰী দীক্ষিত
Atal Bihari Vajpayee|অটল বিহাৰী বাজপায়ী
Lal Bahadur Shastri|লালবাহাদুৰ শাস্ত্ৰী
Syed Ali Ahsan|চৈয়দ আলী আহছান
Kasturba Gandhi|কস্তুৰবা গান্ধী
Paul Robeson|পল ৰ'বচন
Charaka|চৰক
Fakhruddin Ali Ahmed|ফখৰুদ্দিন আলি আহমেদ
Abhimanyu|অভিমন্যু
Satish Dhawan|সতীশ ধৱন
Mary Kom|মেৰী কম
Shruti Haasan|শ্ৰুতি হাচান
Nazrul Islam|কাজী নজৰুল ইছলাম
Bengt Holmström|বেংগেট ৰবাৰ্ট হল্মষ্টৰ্ম
Richard Thaler|ৰিচাৰ্ড থেলাৰ
Motilal Nehru|মতিলাল নেহৰু
Pavel Čmovš|পাভেল ম'ভ্চ
Oliver Hart|অলিভাৰ হাৰ্ট
Soha Ali Khan|চোহা আলী খান
Kira Muratova|কিৰা মুৰাট'ভা
Nayantara Sahgal|নয়নতৰা চেহগল
Saina Nehwal|ছাইনা নেহৱাল
Monica Ali|মনিকা আলী
Meena Kumari|মীনা কুমাৰী
Mira Nair|মীৰা নায়াৰ
Mahadevi Varma|মহাদেৱী বৰ্মা
Noor Jehan|নুৰ জাহান
Asin|আচিন
Lai Pei Jing|Li Pei Jing
Bina Rai|বীণা ৰায়
Nur Jahan|নুৰ জাহান
M. F. Husain|মকবুল ফিদা হুছেইন
Budai|বুদাই
Nawaf Al-Ahmad Al-Jaber Al-Sabah|নাওয়াফ আল-আহমেদ আল-জাবের আল-সাবাহ
Walter Lewin|ৱাল্টাৰ লুইন
Pooja Bhatt|পূজা ভাট
Joi Barua|জয় বৰুৱা
Bala Varman|বল বৰ্মা
Kalyana Varman|কল্যাণ বৰ্মা
Bhuti Varman|ভূতি বৰ্মা
Danielle Barry|Danielle Tahuri
Deepak Mondal|দীপক মণ্ডাল
Dipankar Bhattacharjee|দীপংকৰ ভট্টাচাৰ্য
Chintamani Nagesa Ramachandra Rao|চি এন আৰ ৰাও
Matsyendranath|মৎস্যেন্দ্ৰনাথ
William G. Kaelin|উইলিয়াম কেলিন জুনিয়ৰ
Kalpana Saroj|কল্পনা সৰোজ
Jasimuddin|জসীমউদ্দিন
Silk Smitha|চিল্ক স্মিতা
Lee Mou-Chou|Lee Mou-Chou
Bombayla Devi Laishram|বোম্বাইলা দেৱী লাইশ্ৰাম
Marianne Abrahams|Marianne van der Walt
Susan Cain|ছুছান কেইন
Raghunath Murmu|ৰঘুনাথ মুৰ্মু
Shiraz Minwalla|ছিৰাজ মিনৱালা
Mukesh|মুকেশ
Takuya Takehana|Takuya Takenaka
Sangamitta|সংঘামিত্ৰা
Agnivesa|অগ্নিৱেশ
Pranav Mistry|প্ৰণৱ মিস্ত্ৰী
Yuvraj Singh|যুৱৰাজ সিং
Mohit Chauhan|মোহিত চৌহান
Zoya Akhtar|জয়া আখটাৰ
Shakti Chattopadhyay|শক্তি চট্টোপাধ্যায়
Kamini Roy|কামিনী ৰায়
Ambika Soni|অম্বিকা সোনী
Basudeb Dasgupta|বাসুদেৱ দাসগুপ্ত
Rabindra Guha|ৰবীন্দ্ৰ গুহ
Rani Rashmoni|ৰাণী ৰাসমণি
Uday Shankar|উদয় শংকৰ
Saroj Khan|সৰোজ খান
Nitin Gadkari|নীতিন গাডকাৰী
Jaya Prada|জয়া প্ৰদা
Sucheta Kripalani|সুচেতা কৃপলানী
Mohan Bhagwat|মোহন ভাগৱত
B. Saroja Devi|বি. সৰোজা দেৱী
Rudrama Devi|ৰুদ্ৰমা দেৱী
Prafulla Kumar Mahanta|প্ৰফুল্ল কুমাৰ মহন্ত
Ajan Fakir|আজান ফকীৰ
Mrinal Miri|মৃণাল মিৰি
Malika Pukhraj|মলীকা পোখৰাজ
Krishna Sobti|কৃষ্ণা সোব্‌তি
Kapila Vatsyayan|কপিলা বাৎসায়ন
Barkha Dutt|বৰ্খা দত্ত
Bharati Mukherjee|ভাৰতী মুখাৰ্জী
A. F. Golam Osmani|এ এফ গুলাম ওচমানি
Abhijit Mukherjee|অভিজিত মুখাৰ্জী
Ahmed Sofa|আহমদ ছফা
Aideu Handique|আইদেউ সন্দিকৈ
Alia Bhatt|আলিয়া ভাট
Ananta Kandali|অনন্ত কন্দলী
Angaraag Mahanta|অংগৰাগ মহন্ত
Arjun|অৰ্জুন (ফিৰোজ খান)
Aruni Kashyap|আৰুণি কাশ্যপ
Ashwini Bhide-Deshpande|অশ্বিনী ভিড়ে-দেশপাণ্ডে
Banwarilal Purohit|বানৱাৰীলাল পুৰোহিত
Bhimbor Deori|ভীমবৰ দেউৰী
Bineshwar Brahma|বিনেশ্বৰ ব্ৰহ্ম
Bornali Kalita|বর্ণালী কলিতা
Carina Andersson|Carina Andersson
Damayanti Joshi|দময়ন্তী যোশী
Damodara Deva|দামোদৰ দেৱ
Edward Albert Gait|এডৱাৰ্ড এলবাৰ্ট গেইট
Ghulam Mustafa Khan|গোলাম মুস্তাফা খান
Herbert Kleber|হাৰ্বাট ক্লেবাৰ
Rita Chowdhury|ৰীতা চৌধুৰী
Hira Devi Waiba|হিৰা দেৱী ৱাইবা
Ram Vilas Paswan|ৰাম বিলাস পাছৱান
Kamal Kumari Barooah|কমল কুমাৰী বৰুৱা
Kamlesh Mehta|কমলেশ মেহতা
Laxmi Narayan Tripathi|লক্ষ্মী নাৰায়ণ ত্ৰিপাঠী
M. K. Binodini Devi|মহাৰাজ কুমাৰী বিনোদিনী দেৱী
Sasha Banks|ছাশ্বা বেঙ্কস
Monalisa Baruah Mehta|মনালিচা বৰুৱা মেহতা
Nidhi Razdan|নিধি ৰাজদান
Nilmani Phookan (Junior)|নীলমণি ফুকন (কনিষ্ঠ)
Paoli Dam|পাওলি দাম
Prastuti Parashar|প্ৰস্তুতি পৰাশৰ
Rani Gaidinlu|ৰাণী গাইডিনলিউ
Rasoolan Bai|ৰচুলন বাঈ
Rekha Bhardwaj|ৰেখা ভৰদ্বাজ
Renu Saikia|ৰেণু শইকীয়া
Roshni Nadar|ৰোশনী নাদাৰ
Yamini Krishnamurthy|যামিনী কৃষ্ণমূৰ্তি
Sachindra Lal Singh|সচীন্দ্ৰ লাল সিং
Samir Ranjan Barman|সমীৰ ৰঞ্জন বৰ্মন
Saurabh Kumar Chaliha|সৌৰভ কুমাৰ চলিহা
Seema Rao|সীমা ৰাও
Smitha Madhav|স্মিতা মাধৱ
Sonal Mansingh|সোণাল মানসিং
Sudhin Dasgupta|সুধীন দাশগুপ্ত
Suhenphaa|চুহেনফা
Sukhrangpha|চুখ্ৰাম্‌ফা
Supaatphaa|গদাধৰ সিংহ
Suramphaa|চুৰাম্‌ফা
Swargajyoti Barooah|স্বৰ্গজ্যোতি বৰুৱা
Syed Abdul Malik|চৈয়দ আব্দুল মালিক
Biju Phukan|বিজু ফুকন
Ananda Chandra Barua|আনন্দ চন্দ্ৰ বৰুৱা
Ananda Ram Baruah|আনন্দৰাম বৰুৱা
Arundhati Bhattacharya|অৰুন্ধতী ভট্টাচাৰ্য্য
Urkhao Gwra Brahma|উৰ্খাউ গৌড়া ব্ৰহ্ম
Renee M. Borges|ৰেণী বৰ্গিজ
Rajeshwari Chatterjee|ৰাজেশ্বৰী চেটাৰ্জী
Sharad Arvind Bobde|শৰদ অৰবিন্দ ববডে
Nadong Bhutia|নাদং ভুতিয়া
André Preto|আণ্ড্ৰে' প্ৰেট'
Maganlal Gandhi|মগনলাল গান্ধী
Sulikphaa|চুলিক্‌ফা
Maiken Fruergaard|Maiken Sørensen
Chandra Prasad Saikia|চন্দ্ৰপ্ৰসাদ শ‍ইকীয়া
Gambhari Devi|গম্ভৰী দেৱী
Baharul Islam|বাহাৰুল ইছলাম
Mridula Baruah|মৃদুলা বৰুৱা
Syed Akbaruddin|চৈয়দ আকবৰুদ্দিন
H. C. Verma|হৰিশ চন্দ্ৰ বাৰ্মা
|সীতানাথ ব্ৰহ্মচৌধুৰী
Seema Nanda|সীমা নন্দা
Ushadevi Bhosle|ঊষাদেৱী ভোছলে
Villy Aellen|Villy Aellen
Shagufta Jumani|সাগুফতা জুমানি
Sayyeshaa|সায়েশা সৈগল
Rupamanjari Ghosh|ৰূপামঞ্জৰী ঘোষ
Roman Saini|ৰ'মান চেইনী
|অষ্টভুজ মহন্ত
|প্ৰমোদ বৰুৱা
Samarendra Narayan Dev|সমৰেন্দ্ৰ নাৰায়ন দেৱ
László Ocskó|László Ocskó
Jagmohan Kaur|জগমোহন কৌৰ
Ganga Devi|গংগা দেৱী (চিত্ৰশিল্পী)
Silverine Swer|ছিলভাৰিন স্বেৰ
Chaitanya Tamhane|চৈতন্য টামহানে
Rabindra Nath Upadhyay|ৰবীন্দ্ৰনাথ উপাধ্যায়
|ইন্দিৰা মিৰি
Rohit Khandelwal|ৰোহিত খান্দেলৱাল
Saalumarada Thimmakka|শালুমাৰাদা থিম্মাক্কা
Dicky Dolma|ডিকি ডলমা
Sheela Borthakur|শীলা বৰঠাকুৰ
Baharul Islam|বাহাৰুল ইছলাম
Jones Mahalia|জন্‌ছ মহলীয়া
Shashikala Dani|শশীকলা দানী
Angoorlata Deka|আঙুৰলতা ডেকা
Pramila Rani Brahma|প্ৰমিলা ৰাণী ব্ৰহ্ম
Mahua Moitra|মহুৱা মৈত্ৰা
Manika Batra|মণিকা বাত্ৰা
Narayana Dev|নাৰায়ণদেৱ
|লীলা গগৈ
|অভিজিত বৰুৱা
|খগেন্দ্ৰনাথ নাথ
|ধৰ্মেশ্বৰী দেৱী বৰুৱানী
Jyoti Prakash Das|জ্যোতি প্ৰকাশ দাস
|সাৰদা বেজবৰুৱা
Mrinal Kanti Das|মৃণাল কান্তি দাস
Diganta Hazarika|দিগন্ত হাজৰিকা
Marc-Antoine Desaymoz|Marc Antoine Desaymoz
Grant Walker|Grant Walker
Edward Ward|Eddie Ward
Melih Turgut|Melih Turgut
Tiffany Ho|Tiffany Celine Ho
Kang Chan-hee|Kang Ga-ae
Jan Mendel|Jan Mendel
Rudolf Ogrodzki|Rudolf Ogrodzki
Zdzisław Karwat|Zdzisław Karwat
Łucja Porządnicka|Łucja Porządnicka
Grzegorz Grzybowski|Grzegorz Grzybowski
Lucjan Gibas|Lucjan Gibas
Elżbieta Kuczkowska|Elżbieta Kuczkowska
Karolina Piątek|Karolina Piątek
Małgorzata Kowina|Małgorzata Kowina
Katarzyna Kaczmar|Katarzyna Kaczmar
Joanna Bednarska|Joanna Bednarska
Zbigniew Śmilgin|Zbigniew Śmilgin
Grzegorz Świerczyna|Grzegorz Świerczyna
Grzegorz Szymański|Grzegorz Szymański
Edyta Buziecka|Edyta Buziecka
Zbigniew Serwetnicki|Zbigniew Serwetnicki
Karolina Kosińska|Karolina Kosińska
Evelyn Siamupangila|Evelyn Siamupangila
Elizaberth Chipeleme|Elizaberth Chipeleme
Elsa Danckers|Elsa Danckers
Sarah Sicard|Sarah Sicard
Marie-Josée Nicol|Marie-Josée Nicol
Ana Anaya|Ana Anaya
Bente Pedersen|Bente Pedersen
Berit Elgaaen|Berit Elgaaen
Berit Guren|Berit Guren
Birgitte Hindse|Birgitte Hindse
Blanca Lucas|Blanca Lucas
Christo Popov|Christo Popov
Daniel la Torre Regal|Daniel la Torre Regal
Evgenij Blitshteyn|Evgenij Blitshteyn
Fee Teng Liew|Fee Teng Liew
Harry Huang|Harry Huang
Henry Uy|Henry Uy
Inés Castillo|Ines Castillo
Irina Melnikova|Irina Melnikova
Jan Nyquist|Jan Nyquist
Johann Elgaaen|Johan Elgaaen
Johnnie Torjussen|Johnnie Torjussen
José María Otero|José María Otero
Jurgen van der Pot|Jurgen van der Pot
Kaj Lindfors|Kaj Lindfors
Jhenicha Sudjaipraparat|Kwanchanok Sudjaipraparat
Laura Primo|Laura Primo
Lily Tan|Lily Tan
Louisa Ma|Louisa Ma
Maria Torres|Maria Torres
Nouran Khaled|Nouran Khaled
Mikhail Lavrikov|Mikhail Lavrikov
Tumisang Olekantse|Olekantse Tumisang
Sebastian Grønbjerg|Sebastian Grønbjerg
Simon Haw|Simon Haw
Sukrit Maunglai|Sukrit Maunglai
Vera Pozdnyakova|Vera Pozdnyakova
Ainoa Desmons|Ainoa Desmons
Alfonso Garcia-Rosell|Alfonso Garcia-Rosell
Ana Montefinale|Ana Montefinale
Andreas Hansen|Andreas Hansen
Annette Bernth|Annette Bernth
Annika Schreiber|Annika Schreiber
Antonio Rico|Antonio Rico
Atsuko Koike|Atsuko Koike
Awais Zahid|Awais Zahid
Bimo Adi Prakoso|Bimo Adi Prakoso
Bodil Bugge|Bodil Bugge
Clara Graversen|Clara Graversen
Daniel Ojäaar|Daniel Ojäaar
Debora Blanco|Debora Blanco
Edward Foster|Edward Foster
Ekaterina Karhushina|Ekaterina Karhushina
Emma Timmins|Emma Timmins
Erik Kjølberg|Erik Kjølberg
Espen Larsen|Espen Larsen
Estrella Perez|Estrella Perez
Fachryza Abimanyu|Fachriza Abimanyu
Grace MacFarland|Grace MacFarland
Hans Røpke|Hans Røpke
Hines|Hines
Hope Warner|Hope Warner
Jacinta Joe|Jacinta Joe
Priscilla Fernandez|Priscilla Fernandez
Jere Övermark|Jere Övermark
Jesus Cebey|Jesus Cebey
Jill Crombie|Jill Crombie
José Bermúdez|José Bermúdez
Juri Yermolayev|Juri Yermolayev
Keisuke Kawaguchi|Keisuke Kawaguchi
Lee Boosey|Lee Boosey
Lucero Chueca|Lucero Chueca
Manassanan Lerthattasin|Manassanan Lerthattasin
Margareta Frederiksen|Margareta Frederiksen
Margareta Söderberg|Margareta Söderberg
Marie Therese Braganza|Marie Therese Braganza
Marijuana Mapua|Marijuana Mapua
Matthew Clare|Matthew Clare
Morten Hummelmose|Morten Hummelmose
Natalia Rodriguez|Natalia Rodriguez
Natalja Avdyunina|Natalja Avdyunina
Nina Håland|Nina Håland
Peter Correll|Peter Correll
Po Li-Wei|Po Li-Wei
Robert Kwee|Robert Kwee
Samuel Ricketts|Samuel Ricketts
Sara Pinedo|Sara Pinedo
Stoyan Ivanchev|Stoyan Ivanchev
Susan Jensen|Susan Jensen
Sven-Ove Kellermalm|Sven-Ove Kellermalm
T. Kun Sui|T. Kun Sui
Taichi Saito|Taichi Saito
Tania Díaz|Tania Díaz
Thomas Olsen|Thomas Olsen
Tim Zander|Tim Zander
Usman Isaiq|Usman Isaiq
Vladislav Tikhomirov|Vladislav Tikhomirov
Mariana Paiz Quan|Mariana Paiz Quan
Adriana Garcia|Adriana Garcia
Alex Patrick Zolobe|Alex Patrick Zolobe
Anahit Tadevosyan|Anahit Tadevosyan
Andrea Pipan|Andrea Pipan
Andrea Roschinsky|Andrea Roschinsky
Antonia Meinke|Antonia Meinke
Berthold Auer|Berthold Auer
Brian Kasirye|Brian Kasirye
Calvin Kristano|Calvin Kristano
Chiara List|Chiara List
Christoph Blüml|Christoph Blüml
Christoph Radinger|Christoph Radinger
Christopher Stern|Christopher Stern
Clara Maria Gruber|Clara Maria Gruber
Donald Cory|Donald Cory
Ena Chen|Ena Chen
Fan Ming|Fan Ming
Franck Emmanuel Zolobe|Franck Emmanuel Zolobe
Grace Hanratty|Grace Hanratty
Hoang Pham|Hoang Pham
Hubert Nahrebecki|Hubert Nahrebecki
Jakob Ostermann|Jakob Ostermann
Javier Macagno|Javier Macagno
Joniva Almazan|Joniva Almazan
Karen Petrosyan|Karen Petrosyan
Karl Kogler|Karl Kogler
Leopold Lanner|Leopold Lanner
Leticia Scrocca|Leticia Scrocca
Lionel Seah|Lionel Seah
Lukas Kremmel|Lukas Kremmel
M. Hornsey|M. Hornsey
Manfred Stündl|Manfred Stündl
Manuela Schneider|Manuela Schneider
Markus Ratzenböck|Markus Ratzenböck
Martha Lichtblau|Martha Lichtblau
Matthew Gillie|Matthew Gillie
Mercedes Raunig|Mercedes Raunig
Mia Reilev|Mia Reilev
Micaela Flores|Micaela Flores
Michael Vonnetz|Michael Vonnetz
Minami Kawashima|Minami Kawashima
Moritz Kaufmann|Moritz Kaufmann
N. Wing|N. Wing
Natavan Eyvazova|Natavan Eyvazova
P. Barker|P. Barker
Paul Demmelmayer|Paul Demmelmayer
Pervin Alizade|Pervin Alizade
Peter Kumpfmüller|Peter Kumpfmüller
Philipp Drexler|Philipp Drexler
Phing Teo|Phing Teo
Priscilla Pillay Vinayagam|Priscilla Pillay Vinayagam
Ruben Poghosyan|Ruben Poghosyan
Rudi Mahin|Rudi Mahin
Santiago Otero|Santiago Otero
Saskia Wallner|Saskia Wallner
Shania Leung|Shania Leung
Shirley Etienne|Shirley Etienne
Soledad Pisonero|Soledad Pisonero
Spartak Rsyan|Spartak Rsyan
Stefany Ying Chie Chen Chen|Stefany Ying Chie Chen Chen
Susanne Götschl|Susanne Götschl
Tan Jin Kiat|Tan Jin Kiat
Tobias Karasek|Tobias Karasek
Veronika Leitl|Veronika Leitl
Wesely Caulkett|Wesely Caulkett
Yutaka Amann|Yutaka Amann
Zaur Osmanov|Zaur Osmanov
Natalia Serna|Natalia Eyennidth Serna Leyva
A. Büttner|A. Büttner
A. Ellett|A. Ellett
A. Nolan|A. Nolan
A. Vandeheede|A. Vandeheede
A. York|A. York
Ajit Verma|Ajit Verma
Alberto Companioni|Alberto Companioni
Alexandre Tremblay|Alexandre Tremblay
Al-Sayed Jafar Ebrahim Jafar|Al-Sayed Jafar Ebrahim Jafar
Andreas Geisenhofer|Andreas Geisenhofer
Ann Knaepen|Ann Knaepen
Annemie Buyse|Annemie Buyse
Antony K. Jacob|Antony K. Jacob
Arash Abdul Mohamadian|Arash Abdul Mohamadian
Arba Nawar|Arba Nawar
Augustina Ebhomien Sunday|Augustina Ebhomien Sunday
Benjamin Driesen|Benjamin Driesen
Bhavna Sawaran|Bhavna Sawaran
Bibari Basumatary|Bibari Basumatary
C. Richardson|C. Richardson
Catriona Francica|Catriona Francica
Christine Jacobs|Christine Jacobs
Dart|Dart
Denise Walter|Denise Walter
Dennis Tjin Asjoe|Dennis Tjin Asjoe
Dharakhasa Parvin Moni|Dharakhasa Parvin Moni
Dibyajyoti Borah|Dibyajyoti Borah
Dieter Frick|Dieter Frick
Dmitrii Autarev|Dmitrii Autarev
Dolgorsuren Batsaikhan|Dolgorsuren Batsaikhan
E. W. Griffiths|E. W. Griffiths
Fahim|Fahim
Fernando Molinar|Fernando Molinar
Walter Forster|Forster
Franziska Ottrembka|Franziska Ottrembka
Julia Coelho|Julia Coelho
Geofrey Lamont|Geofrey Lamont
Gerson Quezada|Gerson Quezada
H. de Chazal|H. de Chazal
Hector Casillas|Hector Casillas
Heidi Vrancken|Heidi Vrancken
Henrik Wiberg|Henrik Wiberg
Hugues Belsack|Hugues Belsack
Iqbal Hossain Pista|Iqbal Hossain Pista
Isabelle Meuleman|Isabelle Meuleman
J. B. Laidlaw|J. B. Laidlaw
J. Boulet|J. Boulet
Jackeline Aguilar|Jackeline Aguilar
Jalal Eskandari|Jalal Eskandari
Janet Tam|Janet Tam
Janina Schumacher|Janina Schumacher
Jebunnesa Seema|Jebunnesa Seema
Jenny Wan|Jenny Wan
Jeremy Raines|Jeremy Raines
Johan Delamper|Johan Delamper
José Icaza|José Icaza
José Manuel Icaza López|José Manuel Icaza López
Julia Hauber|Julia Hauber
Karolina Kotte|Karolina Kotte
Karoline Neumann|Karoline Neumann
Kelly Scoliers|Kelly Scoliers
L. Soto Hay|L. Soto Hay
Liesbeth Dufraing|Liesbeth Dufraing
Lionel Warnotte|Lionel Warnotte
Luigi Dalli Cardillo|Luigi Dalli Cardillo
Luz María Curiel|Luz María Curiel
Lwin Aung|Lwin Aung
Madalene Steinbroner|Madalene Steinbroner
Maharani Sekar Batari|Maharani Sekar Batari
Marie Maunoury|Marie Maunoury
Markus Ewald|Markus Ewald
Maryana Verbitskaya|Maryana Verbitskaya
Melida Castelazo|Melida Castelazo
Memminger|Memminger
Michael Pongratz|Michael Pongratz
Miguel Caloca|Miguel Caloca
Mildred Sirwaitis|Mildred Sirwaitis
Mira Das|Mira Das
Mona Fischer|Mona Fischer
Muhammad Hafifi Hashim|Muhammad Hafifi Hashim
Munkhchimeg Mendjargal|Munkhchimeg Mendjargal
Natalia Kalujnaia|Natalia Kalujnaia
Nathalie Grittner|Nathalie Grittner
Nathalie Volochinoff|Nathalie Volochinoff
Nele Hayen|Nele Hayen
Nicolas Cuccu|Nicolas Cuccu
Nicole Montgomery|Nicole Montgomery
Oleg Pashkovich|Oleg Pashkovich
P. Chevreau de Montlehu|P. Chevreau de Montlehu
P. Gutiérrez|P. Gutiérrez
Pat Beckford|Pat Beckford
Patricia Nuñez|Patricia Nuñez
Patrik Beier|Patrik Beier
Pieter Mertens|Pieter Mertens
Pintu|Pintu
Présence Beelen|Présence Beelen
Renate Uschold|Renate Uschold
Roel Bollen|Roel Bollen
Rohit Jaykumar|Rohit Jaykumar
Rokeya Beg|Rokeya Beg
Rose Leefatt|Rose Leefatt
Rover Jay Babatido|Rover Jay Babatido
S. Islam|S. Islam
Sabine Langenaekens|Sabine Langenaekens
Sabuj|Sabuj
Sapan|Sapan
Saribel Caceres|Saribel Caceres
Sarwar|Sarwar
Sarwar Hossain|Sarwar Hossain
Sayeeda Marrium Tareq|Sayeeda Marrium Tareq
Sébastien Pepe|Sébastien Pepe
Shaheb Banu Munni|Shaheb Banu Munni
Simon Eeckhoudt|Simon Eeckhoudt
Sirin Rahman|Sirin Rahman
Stein Notermans|Stein Notermans
Stephan Lutzcanov|Stephan Lutzcanov
Steve Bish|Steve Bish
Steven Delsaert|Steven Delsaert
Sviatlana Kaparkina|Svetlana Koparkina
T. Kelly|T. Kelly
T. Nsete|T. Nsete
Tamara Teuber|Tamara Teuber
Temuulen Ayush|Temuulen Ayush
Thatcher|Thatcher
Thomas Schmudde|Thomas Schmudde
Timo Teulings|Timo Teulings
Toby Baldari|Toby Baldari
Traci White|Traci White
Valeria Reynoso|Valeria Reynoso
Vandeninden|Vandeninden
Vicki Toutz|Vicki Toutz
Vitalii Zinchuk|Vitalii Zinchuk
Viviane Isasi|Viviane Isasi
Willi Barth|Willi Barth
Winsor Wong|Winsor Wong
Wolf-Dieter Baier|Wolf-Dieter Baier
Wolfgang Blümel|Wolfgang Blümel
Wolfmüller|Wolfmüller
Zvetlana Serralde|Zvetlana Serralde
Reimi Starling Cabrera Rosario|Reimi Rosario
Katherine Wynter|Katherine Wynter
Abdelrahman Abdelhakim|Abdelrahman Abdelhakim
Tanupat Viriyangkura|Tanupat Viriyangkura
Gideon Babalola|Gideon Babalola
Anoushka Parikh|Anoushka Parikh
Lee Hong-je|Lee Hong-je
Manuel Martínez Chumillas|Manuel Martínez Chumillas
Ángel Cadarso del Pueyo|Ángel Cadarso del Pueyo
Vishvanarayana Shastry|বিশ্বনাৰায়ণ শাস্ত্ৰী
Mangal Singh Hazowary|মংগলসিং হাজোৱাৰী
|গুণীন্দ্ৰ নাথ দত্ত
Plabita Borthakur|প্লাৱিতা বৰঠাকুৰ
V. Lakshmibai|ভি. লক্ষ্মীবাই
Minimata Agam Dass Guru|মিনীমাতা
Kavita Ramanan|কবিতা ৰামানন
Rima Das|ৰীমা দাস
Mamta Chandrakar|মমতা চন্দ্ৰকৰ
Hima Das|হিমা দাস
Jayanta Madhab Bora|জয়ন্ত মাধৱ বৰা
Orso Orsini|Orso Orsini
Nilanjana Datta|নীলাঞ্জনা দত্ত
Bhuri Bai|ভূৰী বাঈ
Santanoo Tamuly|শান্তনু তামূলী
Purushottam Das|পুৰুষোত্তম দাস
Anshula Kant|অংশুলা কান্ত
Vani Bhojan|বাণী ভজন
Kiron Kumar Gogoi|কিৰণ কুমাৰ গগৈ
Kafil Uddin Sonar|কফিল উদ্দিন ছোনাৰ
Golok Chandra Goswami|গোলোকচন্দ্ৰ গোস্বামী
Fanny Vaucher|Fanny Vaucher
|দিলীপ শৰ্মা
Ajit Kumar Bhuyan|অজিত কুমাৰ ভূঞা
Gyanada Kakati|জ্ঞানদা কাকতি
Afzalur Rahman|আফজালুৰ ৰহমান
Bholanath Borooah|ভোলানাথ বৰুৱা
Kameswar Das|কামেশ্বৰ দাস
Jyoti Prasad Medhi|জ্যোতিপ্ৰসাদ মেধি
Munin Barkotoki|মুনীন বৰকটকী
Dhruv Rathee|ধ্ৰুৱ ৰাথী
Jehirul Hussain|জেহিৰুল হুছেইন
Rajen Rabha|ৰাজেন ৰাভা
Hemanga Kumar Datta|হেমাংগ কুমাৰ দত্ত
Prabhat Sarma|প্ৰভাত শৰ্মা
Bijoy Chowdhury|বিজয় চৌধুৰী
Upendra Nath Goswami|উপেন্দ্ৰনাথ গোস্বামী
Daityari Thakur|দৈত্যাৰি ঠাকুৰ
Tasadduk Yusuf|তচদ্দুক ইউচুফ
Kate Sayer|Kate Sayer
Manoj Gogoi|মনোজ গগৈ
Shubhankar Baruah|শুভংকৰ বৰুৱা
Maitrayee Patar|মৈত্ৰেয়ী পাটৰ
Anna Kulikova|Anna Kulikova
Jean-Pierre Lloyd|Jean-Pierre Lloyd
Areke Hassink|Areke Hassink
Paula Fedirchuk|Paula Fedirchuk
Claudia Migliorini|Claudia Migliorini
Sylvia Debboudt|Sylvia Debboudt
Miranda De Permentier|Miranda De Permentier
Aurélie Anaise|Aurélie Anaise
Gulnara Fatkullina|Gulnara Fatkullina
Mirza Nikolajev|Mirza Nikolajev
Elīna Ieva Vītola|Elīna Ieva Vītola
Kyle Murray|Kyle Murray
Ila Kakati|ইলা কাকতি
Stefan Kiefer|Stefan Kiefer
Stanley Kubrick|ষ্টেনলি কুবৰিক
Galileo Galilei|গেলিলিঅ’ গেলিলি
Bob Marley|বব মাৰ্লি
Socrates|ছক্ৰেটিছ
Caligula|কেলিগোলা
Robin van Persie|ৰবিন ভেন পাৰ্চী
Rajiv Gandhi|ৰাজীৱ গান্ধী
Sarah Bernhardt|ছাৰা বাৰ্নহাৰ্ট
Hippocrates|হিপ'ক্ৰেটিছ
Frida Kahlo|ফ্ৰিদা কাল'
Charles Dickens|চাৰ্লচ ডিকেঞ্চ
Hillary Clinton|হিলাৰি ক্লিণ্টন
Homer|হোমাৰ
Kalidasa|কালিদাস
Joan of Arc|জোন অফ আৰ্ক
Yuri Gagarin|য়ুৰি গেগেৰিন
Ibn Battuta|ইবন বটুতা
Michael Faraday|মাইকেল ফেৰাডে
Johannes Gutenberg|য়'হানেছ গুটন্‌বাৰ্গ
Max Planck|মেক্স প্লেংক
Ronald Reagan|ৰোনাল্ড ৰেগন
Stephen Hawking|ষ্টিফেন হকিং
Hema Malini|হেমা মালিনী
Whitney Houston|হুইটনী হাষ্টন
Rihanna|ৰিয়ানা
Richard Feynman|ৰিচাৰ্ড ফাইনমেন
Virginia Woolf|ভাৰ্জিনিয়া উল্‌ফ
Federico García Lorca|ফেডেৰিক’ গাৰ্ছিয়া ল’ৰ্কা
Bernhard Riemann|বাৰ্নহাৰ্ড ৰিমান
Cameron Diaz|কেমেৰ'ণ দিয়াজ
Satyendra Nath Bose|সত্যেন্দ্ৰনাথ বসু
Edmund Halley|এডমাণ্ড হেলি
Swami Vivekananda|স্বামী বিবেকানন্দ
André Gide|আণ্ড্ৰে পউল গুলেইম গিদ
Rajinikanth|ৰজনীকান্ত
Guru Nanak|গুৰু নানক
John Forbes Nash|জন ফ'ৰ্বছ্‌ নাশ্ব
Neymar|নেইমাৰ
Tanuja|তনুজা
Leó Szilárd|লিঅ' জিলাৰ্ড
Lata Mangeshkar|লতা মংগেশকাৰ
Samuel Hahnemann|চেমুৱেল হ্যানিমেন
Zdeněk Musil|Zdeněk Musil
William S. Burroughs|উইলিয়াম বাৰোজ
Mary Robinson|মেৰী ৰবিনচন
Chandragupta Maurya|চন্দ্ৰগুপ্ত মৌৰ্য
Zubeida|জুবেইদা
Daniel Kahneman|ডেনিয়েল কাহনেমেন
Benedict Cumberbatch|বেনেডিক্ট কাম্বাৰবেটছ্
I. K. Gujral|ইন্দৰ কুমাৰ গুজৰাল
Muhammad Saleh Akbar Hydari|মহম্মদ চালেহ আকবৰ হাইদৰী
Anoushka Shankar|অনুষ্কা শংকৰ
Alexandros Tzorvas|এলেক্‌জেণ্ড্ৰ' জ'ৰ্ৱাছ
Milkha Singh|মিলখা সিং
Konkona Sen Sharma|কংকনা সেন শৰ্মা
Robert Kiyosaki|ৰবাৰ্ট টি কিয়োচাকি
Tulsidas|তুলসীদাস
Jagadish Chandra Bose|জগদীশ চন্দ্ৰ বসু
Abhijit Banerjee|অভিজিৎ বেনাৰ্জী
Vikram Sarabhai|বিক্ৰম সাৰাভাই
Homi Jehangir Bhabha|হোমি জেহাঙ্গীৰ ভাভা
Shammi Kapoor|শাম্মী কাপুৰ
Amitav Ghosh|অমিতাভ ঘোষ
Scott Kelly|স্কট কেলি
Robert B. Wilson|ৰবাৰ্ট বি. ৱিলচন
Bankim Chandra Chattopadhyay|বঙ্কিমচন্দ্ৰ চট্টোপাধ্যায়
Meghnad Saha|মেঘনাদ সাহা
Sushil Kumar|সুশীল কুমাৰ
Shashi Kapoor|শশী কাপুৰ
Tu Youyou|তু ইউইউ
Sheila Dikshit|শীলা দিক্ষিত
Divya Bharti|দিব্যা ভাৰতী
Shabana Azmi|শাবানা আজমী
Alka Yagnik|অলকা য়াগনিক
Tetsuko Kuroyanagi|তেৎছুকো কুৰ'য়ানাগি
Gayatri Joshi|গায়ত্ৰী যোশী
Rokeya Sakhawat Hossain|বেগম ৰোকেয়া
Sonu Nigam|চনু নিগম
Sathya Sai Baba|সত্য সাই বাবা
Bear Grylls|বিয়েৰ গ্ৰিলচ্
Anupama Chopra|অনুপমা চোপ্ৰা
Farida Khanum|ফৰিদা খানম
Shobhaa De|শোভা দে
Kunjarani Devi|কুঞ্জৰাণী দেৱী
Norah Jones|ন’ৰা জ’নছ
Sunil Chhetri|সুনিল ছেত্ৰী
Farhan Akhtar|ফাৰহান আখটাৰ
Mahapajapati Gotami|প্ৰজাপতি গৌতমী
Sonakshi Sinha|সোনাক্ষী সিন্‌হা
Abanindranath Tagore|অৱনীন্দ্ৰনাথ ঠাকুৰ
Begum Hazrat Mahal|বেগম হজৰত মহল
Jim Peebles|জিম পিবলছ্
M. Visvesvaraya|মোক্ষগুণ্ডম বিশ্বেশ্বৰায়
Mahadev Desai|মহাদেৱ দেশাই
Bhagwan Das|ভগৱান দাস
Pierre Vernier|পিয়েৰী ভাৰ্ণিয়াৰ
Rajyavardhan Rathore|ৰাজ্যৱৰ্ধন সিং ৰাথোড়
Carlo Rovelli|কাৰ্লো ৰ'ভেলী
Chandramukha Varman|চন্দ্ৰমুখ বৰ্মা
Manilal Gandhi|মণিলাল গান্ধী
E. C. George Sudarshan|ই চি জৰ্জ সুদৰ্শন
Harilal Gandhi|হৰিলাল গান্ধী
Ramanand Sagar|ৰামানন্দ সাগৰ
Neerja Bhanot|নীৰজা ভানোট
Anwara Taimur|চৈয়দা আনোৱাৰা টাইমূৰ
Shashi Deshpande|শশী দেশপাণ্ডে
Michael Kremer|মাইকেল ক্ৰেমাৰ
Salma Agha|চালমা আগা
Khushwant Singh|খুছৱন্ত সিং
Devanand Konwar|দেৱানন্দ কোঁৱৰ
Pratibha Ray|প্ৰতিভা ৰয়
Peter J. Ratcliffe|পিটাৰ জন ৰেটক্লিফ
Dashrath Manjhi|দশৰথ মাঝি
Tasuku Honjo|টাচুকু হঞ্জ'
Nirmala Joshi|নিৰ্মলা যোশী
Diego Nadaya|দিয়েগ' নাদায়া
Ramchandra Narayan Dandekar|ৰামচন্দ্ৰ নাৰায়ণ দণ্ডেকাৰ
Nanaji Deshmukh|নানাজী দেশমুখ
Kiran Bedi|কিৰণ বেদী
Sharda Sinha|শাৰদা সিনহা
Malay Roy Choudhury|মলয় ৰায়চৌধুৰী
Bhikaiji Cama|ভিখাজী কামা
Rituparna Sengupta|ঋতুপৰ্ণ সেনগুপ্ত
Kumar Sanu|কুমাৰ চানু
P. T. Usha|পি. টি. উষা
Anukulchandra Chakraborty|অনুকূলচন্দ্ৰ চক্ৰৱৰ্তী
Rahul Sankrityayan|ৰাহুল সাংকৃত্যায়ন
Suresh Raina|সুৰেশ ৰাইনা
Umesh Yadav|উমেশ যাদৱ
Raadhika Sarathkumar|ৰাধিকা
Balasaraswati|বালাসৰস্বতী
Maitreyi Devi|মৈত্ৰেয়ী দেবী
Nirmala Deshpande|নিৰ্মলা দেশপাণ্ডে
Suman Kalyanpur|সুমন কল্যাণপুৰ
Muppavarapu Venkaiah Naidu|ভেংকাইয়া নাইডু
Bhishmaka|ভীষ্মক
Aditi Rao Hydari|অদিতি ৰাও হায়দৰী
Adriaan van der Willigen|Adriaan van der Willigen
Adriaan van der Willigen Pz.|Adriaan van der Willigen Pz.
Adriaen Foly|Adriaen Foly
Ajoy Ghatak|অজয় ঘটক
Amirbai Karnataki|আমিৰবাই কৰ্ণাটকী
Amita Malik|অমিতা মালিক
Amulya Barua|অমূল্য বৰুৱা
Anandaram Dhekial Phukan|আনন্দৰাম ঢেকিয়াল ফুকন
Arun Sarma|অৰুণ শৰ্মা
Arupa Kalita Patangia|অৰূপা পটংগীয়া কলিতা
Beli Ram Das|বেলি ৰাম দাস
Birinchi Kumar Barua|বিৰিঞ্চি কুমাৰ বৰুৱা
Ileana Citaristi|ইলেনা চিতাৰিস্তী
Brajanath Sarma|ব্ৰজনাথ শৰ্মা
Chilarai|চিলাৰায়
Devi Shetty|দেৱী প্ৰসাদ শেট্টী
Gauhar Jaan|গৌহৰ জান
Harekrishna Deka|হৰেকৃষ্ণ ডেকা
Harshdeep Kaur|হৰ্ষদীপ কৌৰ
Rudra Baruah|ৰুদ্ৰ বৰুৱা
Holicharan Narzary|হলিচৰণ নাৰ্জাৰী
Indrani Rahman|ইন্দ্ৰাণী ৰহমান
Jatin Bora|যতীন বৰা
Kanaklata Barua|কনকলতা বৰুৱা
Kopil Bora|কপিল বৰা
Khursheed Bano|খুৰশীদ বানো
Kum Uma Sharma|উমা শৰ্মা
Lalita Pawar|ললিতা পাৱাৰ
Miles Bronson|মাইলছ ব্ৰনছন
Neena Gupta|নীনা গুপ্তা
Obaid Siddiqi|অবেইদ ছিদ্দিকি
Padmavathy Bandopadhyay|পদ্মাৱতী বন্দ্যোপাধ্যায়
Esther Victoria Abraham|এস্থাৰ ভিক্টোৰিয়া আব্ৰাহাম
Pratishtha Sharma|প্ৰতিষ্ঠা শৰ্মা
Premlata Agarwal|প্ৰেমলতা অগ্ৰৱাল
Sudarshan Pattnaik|সুদৰ্শন পাটনায়ক
Punita Arora|পুনিতা অৰোৰা
Radhika Ranjan Gupta|ৰাধিকা ৰঞ্জন গুপ্ত
Radhika Roy|ৰাধিকা ৰয়
Rajen Gohain|ৰাজেন গোঁহাই (ৰাজনীতিক)
Sailadhar Baruah|শৈলধৰ বৰুৱা
Shaheer Sheikh|শ্বাহিৰ শ্বেখ
Malavika Sarukkai|মালবিকা চাৰুক্কাই
Shefali Shah|শেফালী শ্বাহ
Sunyatphaa|চুন্যৎফা
Supriya Devi|সুপ্ৰিয়া দেৱী
Susenghphaa|চুচেংফা
Susenphaa|চুচেনফা
Sutamla|স্বৰ্গদেউ জয়ধ্বজ সিংহ
Usha Mehta|ঊষা মেহতা
Ōsumi Yoshinori|য়শ্বিনৰী অহচুমি
Sushant Singh Rajput|সুশান্ত সিং ৰাজপুত
Pankaj Tripathi|পংকজ ত্ৰিপাঠী
Gopaldev|গোপালদেৱ
V. Mohini Giri|ভি. মোহিনী গিৰি
Hemchandra Goswami|হেমচন্দ্ৰ গোস্বামী
Jatindranath Dowara|যতীন্দ্ৰ নাথ দুৱৰা
Urjit Patel|উৰ্জিত পেটেল
M. R. Poovamma|মাচেত্তিৰা ৰাজু পুভাম্মা
Sushmita Banerjee|সুস্মিতা বেনাৰ্জী
Lee Se-yeon|Lee Min-ji
Liladhar Kotoki|লীলাধৰ কটকী
Radha Balakrishnan|ৰাধা বালাকৃষ্ণন
Yamuna Krishnan|যমুনা কৃষ্ণণ
Rohini Godbole|ৰোহিনী গোডবোলে
Anuradha Misra|অনুৰাধা মিশ্ৰ
Bajrang Punia|বজৰং পুনিয়া
Hitendra Nath Goswami|হিতেন্দ্ৰ নাথ গোস্বামী
Pornpawee Chochuwong|Chochuwong Pornpawee
Robin Dey|ৰবীন দে
Maheswar Neog|মহেশ্বৰ নেওগ
T. S. Thakur|তীৰথ সিং ঠাকুৰ
Kavi Shastri|কৱি শাস্ত্ৰী
Heera Saraniya|হীৰা শৰণীয়া
Supangmung|চুপুংমুং
Sushila Chanu|পোখৰাম্বাম সুশীলা চানু
Rohit Mirza|ৰ'হিত মিৰ্জা
Geetanjali Thapa|গীতাঞ্জলি থাপা
Indu Malhotra|ইন্দু মলহোত্ৰা
Lila Tretikov|লাইলা ট্ৰেটিক'ভ
Savani Ravindra|সাৱনী ৰবীন্দ্ৰ
Kamakhya Prasad Tasa|কামাখ্যা প্ৰসাদ তাছা
|মহেন্দ্ৰ বৰঠাকুৰ
Mitradev Mahanta|মিত্ৰদেৱ মহন্ত
Keshda Mahant|কেশদা মহন্ত
Devendranath Acharya|দেবেন্দ্ৰ নাথ আচাৰ্য
Teerthnath Sharma|তীৰ্থনাথ শৰ্মা
Nilim Kumar|নীলিম কুমাৰ
Bhrigumoni Kakyung|ভৃগুমুনি কাগয়ুং
Mahendra Bara|মহেন্দ্ৰ বৰা
Shane Reti|Shane Reti
Manas Robin|মানস ৰবীন
Pushpa Bhuyan|পুষ্পা ভূঞা
Radhika Madan|ৰাধিকা মাদান
Indulata Sukla|ইন্দুলতা শুক্লা
|কৱীন্দ্ৰ পাত্ৰ
|গাগিনী ডেকা মহন্ত
|জুবলী বৰুৱা
|স্বৰ্ণলতা বৰুৱা
Kamal Narayan Choudhury|কমল নাৰায়ণ চৌধুৰী
Arushi Nishank|আৰুচি নাশিক
Queen Hazarika|কুইন হাজৰিকা
Maia Weinstock|মাইৱা ৱিনষ্টক
Kanta Gupta|কান্তা গুপ্তা
Meena Shorey|মীনা শোৰী
Laxmirani Majhi|লক্ষ্মীৰাণী মাঝি
Begum Zaffar Ali|বেগম জাফৰ আলী
Jan Pawlowski|Jan Pawlowski
Hema Bharali|হেম ভৰালী
Rabindra Sarkar|ৰবীন্দ্ৰ সৰকাৰ
Lionel Cavin|Lionel Cavin
Charles M. Rice|চাৰ্লছ এম. ৰাইচ
Kənan Rzayev|Kanan Rzayev
Jatin Goswami|যতীন গোস্বামী
Jean-Philippe Anstett|Jean-Philippe Anstett
Satyendranath Sarma|সত্যেন্দ্ৰনাথ শৰ্মা
|তাৰিকুদ্দিন আহমেদ
Ajaleetora Neog|আজলীতৰা নেওগ
|মহেশ্বৰ বসুমতাৰী
Dinesh Das|দীনেশ দাস
Gagandeep Kang|গগনদীপ কাং
Bibhuti Lahkar|বিভুতি লহকৰ
Alaa Youssef|Alaa Fatty
Suman Haripriya|সুমন হৰিপ্ৰিয়া
Alfa Tofft|Alfa Tofft
Kanu Gandhi|কানু গান্ধী
Günther Chiwitt|Günther Chiwitt
Jerzy Chojnacki|Jerzy Chojnacki
Andrzej Dyżakowski|Andrzej Dyżakowski
Jadwiga Ferenstein|Jadwiga Ferenstein
Eugeniusz Jaromin|Eugeniusz Jaromin
Wanda Wegner|Wanda Wegner
Włodzimierz Kacprzak|Włodzimierz Kacprzak
Małgorzata Izydorczak|Małgorzata Izydorczak
Wojciech Starkowski|Wojciech Starkowski
Joachim Krawczyk|Joachim Krawczyk
Cezary Hryciuk|Cezary Hryciuk
Magdalena Konopka|Magdalena Konopka
Adrian Bąk|Adrian Bąk
Marcin Zejmowicz|Marcin Zejmowicz
Ewa Jarocka|Ewa Jarocka
Aneta Walentukanis|Aneta Walentukanis
Lech Dryżałowski|Lech Dryżałowski
Hana Snochowska|Hana Snochowska
Mariola Klonowska|Mariola Klonowska
Maria Dobrowolska|Maria Dobrowolska
Iwona Szymańska|Iwona Szymańska
Dariusz Kaczmarczyk|Dariusz Kaczmarczyk
Michał Mirowski|Michał Mirowski
Agata Stelmaszczyk|Agata Stelmaszczyk
Dominika Guzik-Płuchowska|Dominika Guzik-Płuchowska
Agata Rzepczyk|Agata Rzepczyk
Kornelia Kowalczyk|Kornelia Kowalczyk
David Domínguez|David Domínguez
Topsy Phiri|Topsy Phiri
Alicia Calonge|Alicia Calonge
Anastasia Medvedeva|Anastasia Medvedeva
Ann Christine Tengström|Ann Christine Tengström
Baby Salahuddin|Baby Salahuddin
Christine Dahlberg|Christine Dahlberg
Daniela Cuba|Daniela Cuba
Deborah Ukeh|Deborah Ukeh
Edurne Echarri|Edurne Echarri
Felix Burestedt|Felix Burestedt
G. A. Kapadia|G. A. Kapadia
G. Goodchild|G. Goodchild
Jan Holtnæs|Jan Holtnæs
Janke van der Vyver|Janke van der Vyver
Jason Wong|Jason Wong
Jennifer Wong|Jennifer Wong
José Isasi|José Isasi
Jouko Degerth|Jouko Degerth
Kim Hyang-im|Kim Hyang-im
Lee Yen Khoo|Lee Yen Khoo
Liselotte Nielsen|Liselotte Nielsen
Marlin Maldonado|Marlin Maldonado
Mary O'Connor|Mary O'Connor
Mathilde Cramer Ahrens|Mathilde Cramer Ahrens
Mette Myhre|Mette Myhre
Niclas Højgaard Eysturoy|Niclas Højgaard Eysturoy
Ørvar Tollås|Ørvar Tollås
Paula La Torre Regal|Paula La Torre Regal
Petr Beran|Petr Beran
Roy Purnomo|Roy Purnomo
Rubén Castellanos|Rubén Castellanos
Sartono Ekopranoto|Sartono Ekopranoto
Sergei Korsunski|Sergei Korsunski
Tomoya Takashina|Tomoya Takashina
Ahsan Qamar|Ahsan Qamar
Alan McMillan|Alan McMillan
Alejandro Alcalá|Alex Alcala Dominguez
Alexander Gutko|Alexander Gutko
Ana Amador|Ana Amador
Andrea Tuckett|Andrea Tuckett
Ben Williams|Ben Williams
Bobby Chee|Bobby Chee
Boris Barshakh|Boris Barshakh
Cedric Grosjean|Cedric Grosjean
Chinami Okui|Chinami Okui
Danylo Bosniuk|Danylo Bosniuk
Darren Reid|Darren Reid
David Kaviladze|David Kaviladze
Elinor Lystad|Elinor Lystad
Elisa Borrás|Elisa Borrás
Ferdy Wirinata|Ferdy Wirinata
Grace Chua Hui Zhen|Grace Chua Hui Zhen
Ivan Nikitin|Ivan Nikitin
Javeria Tahir|Javeria Tahir
Javier Tur|Javier Tur
Johanna Luostarinen|Johanna Luostarinen
Jonas Ericsson|Jonas Ericsson
Kasper Paulsen|Kasper Paulsen
Katsuki Domoto|Katsuki Domoto
Kazuya Itani|Kazuya Itani
Elizabeth Nuza|Elizabeth Nuza
Lisandra Suárez|Lisandra Suárez
Lise Vooren|Lise Vooren
Lizzie Tolman|Lizzie Tolman
Lubov Ledneva|Lubov Ledneva
Margot de Balbuena|Margot de Balbuena
Maria Alonso|Maria Alonso
Maria Delia Zambrano Solano|Maria Delia Zambrano Solano
Marianne Christensen|Marianne Christensen
Mariano Yanga|Mariano Yanga
Mathias Mundbjerg|Mathias Mundbjerg
Michael Scholes|Michael Scholes
Mihaela Neycheva|Mihaela Neycheva
Mogens Nielsen|Mogens Nielsen
Mohamed Guelmaoui|Mohamed Guelmaoui
Nanna Vestergaard|Nanna Vestergaard
Natasha Sharp|Natasha Sharp
Nathan Osborne|Nathan Osborne
Niels Christensen|Niels Christensen
Pat Ellis|Pat Ellis
Raquel Miguens|Raquel Miguens
Rayna Philipps|Rayna Philipps
Rinov Rivaldy|Rinov Rivaldy
Simone Jegge|Simone Jegge
Søren Christensen|Søren Christensen
Søren Frandsen|Søren Frandsen
Steen Thygesen-Poulsen|Steen Thygesen-Poulsen
Steven Higgins|Steven Higgins
Susanne Mølgaard Hansen|Susanne Mølgaard Hansen
Tore Engebretsen|Tore Engebretsen
Víctor Alcaide|Víctor Alcaide
Vyacheslav Nazarenko|Vyacheslav Nazarenko
W. F. Foo|W. F. Foo
Cory Fanus|Cory Fanus
Anjali Paragsingh|Anjali Paragsingh
Agustin Klein|Agustin Klein
Ammar Zeradine|Ammar Zeradine
Anders Hansson|Anders Hansson
Andrea Sailer|Andrea Sailer
Anna Hagspiel|Anna Hagspiel
Anthony Chang|Anthony Chang
Araz Soltanaliyev|Araz Soltanaliyev
Armine Manukyan|Armine Manukyan
Ashley Moss|Ashley Moss
B. Kren|B. Kren
Bianca Schiester|Bianca Schiester
C. Fildes|C. Fildes
Carmen Schreiber|Carmen Schreiber
Carolina Lux|Carolina Lux
Clara Bertagno|Clara Bertagno
Elaine Wong|Elaine Wong
Erika Streicher|Erika Streicher
Ezequiel Garmendia|Ezequiel Garmendia
G. Genders|G. Genders
Gabriel Ladstätter|Gabriel Ladstätter
Gerhard Nöhrer|Gerhard Nöhrer
H. Tattersall|H. Tattersall
Harald Hochgatterer|Harald Hochgatterer
Heidi Losek|Heidi Losek
Helen Young|Helen Young
Helmut Kraule|Helmut Kraule
Hsieh Chia-Ju|Hsieh Chia-Ju
Ingela Freiman|Ingela Freiman
Jane Bennett|Jane Bennett
Jaqueline Lampert|Jaqueline Lampert
Jeanette Ryrman|Jeanette Ryrman
Jennifer van den Berg|Jennifer van den Berg
Jiten Bhatt|Jiten Bhatt
Johannes Wackerle|Johannes Wackerle
Johnny Tjoa|Johnny Tjoa
Josef Hortnagel|Josef Hortnagel
Julia Herndlhofer|Julia Herndlhofer
Karin Steidl|Karin Steidl
Kurt Kenzian|Kurt Kenzian
Laura Demmelmayer|Laura Demmelmayer
Laura Thouyaret|Laura Thouyaret
Lee Ming-Hwa|Lee Ming-Hwa
Iván León|León Ivan
Leslie Teng Pang Liang|Leslie Teng Pang Liang
Lilit Minasyan|Lilit Minasyan
Liu Haichao|Liu Haichao
Lusine Arzcyan|Lusine Arzcyan
M. Lockwood|M. Lockwood
Manuela Hoheneder|Manuela Hoheneder
Margot Strehlan|Margot Strehlan
Marieta Nikoyan|Marieta Nikoyan
Martín Villalba|Martín Villalba
Michael Neufellner|Michael Neufellner
Michelle Tam|Michelle Tam
Ni Bowen|Ni Bowen
Nicolas Rudolf|Nicolas Rudolf
Nurane Akperova|Nurane Akperova
Papatsorn Eksorakul|Papatsorn Eksorakul
Peggy Lim|Peggy Lim
Peter Shepperd|Peter Shepperd
Philip Katsaros|Philip Katsaros
Philipp Haidinger|Philipp Haidinger
Ramdhani Muhammad Zulkifli|Ramdhani Muhammad Zulkifli
Raul Blondet Martinez|Raul Blondet Martinez
Redi Cufo|Redi Cufo
Reinard Louw|Reinard Louw
Rodrigo Camogliano Telge|Rodrigo Camogliano Telge
Rüdiger Gnedt|Rüdiger Gnedt
Sabina Mamedova|Sabina Mamedova
Sabine Ferner|Sabine Ferner
Sandra Egger|Sandra Egger
Simon Rebhandl|Simon Rebhandl
Stefan Ratheyser|Stefan Ratheyser
Teresa Lian|Teresa Lian
Thomas Thurnher|Thomas Thurnher
Valentin Taupe|Valentin Taupe
Verena Lunardon|Verena Lunardon
Vuqar Abdullayev|Vuqar Abdullayev
Walter Dangl|Walter Dangl
Werner Cermak|Werner Cermak
Yacine Balahouane|Yacine Belhouane
Zahira Yakubova|Zahira Yakubova
Zani van der Merwe|Zani van der Merwe
Rahul Yadav Chittaboina|Rahul Yadav Chittaboina
A. E. Sandrai|A. E. Sandrai
A. Mayer|A. Mayer
Abigail García|Abigail García
Adnan Ebrahim|Adnan Ebrahim
Afshin Bozorgzadeh|Afshin Bozorgzadeh
Alexandru Rosca|Alexandru Rosca
Alexey Shishov|Alexey Shishov
Alluddin|Alluddin
Anait Khurshudyan|Anait Khurshudyan
Armin Hartmann|Armin Hartmann
B. Smith|B. Smith
Beelall Bhurtun|Beelall Bhurtun
Benoît Delvaux|Benoît Delvaux
Bettina Mayer|Bettina Mayer
Birgit Schönharting|Birgit Schönharting
Blair Kitchener|Blair Kitchener
Brent Chapman|Brent Chapman
Byron Smith|Byron Smith
Carolina Pizarro|Carolina Pizarro
Chan Tin Chua|Chan Tin Chua
Christa Hökel|Christa Hökel
Christian Bene|Christian Bene
Christian Beutel|Christian Beutel
Christine Selchow|Christine Selchow
Christopher Paul|Christopher Paul
Claudia Weiser|Claudia Weiser
Clemens Rocholl|Clemens Rocholl
Dagva Enkhtsetseg|Dagva Enkhtsetseg
Dalli Cardillo|Dalli Cardillo
Daniel Martinez|Daniel Martinez
Daniel Orozco|Daniel Orozco
de Barry|de Barry
Delius Tang|Delius Tang
Emilia Gómez Luna|Emilia Gómez Luna
Floris Oleffe|Floris Oleffe
Fredyno Saha|Fredyno Saha
G. A. Pearce|G. A. Pearce
Gábor Óvári-Kerti|Gábor Óvári-Kerti
Gert Poesen|Gert Poesen
Glen Barker|Glen Barker
Gregory Schneider|Gregory Schneider
Greig Bramwell|Greig Bramwell
Habib Hasan|Habib Hasan
Heike Hamm|Heike Hamm
Liang Hua-Chun|Hua Chun Liang
Indra Mahata|Indra Mahata
J. Manton|J. Manton
Jakaria Islam|Jakaria Islam
Jan Daems|Jan Daems
Jana Tegethoff|Jana Tegethoff
Jane Byram|Jane Byram
Jente Paesen|Jente Paesen
Jin Yong-hoon|Jin Yong-hoon
Jochen Zepmeisel|Jochen Zepmeisel
Johannes Johari|Johannes Johari
Josefina de Tinoco|Josefina de Tinoco
Justine Godfroid|Justine Godfroid
Kathrin Hoffmann|Kathrin Hoffmann
Kazi Hasinur Rahman Shakil|Kazi Hasinur Rahman Shakil
Kerstin Wagner|Kerstin Wagner
Koen Verleyen|Koen Verleven
Kristof van Landschoot|Kristof van Landschoot
Kuhoo Garg|Kuhoo Garg
L. Leslie|L. Leslie
Laidlaw|Laidlaw
Leann Alwine|Leann Alwine
Lim Theam Teow|Lim Theam Teow
Lorenzo Ruíz|Lorenzo Ruíz
M. Ali Aiub|M. Ali Aiub
Mahbubur Rob|Mahbubur Rob
Mahmudur Rahman Mahi|Mahmudur Rahman Mahi
Mamunur Rashid|Mamunur Rashid
Maria Desy|Maria Desy
Maria Elena Vivanco|Maria Elena Vivanco
Maria Mata Masinipeni|Maria Mata Masinipeni
Maria Mørk|Maria Mørk
Mariana Ibarra|Mariana Ibarra
Marie-Christine Donnay|Marie-Christine Donnay
Mark Byerly|Mark Byerly
Maryse Deruyver|Maryse Deruyver
Natalie Tropf|Natalie Tropf
Nighat|Nighat
Oleg Evgrafov|Oleg Evgrafov
Oleg Evstafiev|Oleg Evstafiev
Olga Kostuchik|Olga Kostuchik
Parvin|Parvin
Peter Mayer|Peter Mayer
R. F. Hull|R. F. Hull
Rashida|Rashida
Ray Rofe|Ray Rofe
Regina Müller|Regina Müller
Roberto Arredondo|Roberto Arredondo
Roxane Hens|Roxane Hens
Rüttner|Rüttner
Ryhor Vorobev|Ryhor Vorobev
S. J. Miller|S. J. Miller
S. S. Jbr|S. S. Jbr
Sabana Hossain|Sabana Hossain
Shek Abul Hashem|Shek Abul Hashem
Shonette Wilson|Shonette Wilson
Sibylle Holz|Sibylle Holz
Siew Yian Wai|Siew Yian Wai
Simone Hilt|Simone Hilt
Stephen McPhail|Stephen McPhail
Sumi|Sumi
Surgent|Surgent
Susanne Höfle|Susanne Höfle
Sylvie Donnay|Sylvie Donnay
Tajul Islam|Tajul Islam
Tamiko Foster|Tamiko Foster
Tara Aboobakar|Tara Aboobakar
Ulla Helm|Ulla Heim
Volker Herok|Volker Herok
Vulu|Vulu
Wendy Taylor|Wendy Taylor
Wilfried Pritzlaff|Wilfried Pritzlaff
Therry Aquino|Therry Aquino
Philip Seerup|Philip Seerup
Matthew Michel|Matthew Michel
M. Anilkumar Raju|M. Anilkumar Raju
Venkat Gaurav Prasad|Gaurav Venkat
Godwin Mathumo|Godwin Mathumo
Asrar Seid|Asrar Seid
Rajdweep|ৰাজদ্বীপ
Francisco Alonso Martos|Francisco Alonso Martos
Jesús Martínez Verón|Jesús Martínez Verón
Joaquín de la Concha Alcalde|Joaquín de la Concha Alcalde
Felipe Medina Benjumea|Felipe Medina Benjumea
Ritu Karidhal|ৰিতু কাৰিধল
Manushi Chhillar|মানুষী চিল্লাৰ
Chandana Goswami|চন্দনা গোস্বামী
Samir Kumar Saha|সমীর কুমার সাহা
Birubala Rabha|বিৰুবালা ৰাভা
Konstantina Sintzaniki|Konstantina Syntzanaki
Godawari Dutta|গোদাৱৰী দত্ত
|ইনামুল হক
Eva Asao|ইভা আচাও
Anil Adhikari|অনিল অধিকাৰী
Pranita Talukdar|প্ৰণিতা তালুকদাৰ
Mohan Das|মোহন দাস
Sunita Bhuyan|সুনীতা ভূঞা
Arun Nath|অৰুণ নাথ
Santwana Bardoloi|সান্ত্বনা বৰদলৈ
Douglas Stuart|ডগলাছ ষ্টুৱাৰ্ট
Gjergj Zefi|Gjergj Zefi
Linus Kvist|Linus Kvist
Erki Laanemäe|Erki Laanemäe
Ingram Cuff|Ingram Cuff
Nikita Stenkovoy|Nikita Stenkovoy
Maria Ögn Gudmundsdottir|Maria Ögn Gudmundsdottir
Cornelia Cyrus|Cornelia Cyrus
Ioulia Eremeeva|Ioulia Eremeeva
Julia Bradley|Julia Bradley
Simona Wagnerova|Simona Wagnerova
Sara Savino|Sara Savino
Guna Sindhu Hazarika|গুণসিন্ধু হাজৰিকা
Florian Auer|Florian Auer
Emīls Cipulis|Emīls Cipulis
Marián Skupek|Marián Skupek
Adam Dobeš|Adam Dobeš
Mara Morell|Mara Morell
Dylan Sorensen|Dylan Sorensen
Bhitali Das|ভিতালী দাস
Jonas Oehmichen|Jonas Oehmichen
Abraham Lincoln|আব্ৰাহাম লিংকন
Lionel Messi|লিঅ'নেল মেছি
Charlie Chaplin|চাৰ্লি চেপলিন
Julius Caesar|জুলিয়াছ চিজাৰ
Vladimir Lenin|ভ্লেডিমিৰ লেনিন
Ferdinand Magellan|ফাৰ্ডিনেণ্ড মেগালান
Neil Armstrong|নীল আৰ্মষ্ট্ৰং
Raphael|ৰাফায়েল
James Cook|জেমছ কুক
Kamala Sohonie|কমলা সাহানী
Leonhard Euler|লিঅ'নাৰ্ড অইলাৰ
Akira Kurosawa|আকিৰা কুৰোছাৱা
Nelson Mandela|নেলছন মেণ্ডেলা
Satyajit Ray|সত্যজিৎ ৰায়
Steven Spielberg|ষ্টিভেন স্পিলবাৰ্গ
Aamir Khan|আমিৰ খান
Tipu Sultan|টিপু চুলতান
Pelé|পেলে
Xi Jinping|ছি জিনপিং
Tenzin Gyatso|টেনজিং গিয়াত্‍ ছো
Donald Trump|ডোনাল্ড ট্রাম্প
Yash Chopra|য়শ চোপ্ৰা
Scarlett Johansson|স্কাৰলেট জ'হানছন
Omar Khayyám|ওমৰ খৈয়াম
Werner Heisenberg|হাইজেনবাৰ্গ
Carl Jung|কাৰ্ল গুষ্টাভ য়ুং
Xuanzang|হিউৱেন-চাঙ
Raima Sen|ৰাইমা সেন
Esha Deol|ঈশা দেউল
Toni Morrison|টনি মৰিছন
Raymond Tomlinson|ৰেই টম্‌লিনছন
Bhimsen Joshi|ভীমসেন জোশী
Subrahmanyan Chandrasekhar|সুব্ৰহ্মণ্যন চন্দ্ৰশেখৰ
Imran Khan|ইমৰান খান
Sarvepalli Radhakrishnan|সৰ্বপল্লী ৰাধাকৃষ্ণণ
Tabu|টবু
Nargis|নাৰ্গিছ
Maggie Smith|মেগী স্মিথ
Premchand|প্ৰেমচন্দ
Verghese Kurien|ভাৰ্গিজ কুৰিয়েন
Rani Lakshmibai|ৰাণী লক্ষ্মীবাই
Kareena Kapoor|কৰীণা কাপোৰ
Jetsun Pema|জেৎচুন পেমা
Arundhati Roy|অৰুন্ধতী ৰায়
Kiran Desai|কিৰণ দেশাই
Anna Hazare|আন্না হাজাৰে
Junko Tabei|জুংক' টাবেই
Sushmita Sen|সুস্মিতা সেন
Shakib Al Hasan|ছাকিব আল হাছান
Nara Narayan|নৰনাৰায়ণ
R. Venkataraman|আৰ ভেঙ্কটৰমন
Hans Christian Gram|হান্স খ্ৰীষ্টিয়ান গ্ৰাম
Faxian|ফা-হিয়েন
M. N. Roy|মানবেন্দ্ৰ নাথ ৰয়
Silambarasan Rajendar|সিলামবৰসন ৰাজেন্দৰ
Amrish Puri|অমৰীশ পুৰী
Rahul Bose|ৰাহুল বসু
Jyoti Prasad Agarwala|জ্যোতিপ্ৰসাদ আগৰৱালা
Koel Mullick|কোয়েল মল্লিক
Sarat Chandra Chattopadhyay|শৰৎচন্দ্ৰ চট্টোপাধ্যায়
Ruby Myers|ৰুবি মায়াৰ্ছ
Gayatri Devi|গায়ত্ৰী দেৱী
Phoolan Devi|ফুলন দেৱী
Mamata Banerjee|মমতা বন্দ্যোপাধ্যায়
Anushka Sharma|অনুষ্কা শৰ্মা
Meera|মীৰাবাঈ
Vyjayanthimala|বৈজয়ন্তীমালা
Tukaram|তুকাৰাম
Chetana Das|চেতনা দাস
Bhanu Athaiya|ভানু আথাইয়া
Sunil Gavaskar|সুনীল গাভাস্কাৰ
Manik Sarkar|মাণিক চৰকাৰ
Priyanka Vadra|প্ৰিয়ংকা গান্ধী
Arthur Ashkin|আৰ্থাৰ অস্কিন
Valmiki|বাল্মীকি
Bhupen Hazarika|ভূপেন হাজৰিকা
Bhumidhar Barman|ভূমিধৰ বৰ্মন
Supratisthita Varman|সুপ্ৰতিষ্ঠ বৰ্মা
Tim Dettmann|Tim Dettman
Paul Milgrom|প'ল আৰ. মিলগ্ৰম
Manohar Parrikar|মনোহৰ পাৰিকৰ
G. Madhavan Nair|জি. মাধৱন নায়াৰ
Amrita Pritam|অমৃতা প্ৰীতম
Kamalakanta Bhattacharya|কমলাকান্ত ভট্টাচাৰ্য্য
Steffan Pandya|Stefan Pandya
Louise Glück|লুইচ গ্লিক
Sister Nivedita|ভগিনী নিবেদিতা
Val Gow|Val Johnson
Homai Vyarawalla|হোমাই ভ্যাৰাৱালা
Seema Biswas|সীমা বিশ্বাস
Govind Ballabh Pant|গোবিন্দ বল্লভ পণ্ট
Haldhar Nag|হলধৰ নাগ
Nalini Jaywant|নলিনী জয়ৱন্ত
Uma Bharti|উমা ভাৰতী
Yusuf Estes|ইউছুফ এষ্টেছ
Rani Durgavati|ৰাণী দুৰ্গাৱতী
Shrikant Jichkar|শ্ৰীকান্ত জিচকাৰ
Justin Knapp|জাষ্টিন নেপ
Debashree Roy|দেৱাশ্ৰী ৰয়
Diana Edulji|ডায়েনা এডুলজি
Siddheshwari Devi|সিদ্ধেশ্বৰী দেৱী
Hiren Bhattacharyya|হীৰেন ভট্টাচাৰ্য
Birendra Kumar Bhattacharya|বীৰেন্দ্ৰ কুমাৰ ভট্টাচাৰ্য
Ekta Kapoor|একতা কাপুৰ
Parveen Sultana|পাৰবীন চুলতানা
Roopmati|ৰূপমতী
Abhijeet Sawant|অভিজিত শাৱন্ত
Ronit Roy|ৰোনিত ৰয়
Afsana Mimi|আফচানা মিমি
Atreya|আত্ৰেয়
Axl Hazarika|Axl Hazarika
Bijoy Chandra Bhagavati|বিজয় চন্দ্ৰ ভাগৱতী
Chitralekha|চিত্ৰলেখা
Dasarath Deb|দশৰথ দেৱ
Dipak C. Jain|দীপক চন্দ্ৰ জৈন
Dipannita Sharma|দীপান্বিতা শৰ্মা
Dolly Guleria|ডলী গুলেৰীয়া
Githa Hariharan|গীতা হৰিহৰণ
Haimanti Sukla|হৈমন্তী শুক্লা
Hem Barua|হেম বৰুৱা
Henry John Stedman Cotton|হেনৰী ষ্টাডমেন কটন
Lakshminath Bezbarua|লক্ষ্মীনাথ বেজবৰুৱা
Indrani Haldar|ইন্দ্ৰানী হালদাৰ
Ismail Hussain|ইছমাইল হুচেইন
Kamini Kaushal|কামিনী কৌশল
Kamlabai Gokhale|কমলাবাঈ গোখলে
Kashmiri Saikia Baruah|কাশ্মীৰি শইকীয়া বৰুৱা
Kunal Ganjawala|কুনাল গাঞ্জাৱালা
Lakshyadhar Choudhury|লক্ষ্যধৰ চৌধুৰী
Lalrin Fela|লাল্ৰিন ফেলা
Luipa|লুইপাদ
Manoj Kumar Goswami|মনোজ কুমাৰ গোস্বামী
Matangini Hazra|মাতঙ্গিনী হাজৰা
Muhammed Saadulah|চৈয়দ মহম্মদ ছাদুল্লা
Nabaneeta Dev Sen|নৱনীতা দেৱ সেন
Nakul Chandra Bhuyan|নকুলচন্দ্ৰ ভূঞা
Narayan Chandra Borkataky|নাৰায়ণ চন্দ্ৰ বৰকটকী
Nipon Goswami|নিপন গোস্বামী
Nisha Aggarwal|নিশা আগৰৱাল
Nongthombam Biren Singh|এন. বিৰেন সিং
Purandar Singha|পুৰন্দৰ সিংহ
Raju Gaikwad|ৰাজু গাইক্বাদ
Ramesh C. Deka|ৰমেশ চন্দ্ৰ ডেকা
Ravuri Bharadhwaja|ৰাভুৰি ভৰদ্বাজ
Richard William Timm|ৰিচাৰ্ড উইলিয়াম টিম
Romit Raj|ৰোমিত ৰাজ
Rukmini Vijayakumar|ৰুক্মিনী বিজয়াকুমাৰ
Santosh Mohan Dev|সন্তোষ মোহন দেৱ
Buta Singh|বুটা সিং
Shabnam Mausi|শবনম মৌচি
Shamsuddin Ahmad Shah|চামচুদ্দিন আহমদ শ্বাহ
Shankha Ghosh|শংখ ঘোষ
Smriti Irani|স্মৃতি ইৰানী
Suklamphaa|চুক্লমফা
Sumitra Mahajan|সুমিত্ৰা মহাজন
Sutuphaa|চুতুফা
Tara Sharma Saluja|তাৰা শৰ্মা
Tiago Manuel Fernandes Ribeiro|তিয়াগ' ৰিবেইৰ'
Urmila Pawar|উৰ্মিলা পাৱাৰ
Utpal Datta|উৎপল দত্ত
Vishaka Hari|বিশাখা হৰি
Uddhab Bharali|উদ্ধৱ ভৰালী
Nora Polley|নোৰা পোলী
Chandradhar Barua|চন্দ্ৰধৰ বৰুৱা
Jnanadabhiram Barua|জ্ঞানদাভিৰাম বৰুৱা
Srikanth Kidambi|শ্ৰীকান্ত কিদাম্বি
Nagendra Narayan Choudhury|নগেন্দ্ৰ নাৰায়ণ চৌধুৰী
Mavis Kerr|Mavis Potts
B. Vijayalakshmi|বি.বিজয়ালক্ষ্মী
Sharmila Biswas|শৰ্মিলা বিশ্বাস
Alwin Francis|Francis Alwin
Kamla Bhasin|কমলা ভাচিন
Kasturi Pattanaik|কস্তুৰী পট্টানাইক
Jaya Bhattacharya|জয়া ভট্টাচাৰ্য
Barsha Rani Bishaya|বৰ্ষাৰাণী বিষয়া
Kalpana Patowary|কল্পনা পাটোৱাৰী
Rameswar Teli|ৰামেশ্বৰ তেলী
Bhogeswar Baruah|ভোগেশ্বৰ বৰুৱা
Li Shengpeng|Li Shengpeng
Patralekha Paul|পত্ৰলেখা পাল
Atulananda Goswami|অতুলানন্দ গোস্বামী
Keerthy Suresh|কীৰ্তি সুৰেশ
Saikhom Mirabai Chanu|চাইখম মীৰাবাই চানু
Maya Rao|মায়া ৰাও
Bishnu Kharghoria|বিষ্ণু খাৰঘৰীয়া
Ajit Barua|অজিৎ বৰুৱা
Bal Dattatreya Tilak|বাল দত্তাত্রেয় তিলক
Kenny Basumatary|কেনী বসুমতাৰী
Hemendra Prasad Barooah|হেমেন্দ্ৰ প্ৰসাদ বৰুৱা
Binny Yanga|বিন্নী য়াংগা
Bhakti Sharma|ভক্তি শৰ্মা
Aisha Chaudhary|আয়েশা চৌধুৰী
Utpal Das|উৎপল দাস
|নয়ন নীলিম
Uthara Unnikrishnan|উত্তৰা উন্নিকৃষ্ণন
Amalprava Das|অমলপ্ৰভা দাস
Anna Rajam Malhotra|আন্না ৰাজম মলহোত্ৰা
Anupam Sen|অনুপম সেন
Vanaja Iyengar|ভানাজা আয়েংগাৰ
Gulab Bai|গুলাব বাই
Hamza Bendelladj|হামজা বেনডল্লাজ
Muniba Mazari|মুনিবা মাজাৰি
Mangala Narlikar|মংগলা নাৰ্লিকাৰ
Vojtech H. Lindtner|Vojtech H. Lindtner
Pali Chandra|পালি চন্দ্ৰা
Harris J|হেৰিছ জং
Philipp Wobeto|Philipp Wobeto
Baisali Mohanty|বাইশালী মহান্তি
Priyadarshini Chatterjee|প্ৰিয়দৰ্শনী চেটাৰ্জী
Rémi Brazeilles|Rémi Brazeilles
Shakuntala Gamlin|শকুন্তলা দলে গামলিন
Sonia Fisch-Muller|Sonia Fisch-Muller
Sneha Devi|স্নেহ দেৱী
Bhrigu Phukan|ভৃগু কুমাৰ ফুকন
Dandinath Kalita|দণ্ডিনাথ কলিতা
|পল ফুকন
|প্ৰসেন বৰা
Hiren Gohain|হীৰেন গোহাঁই
Laurent Vallotton|Laurent Vallotton
Aditya Hari Sasongko|Aditya Hari Sasongko
Sachin Dias|Angodavidanalage Dias
Jóhann Kjartansson|Jóhann Kjartansson
Bijoy Sankar Barman|বিজয় শংকৰ বৰ্মন
Rosalia Anastasia|Agnastasia R.
Zbigniew Kościelniak|Zbigniew Kościelniak
Irena Józefowicz|Irena Józefowicz
Marek Danowski|Marek Danowski
Henryk Sienkiewicz|Henryk Sienkiewicz
Krystyna Markowicz|Krystyna Markowicz
Adam Jaromin|Adam Jaromin
Mirosław Żyniewicz|Mirosław Żyniewicz
Ryszard Werbliński|Ryszard Werbliński
Irena Rogula|Irena Rogula
Ewa Ochman|Ewa Ochman
Sylwia Bochat|Sylwia Bochat
Krzysztof Maślanka|Krzysztof Maślanka
Przemysław Urban|Przemysław Urban
Patryk Szymoniak|Patryk Szymoniak
Martyna Poprzeczko|Martyna Poprzeczko
Dominika Cygan|Dominika Cygan
Marcin Burzyński|Marcin Burzyński
Paweł Kościelniak|Paweł Kościelniak
Aleksandra Goszczyńska|Aleksandra Goszczyńska
Wiktoria Dąbczyńska|Wiktoria Dąbczyńska
Mateusz Świerczyński|Mateusz Świerczyński
Jing Yu Hong|Jing Yu Hong
Mathieu Pohl|Mathieu Pohl
Alejandro Ferrer|Alejandro Ferrer
Alejo Javier Ibeas|Alejo Ibeas
Alice Wu|Alice Wu
Anri Schoones|Anri Schoones
Bruno Wackfelt|Bruno Wackfelt
Christine Busch Andreasen|Christine Busch Andreasen
Daniel Sánchez|Daniel Sánchez
Daniela Zapata|Daniela Zapata
Evgeniy Dayanov|Evgeniy Dayanov
Gloria Kondo|Gloria Kondo
Ingrid Rogiers|Ingrid Rogiers
Ira Banerjee|Ira Banerjee
Jens Maibom|Jens Maibom
José Guevara|José Guevara
Keng See Ching|Keng See Ching
Kingsley Nelson|Kingsley Nelson
Lars Kotte|Lars Kotte
Leidis Mora|Leidis Mora
Lillian Johansson|Lillian Johansson
Matéo Martinez|Matéo Martinez
Mette Hansen|Mette Hansen
Mikhail Chervyakov|Michail Chervyakov
Nick Marks|Nick Marks
Noora Ahola|Noora Ahola
Per Nielsen|Per Nielsen
Peter Gardner|Peter Gardner
Shaama Sandooyeea|Shaama Sandooyeea
Simone von Rotz|Simone von Rotz
John Hollier|John Hollier
Alberto Perez|Alberto Perez
Álvaro Vázquez|Alvaro Vazquez
Anders Andersen|Anders Andersen
Anjum Bashir|Anjum Bashir
Annie Xu|Annie Xu
Armelle Cassen|Armelle Cassen
Ashley Spencer|Ashley Spencer
C. Chua|C. Chua
Carl-Johan Nybergh|Carl-Johan Nybergh
Daniel Seifert|Daniel Seifert
Daxxon Vong|Daxxon Vong
Els van Eeuwijk|Els van Eeuwijk
Elizaveta Tarasova|Elizaveta Tarasova
Ghazala Saddique|Ghazala Saddique
Göran Sterner|Göran Sterner
Hugo Madsen|Hugo Madsen
Rebecca Sita|Rebecca Sita
Inger Mette Bjørvik|Inger Mette Bjørvik
José Matos|José Matos
Joshua Apiliga|Joshua Apiliga
Lester Oey|Lester Oey
Lone Rasmussen|Lone Rasmussen
Ma Songfeng|Ma Songfeng
Maarit Jaakkola|Maarit Jaakkola
Maja Bech|Maja Bech
Maria A. Bosque|Maria A. Bosque
Maria Sofronova|Maria Sofronova
Mette Wildhagen|Mette Wildhagen
Mike Parker|Mike Parker
Momoh Zainab|Momoh Zainab
Nathan Hannam|Nathan Hannam
Nazlıcan İnci|Nazlıcan İnci
Nikolay Balakirev|Nikolay Balakirev
Pamela Macaya|Pamela Macaya
Phanuwat Srimanta|Phanuwat Srimanta
Poul Anker|Poul Anker
Quijada Willfer|Quijada Willfer
Rachel Cameron|Rachel Cameron
Rafael Vázquez|Rafael Vazquez
Rei Sato|Rei Sato
Rolf Monteiro|Rolf Monteiro
Youcef Sabri Medel|Sabri Medel
Salim|Salim
Sanni Jaakkola|Sanni Jaakkola
Tan Jia Wei|Tan Jia Wei
Tor Egil Kristensen|Tor Egil Kristensen
Tuomas Palmqvist|Tuomas Palmqvist
Tuuli Härkönen|Tuuli Härkönen
Vania Arianti Sukoco|Vania Arianti Sukoco
Vicente Ortgosa|Vicente Ortgosa
Víctor Pérez|Víctor Pérez
Wilhelm Koren|Wilhelm Koren
Sherifa Jameson|Sherifa Jameson
Alistair Espinoza|Alistair Espinoza
Yamit Gironza|Yamit Gironza
A. Adamu|A. Adamu
Alfred Pautsch|Alfred Pautsch
Andrea Somrau|Andrea Somrau
Andrej Serov|Andrej Serov
Anita Raunig|Anita Raunig
Bagas Maulana|Bagas Maulana
Barbara Scheer|Barbara Scheer
Ben Lee|Ben Lee
Bernd Sagmeister|Bernd Sagmeister
Bernd Thormann|Bernd Thormann
Candace Mann|Candace Mann
Celica Christensen|Celica Christensen
Celina Juarez|Celina Juarez
Christina Chan|Christina Chan
Christl Keberschak|Christl Keberschak
Colin Cutt|Colin Cutt
Daniel Walchshofer|Daniel Wachshofer
Daniel Wolf|Daniel Wolf
E. H. Smith|E. H. Smith
Edgar Nazaretyan|Edgar Nazaretyan
Elnara Nasrullayeva|Elnara Nasrullayeva
Fei Fei He|Fei Fei He
Fritz Skiba|Fritz Skiba
G. Yeang|G. Yeang
Gabriele Freuis|Gabriele Freuis
Gayane Mkrtchyan|Gayane Mkrtchyan
Gerrelyn Glico|Gerrelyn Glico
Gertrude Gröss|Gertrude Gröss
Gregor Radner|Gregor Radner
Hayk Misakyan|Hayk Misakyan
Helga Schönbauer|Helga Schönbauer
Inna Ananyeva|Inna Ananyeva
J. Doyle|J. Doyle
J. S. Heng|J. S. Heng
Jason Coetzer|Jason Coetzer
Jefry Tjoandi|Jefry Tjoandi
Jiang Shan|Jiang Shan
Julian Schmid|Julian Schmid
K. Kistler|K. Kistler
Karin Mühlbacher|Karin Mühlbacher
Karin Seebacher|Karin Seebacher
Karl Klesadl|Karl Klesadl
Kittithat Cheilkinthe|Kittithat Cheilkinthe
Knarik Margaryan|Knarik Margaryan
Ko Kovalyov|Ko Kovalyov
Leilei Huang|Leilei Huang
Leonie Stenek|Leonie Stenek
Lim Ah Soo|Lim Ah Soo
Marion O'May|Marion O'May
Mauro Marzullo|Mauro Marzullo
Meline Kocharyan|Meline Kocharyan
Michelle Zhang Xi|Michelle Zhang Xi
Mikael Nilsson|Mikael Nilsson
Miriam Herbst|Miriam Herbst
Muhammad Reza Pahlevi Isfahani|Muhammad Reza Pahlevi Isfahani
Oscar Malamud|Oscar Malamud
R. Mirnig|R. Mirnig
Rainbow Ngai|Rainbow Ngai
Ralph Bittenauer|Ralph Bittenauer
Raymond Darmawan|Raymond Darmawan
Ruan Snyman|Ruan Snyman
Sabrina Herbst|Sabrina Herbst
Sally Johnstone|Sally Johnstone
Schnabl|Schnabl
See Chin Leong|See Chin Leong
Sejla Dzinic|Sejla Dzinic
Siegfried Jost|Siegfried Jost
Sona Ghukasyan|Sona Ghukasyan
Stingl|Stingl
Tamaki Fujii|Tamaki Fujii
Theresa Baldauf|Theresa Baldauf
Tjap Han Tiong|Tjap Han Tiong
Walter Obritzhauser|Walter Obritzhauser
Wu Qianqian|Wu Qianqian
Yuriy Bizev|Yuriy Bizev
Zarra Faza Azka|Zarra Faza Azka
Zulfiyya Huseynova|Zulfiyya Huseynova
Mihir Kanti Chaudhuri|মিহিৰ কান্তি চৌধুৰী
Vanessa Villalobos|Vanessa Karmine Villalobos Vázquez
Mauricio Casillas|Mauricio Casillas
Luis Montoya|Luis Armando Montoya Navarro
Abantika Deka|Abantika Deka
Abdullah Al-Masrafi|Abdullah Al-Masrafi
Akhter|Akhter
Alexei Denisenko|Alexei Denisenko
Amanda Guthrie|Amanda Guthrie
An Soenens|An Soenens
Andrei Razmakov|Andrei Razmakov
Angela Castillo|Angela Castillo
Angela Dobbs|Angela Dobbs
Angelika Zeisinger|Angelika Zeisinger
Angelina Cazorla|Angelina Cazorla
Antonio Ocegueda|Antonio Ocegueda
Antonio Vessi|Antonio Vessi
Anuj Gupta|Anuj Gupta
Aston Khor|Aston Khor
Ayesha Khatun Nuri|Ayesha Khatun Nuri
Aziz Dutta|Aziz Dutta
B. Selinger|B. Selinger
Saikhantuul Banzragch|Banzragch Saikhantuul
Benny Tan Ook Djie|Benny Tan Ook Djie
Bernard Blake|Bernard Blake
Cordula Schütt|Cordula Schütt
Cristinel Cojocaru|Cristinel Cojocaru
Cynthia Calderon|Cynthia Calderon
D. McNeill|D. McNeill
Danielle Jupiter|Danielle Jupiter
Dario van Nauw|Dario van Nauw
David Melo|David Melo
Dina Grinshteyn|Dina Grinshteyn
Dmitrii Butarev|Dmitrii Butarev
Elena Lukashevich|Elena Lukashevich
Elena Sereda|Elena Sereda
Elke Cramer|Elke Cramer
Elke Hintermayr|Elke Hintermayr
Els Baert|Els Baert
Esteban Reyes|Esteban Reyes
F. N. Harvey|F. N. Harvey
Felix Hoffmann|Felix Hoffmann
Ferdousy Begum|Ferdousy Begum
G. de Chazal|G. de Chazal
G. Martin|G. Martin
Gay Meyer|Gay Meyer
Génesis Valentín|Genesis Valentín
Golam Aziz Zilani|Golam Aziz Zilani
Gopal Tawabi|Gopal Tawabi
Hanny Setiani Juhari|Hanny Setiani Juhari
Heike Stohlmann|Heike Stohlmann
Hélène Pin Harry|Hélène Pin Harry
Ingrid Rijcken|Ingrid Rijcken
Irina Gourina|Irina Gourina
J. E. Ramsay|J. E. Ramsay
J. Mathieu|J. Mathieu
J. W. Neale|J. W. Neale
Jenni Jefferson|Jenni Jefferson
Jihyun Marr|Jihyun Marr
Josef Link|Josef Link
Karel Sioncke|Karel Sioncke
Keiron Ng|Keiron Ng
Kim Young-sun|Kim Young-sun
Kokoe Tanaka|Kokoe Tanaka
Kurt Nys|Kurt Nys
Kyle Foley|Kyle Foley
Laura Michel|Laura Michel
Laurent Cuccu|Laurent Cuccu
Lee Ja-yeong|Lee Ja-yeong
Lindsay Smith|Lindsay Smith
Luis Suárez|Luis Suárez
Luky|Luky
Manuel Heumann|Manuel Heumann
María Antonieta Rivas|María Antonieta Rivas
Maria Eugenia Azuara|Maria Eugenia Azuara
Maria Eugenia de del Rio|Maria Eugenia de del Rio
Maryanne Breckell|Maryanne Breckell
Maxim Shmakov|Maxim Shmakov
Md Rais Uddin|Md Rais Uddin
Melanie Herrle|Melanie Herrle
Michel Bauduin|Michel Bauduin
Mihir|Mihir
Mirella Antico|Mirella Antico
Monica Rivera|Monica Rivera
Monserrat Soto|Monserrat Soto
Munmun Rahman Dolla|Munmun Rahman Dolla
Nancy de Mey|Nancy de Mey
Neil Hedenton|Neil Hedenton
Olivia Chelin Maria Kambey|Olivia Chelin Maria Kambey
P. Scott|P. Scott
Pavel Kyrilo|Pavel Kyrilo
Pervin|Pervin
Peter Vöttiner|Peter Vöttiner
Peter Weinert|Peter Weinert
Petia Todorova|Petia Todorova
Philipp Discher|Philipp Discher
Popy|Popy
R. G. Pattinson|R. G. Pattinson
R. T. Fear|R. T. Fear
Radoslav Simeonov|Radoslav Simeonov
Radu Milevschi|Radu Milevschi
Roland Dorner|Roland Dorner
Ronald Huber|Ronald Huber
S. Cushman|S. Cushman
S. Sheo Chap Sing|S. Sheo Chap Sing
S. Young|S. Young
Sabine Schilling|Sabine Schilling
Sandrine Callon|Sandrine Callon
Sarah Spielmann|Sarah Spielmann
Sarmilla Goorye|Sarmilla Goorye
Selena Henry|Selena Henry
Serayal Lakhi|Serayal Lakhi
Sharleen Bulli|Sharleen Bulli
Sonja Beaurain|Sonja Beaurain
Sophie Laguesse|Sophie Laguesse
Steffen Weber|Steffen Weber
Tao Xiaolan|Tao Xiaolan
Tim Baeke|Tim Baeke
Tim Wouters|Tim Wouters
Tobias Braun|Tobias Braun
Tulga Khuyag|Tulga Khuyag
Twina Bora|Twina Bora
V. E. Duringer|V. E. Duringer
Valentina Metlitzkaia|Valentina Metlitzkaia
Vitalii Masuk|Vitalii Masuk
Winnie Lee|Winnie Lee
Wong Wai See|Wong Wai See
Yury Sakolin|Yury Sakolin
Zolzaya Gankhuyag|Zolzaya Gankhuyag
Rasmus Kjær Pedersen|Rasmus Kjær Pedersen
Lim Jee Lynn|Lim Jee Lynn
Low Hang Yee|Low Hang Yee
Shunsuke Yamamura|Shunsuke Yamamura
Yoshiki Tsukamoto|Yoshiki Tsukamoto
Shreyansh Jaiswal|Shreyansh Jaiswal
Yerusksew Tura|Yerusksew Tura
Devi Yunita Indah Sari|Devi Yunita Indah Sari
Bhupendra Nath Goswami|ভূপেন্দ্ৰ নাথ গোস্বামী
Dionisio García Cortázar|Dionisio García Cortázar
Máximo Cánovas del Castillo|Máximo Cánovas del Castillo
Anshu Jamsenpa|অংশু জামচেংপা
Rimpi Das|ৰিম্পী দাস
Iman Chakraborty|ইমন চক্ৰৱৰ্তী
Eliza Myrie|এলিজা মাইৰি
Prajnasundari Devi|প্ৰজ্ঞাসুন্দৰী দেৱী
Anupam Saikia|অনুপম শইকীয়া
Sarbananada Singha|সৰ্বানন্দ সিংহ
Greta Thunberg|গ্ৰেটা থুন্‌বাৰি
Mahashay Dharam Pal Gulati|মহাশয় ধৰমপাল গুলাটি
Priyanka|প্ৰিয়ংকা
Jakir Khan|জাকিৰ খান
Reshma Pathan|ৰেশমা পাঠান
Vanessa Mark|Vanessa Mark
Alexander Bernardi|Alexander Bernardi
|কীৰ্তিনাথ শৰ্মা বৰদলৈ
Amrutha Suresh|অমৃতা সুৰেশ
Mithoo Barooah|মিথু বৰুৱা
Anil Raichoudhury|অনিল ৰায়চৌধুৰী
Sujita Das|সুজিতা দাস
Devdas Banjare|দেৱদাস বনজাৰে
Olivia Araujo|Olivia Araujo
Surjya Kanta Hazarika|সূৰ্যকান্ত হাজৰিকা
Victor Povzner|Victor Povzner
Pijush Kanti Roy|পীযুষ কান্তি ৰয়
Mantas Januskevicius|Mantas Januskevicius
Bolivar Espinosa|Bolivar Espinosa
Mattija Lojen|Mattija Lojen
Joanne Cavill|Joanne Cavill
Deb Kumar Bose|দেৱ কুমাৰ বসু
Beata Jasińska|Beata Jasińska
Olga Mikhailoyskaia|Olga Mikhailoyskaia
Els Bauden|Els Bauden
Sabrina Arhab|Sabrina Arhab
Cecilia Bäckstedt|Cecilia Bäckstedt
Dulal Manki|দুলাল মানকি
Swati Mohan|স্বাতি মোহন
Iulian Oprea|Iulian Oprea
Leon Felderer|Leon Felderer
Cezara Curmei|Cezara Curmei
Roberts Plūme|Roberts Plūme
Erica Voss|Erica Voss
Julia Słupecka|Julia Słupecka
Eric Fantazzini|Eric Fantazzini
Arnis Bebrišs|Arnis Bebrišs
Taylor Lawrence|Taylor Lawrence
Cédric Follador|Cédric Follador
Erik Schmidt|Erik Schmidt
William Shakespeare|উইলিয়াম শ্বেইকছপীয়েৰ
Aristotle|এৰিষ্ট'টল
Fyodor Dostoyevsky|ফিওদোৰ দস্তয়েভস্কি
Carl Linnaeus|কাৰ্ল লিনিয়াছ
Georg Simon Ohm|গিয়ৰ্গ ছিমন ওম
Marilyn Monroe|মেৰীলিন মনৰো
Henri Matisse|হেনৰি মেটিশ্ব
Marco Polo|মাৰ্ক’ প’ল’
Niels Bohr|নিলছ্ ব'ৰ
Évariste Galois|এভাৰিষ্ট গেল'ৱা
Najib Mahfouz|নাগিব মাহফুজ
Rabindranath Tagore|ৰবীন্দ্ৰনাথ ঠাকুৰ
Ashoka|সম্ৰাট অশোক
Euclid|ইউক্লিড
Chanakya|চাণক্য
Karl Marx|কাৰ্ল মাৰ্ক্স
Aryabhata|আৰ্যভট্ট
Robert Baden-Powell, 1st Baron Baden-Powell|লৰ্ড বেডেন পাৱেল
Vinoba Bhave|বিনোৱা ভাৱে
Alfred Nobel|আলফ্ৰেড ন'বেল
Mother Teresa|মাদাৰ টেৰেছা
Pablo Neruda|পাবলো নেৰুদা
Daniel Radcliffe|ডেনিয়েল ৰেডক্লিফ
Karen Keskulla Uhlenbeck|কাৰেণ উলেনবেক
Manmohan Singh|মনমোহন সিং
Peter Handke|পিটাৰ হেণ্ডকে
Sudha Chandran|সুধা চন্দ্ৰন
Juan Manuel Santos|সুআন মানুৱেল ছাণ্ট'ছ কাল্ডে'ৰ'ন
Jigme Khesar Namgyel Wangchuck|জিগমে খেচাৰ নামগৱেল ৱাংচুক
Pierre de Fermat|পিয়েৰী দি ফাৰ্মা
André Moritz|আণ্ড্ৰে' ম'ৰিট্জ
Maria Montessori|মেৰীয়া মন্টেছৰী
Ajay Devgn|অজয় দেৱগন
Kajol|কাজল
Mohammed Rafi|মহম্মদ ৰফি
Bindu|বিন্দু (অভিনেত্ৰী)
Stephenie Meyer|ষ্টিফেনি মেয়াৰ
Jack Kerouac|জেক কেৰুৱাক
Helena Bonham Carter|হেলেনা ব'নহাম কার্টাৰ
Jayant Vishnu Narlikar|জয়ন্ত নাৰ্লিকাৰ
Virat Kohli|বিৰাট ক'হলি
Kajal Aggarwal|কাজল আগাৰৱাল
Sai Baba of Shirdi|শিৰডীৰ সাই বাবা
Mayawati|মায়াৱতী
Indra Nooyi|ইন্দ্ৰা নূয়ী
Yaragudipati Venkata Mahalakshmi|লক্ষ্মী
Revathi|ৰেৱতী
António Guterres|এণ্টনিও গুটেৰেছ
Shakti Kapoor|শক্তি কাপুৰ
Dhanush|ধনুষ
Ratan Tata|ৰতন টাটা
Somdev Devvarman|সোমদেৱ দেৱবৰ্মন
Dilip Kumar|দিলীপ কুমাৰ
Tathagat Avatar Tulsi|তথাগত অৱতাৰ তুলসী
Phani Sarma|ফণী শৰ্মা
Surinder Kaur|সুৰিন্দৰ কৌৰ
Amrit Kaur|ৰাজকুমাৰী অমৃত কৌৰ
Olga Ladyzhenskaya|অল্গা লেডিজেংস্কায়া
Raman Parimala|ৰামন পৰিমালা
Jayalalitha Jayaram|জয়ললিতা
Rekha|ৰেখা
Waheeda Rehman|ৱাহীদা ৰহমান
Gérard Mourou|জেৰাৰ্ড মৌৰো
Bhaktivinoda Thakur|ভক্তিৱিনোদ ঠাকুর
Yves Meyer|য়েভেচ মেয়াৰ
Martin Ohm|মাৰ্টিন ওম
David J. Thouless|ডেভিদ জেমছ থুলছ
Devdas Gandhi|দেৱদাস গান্ধী
Hippolyte Pixii|হিপ্পোলাইট পিক্সি
Raghuram Rajan|ৰঘূৰাম ৰাজন
Samudra Varman|সমুদ্ৰ বৰ্মা
Pushya Varman|পুষ্য বৰ্মা
Jamal Khashoggi|জামাল আহমেদ ষাশ্বকজী
Prakash Raj|প্ৰকাশ ৰাজ
Golap Borbora|গোলাপ বৰবৰা
Gabriella Rodríguez|Gabriela Rodríguez
Herbert Gintis|হাৰ্বাৰ্ট গিণ্টিছ
Michael Houghton|মাইকেল হাউটন
Gauri Shankar Kalita|গৌৰীশংকৰ কলিতা
Vinod Khanna|বিনোদ খান্না
Vani Jairam|বাণী জয়ৰাম
Nek Chand Saini|নেক চান্দ চে'নি
Prabhat Mukherjee|প্ৰভাত মুখাৰ্জী
Reita Faria|ৰীতা ফাৰিয়া
Sushil Kumar Singh|চুচিল কুমাৰ চিং
Nana Patekar|নানা পাটেকৰ
Yuval Noah Harari|য়ুভাল নোৱাহ হাৰাৰী
Agatha Sangma|আগথা চাংমা
Parashara|পৰাশৰ
Nirupa Roy|নিৰূপা ৰয়
George Fernandes|জৰ্জ ফাৰ্নাণ্ডেজ
José Luis Álvarez Álvarez|José Luis Álvarez
Kalki Koechlin|কাল্কী কেকলাঁ
Nazia Hassan|নাজিয়া হাচান
Michael Moschen|Michael Moschen
Tarun Gogoi|তৰুণ গগৈ
Prafulla Chandra Ray|প্ৰফুল্ল চন্দ্ৰ ৰায়
Chuni Goswami|চুনী গোস্বামী
Momtaz Begum|মমতাজ বেগম
Kelucharan Mohapatra|কেলুচৰণ মহাপাত্ৰ
Meera Jasmine|মীৰা জেছমিন
Karan Singh Grover|কৰন সিং গ্ৰোভাৰ
Devi Sri Prasad|দেৱী শ্ৰী প্ৰসাদ
C. B. Muthamma|চি. বি. মুথাম্মা
Piyush Mishra|পীয়ূষ মিশ্ৰ
Zubeen Garg|জুবিন গাৰ্গ
Ileana D'Cruz|ইলিয়ানা ডি'ক্ৰুজ
Lachit Borphukan|লাচিত বৰফুকন
Rani Padmini|ৰাণী পদ্মিনী
Kamala Nehru|কমলা নেহৰু
Harishankar Parsai|হৰিশংকৰ পৰসাঈ
A. Vincent|অজয়ন ভিনচেন্ট
Arati Mukhopadhyay|আৰতি মুখাৰ্জী
Ilaram Das|ইলাৰাম দাস
Ajit Kumar Doval|অজিত কুমাৰ ডোভাল
Akira Yoshino|আকিৰা য়শ্বিন'
Amit Shah|অমিত শ্বাহ
Amitava Roy|অমিতাভ ৰায়
Amrita Patel|অমৃতা পেটেল
Anuja Chauhan|অনুজা চৌহান
Arati Ankalikar-Tikekar|আৰতি অংকলীকৰ-টিকেকৰ
Arnab Ranjan Goswami|অৰ্ণৱ গোস্বামী
Aurangabadi Mahal|ঔৰংগাবাদী মহল
Azam Tariq|আজম তাৰিক
Bagh Hazarika|বাঘ হাজৰিকা
Baro-Bhuyan|বাৰ ভূঞা
Benjamin A. Gilman|बेञमिन.ए.गिलमान
Benudhar Sharma|বেণুধৰ শৰ্মা
Bhabananda Deka|ভৱানন্দ ডেকা
Bibek Debroy|বিবেক দেবৰয়
Biren Singh Engti|বিৰেন সিং ইংতি
Biswa Singha of Kamata|বিশ্ব সিংহ
Dimbeswar Neog|ডিম্বেশ্বৰ নেওগ
Jeetendra Madnani|জিৎ (অভিনেতা)
Fathima Beevi|ফাটিমা বিবি
Gautam Kalita|গৌতম কলিতা
Hema Saraswati|হেম সৰস্বতী
Hemlata|হেমলতা
Nabakanta Barua|নৱকান্ত বৰুৱা
Indira Jaising|ইন্দিৰা জয়সিংহ
James P. Allison|জেমছ পি. এলিচন
Jyotsna Srikanth|জ্যোৎস্না শ্ৰীকান্ত
Kampa Borgoyary|কাম্পা বৰগয়াৰী
Kiren Rijiju|কিৰেণ ৰিজিজু
Kushal Konwar|কুশল কোঁৱৰ
Nita Ambani|নীতা আম্বানী
Panchi Bora|পঞ্চী বৰা
Parbati Barua|পাৰ্বতী বৰুৱা
Pran Kumar Sharma|প্ৰাণ কুমাৰ শৰ্মা
Prerana Deshpande|প্ৰেৰণা দেশপাণ্ডে
Priyamvada Natarajan|প্ৰিয়ম্বদা নটৰাজন
Rahat Indori|ৰাহত ইন্দৰী
Rameshwar Pathak|ৰামেশ্বৰ পাঠক
Robin Gurung|ৰবিন গুৰুং
Rupnath Brahma|ৰূপনাথ ব্ৰহ্ম
Sheila Sri Prakash|শীলা শ্ৰী প্ৰকাশ
Subinphaa|চুবিন্‌ফা
Sudangphaa|চুদাংফা
Sukhrungphaa|ৰুদ্ৰ সিংহ
Sumati Morarjee|সুমতী মোৰাৰজী
Sutanphaa|চুতণফা
Taapsee Pannu|তাপ্‌সী পন্নু
Talimeren Ao|টালিমেৰণ আও
Uddabh Barman|উদ্ধৱ বৰ্মন
Usha Jadhav|উষা যাদৱ
Urmila Mahanta|উৰ্মিলা মহন্ত
Vaishnavi Mahant|বৈষ্ণৱী মহন্ত
Vijay Prakash|বিজয় প্ৰকাশ
Tara|তাৰা
Parvati Prasad Baruva|পাৰ্ৱতি প্ৰসাদ বৰুৱা
Homen Borgohain|হোমেন বৰগোহাঞি
Khagen Mahanta|খগেন মহন্ত
Shahana Goswami|শ্বাহানা গোস্বামী
Karamchand Uttamchand Gandhi|কৰমচান্দ উত্তমচান্দ গান্ধী
Kritika Kamra|কৃতিকা কামৰা
Maanu|মানু
Ananda Chandra Agarwala|আনন্দচন্দ্ৰ আগৰৱালা
Edward Snowden|এডৱাৰ্ড স্ন'ডেন
Sarla Thakral|সৰলা ঠকৰাল
Jahnavi Barua|জাহ্নৱী বৰুৱা
Elli Avram|এলি আভৰাম
Rajani A. Bhisey|ৰজনী এ. ভিছেই
Joyanti Chutia|জয়ন্তী চুতীয়া
Rama Govindarajan|ৰামা গোবিন্দাৰাজন
Avantibai|অৱন্তীবাই
Drupad Borgohain|দ্ৰুপদ বৰগোঁহাই
Subrahmanyam Jaishankar|সুব্ৰমনিয়ম জয়শংকৰ
Laishram Sarita Devi|লাইশ্ৰাম চৰিতা দেৱী
Simple Gogoi|চিম্পল গগৈ
Sushmita Dev|সুস্মিতা দেৱ
Suhung|চুহুংফা
Deepa Malik|দীপা মালিক
Neelam Kler|নীলম ক্লেৰ
Jhannabi Goswami|জাহ্নৱী গোস্বামী
Padum Barua|পদুম বৰুৱা
Laxmi Agarwal|লক্ষ্মী আগৰৱাল
Sarbeswar Sahariah|সৰ্বেশ্বৰ চহৰীয়া
Atishi Marlena|অতিশী মাৰ্লেনা
Swarupam Purkayastha|স্বৰূপম পুৰকায়স্থ
Tarun Chandra Pamegam|তৰুণ চন্দ্ৰ পামেগাম
Kareena Marshall|Kareena Marshall
Arnab Jan Deka|অৰ্ণৱ জান ডেকা
Sheila Bhatia|শীলা ভাটিয়া
Rupam Bhuyan|ৰূপম ভূঞা
Suniti Solomon|ছুনীতি ছলোমন
Sreelakshmy Govardhanan|শ্ৰীলক্ষ্মী গোৱৰ্ধনন
Munin Barua|মুনিন বৰুৱা
Chloé Zhao|ক্লৱি ঝাও
Friederike Spitzenberger|Friederike Spitzenberger
|গুৰুপ্ৰসাদ দাস
Sabitri Heisnam|সাৱিত্ৰী হেইচনাম
Gunaram Khanikar|গুণাৰাম খনিকৰ
Ashraful Haque|আশ্ৰাফুল হক
Ratnadhwajpal|ৰত্নধ্বজপাল
Rukhmabai|ৰুখমাবাই
Suprabha Devi|সুপ্ৰভা দেৱী
Yeshe Dorjee Thongchi|য়েছে দৰজে ঠংচি
AK Garney|এ কে গাৰ্নি
|ময়িদুল ইছলাম বৰা
|দিলীপ কুমাৰ দত্ত
|মোহন ভাৱৰীয়া
Debajit Changmai|দেৱজিৎ চাংমাই
Pakija Begum|পাকিজা বেগম
Upen Kakati|উপেন কাকতি
Phanindra Kumar Dev Choudhury|ফণীন্দ্ৰ কুমাৰ দেৱচৌধুৰী
Sanjukta Parashar|সংযুক্তা পৰাশৰ
C A Bhavani Devi|চি. এ. ভৱানী দেৱী
Dhirendra Nath Bezbaruah|ধীৰেন্দ্ৰ নাথ বেজবৰুৱা
Claude Vaucher|Claude Vaucher
Armando del Carpio|Armando del Carpio
Kristín Berglind Kristjánsdóttir|Kristín Berglind Kristjánsdóttir
A. R. V. Dolman|A. R. V. Dolman
De Dee Hame Azaadi|দে দে হমে আজাদী
Anne-Christin Reiter|Anne Reiter
Urszula Wiśniak|Urszula Wiśniak
Tadeusz Woźny|Tadeusz Woźny
Lesław Markowicz|Lesław Markowicz
Jadwiga Czarniecka|Jadwiga Czarniecka
Halina Mozolewska|Halina Mozolewska
Marek Złomko|Marek Złomko
Teresa Złoczewska|Teresa Złoczewska
Bożena Wiczyńska|Bożena Wiczyńska
Iwona Nabiałek|Iwona Nabiałek
Krystyna Polakowska|Krystyna Polakowska
Iwona Matkowska|Iwona Matkowska
Irena Masłowska|Irena Masłowska
Maria Domańska|Maria Domańska
Sylwester Malak|Sylwester Malak
Krystyna Bednarek|Krystyna Bednarek
Piotr Sobotka|Piotr Sobotka
Izabela Białek|Izabela Białek
Aída Rodríguez|Aída Rodríguez
Andreas Ruth|Andreas Ruth
Artur Khachaturyan|Artur Khachaturyan
Azim Wasti|Azim Wasti
Bodil Valtonen|Bodil Valtonen
Chiara Carranza|Chiara Carranza
Elisabeth Eide|Elisabeth Eide
Harry Sarén|Harry Sarén
José Vicente Martínez|José Vicente Martínez
Julia Chen|Julia Chen
Kari Histøl|Kari Histøl
Kristian Langbak|Kristian Langbak
Lara Lucas|Lara Lucas
Ludmila Kosse|Ludmila Kosse
Marlies Baan|Marlies Baan
Maryna Ilyinskaya|Maryna Ilyinskaya
Netty Ooms|Netty Ooms
Nikolaj Gunnarstein|Nikolaj Gunnarstein
Olga Kozlova|Olga Kozlova
Ricardo Gonzales|Ricardo Gonzales
Rory Easton|Rory Easton
Rosario Copello|Rosario Copello
Susanne Johansen|Susanne Johansen
Thaina Bellido Garcia|Thaina Bellido Garcia
Viktoria Semenyuta|Viktoria Semenyuta
Tan Yip Jiun|Tan Yip Jiun
Lim Fang Yang|Lim Fang Yang
Adriana Rivas|Adriana Rivas
Andika Ramadiansyah|Andika Ramadiansyah
Ann-Sofi Bergman|Ann-Sofi Bergman
Benny Lin|Benny Lin
Bremer Visser|Bremer Visser
Carmen Chan|Carmen Chan
Carsten Hansson|Carsten Hansson
Charo Oteyza|Charo Oteyza
Chhorvann Chhea|Chhorvann Chhea
Christine Yang|Christine Yang
Corine McKinley|Corine McKinley
Daniel Lundgaard|Daniel Lundgaard
Darren Yang|Darren Yang
Dorothy Hinchcliff|Dorothy Hinchcliff
Ella Peters|Ella Peters
Éloi Adam|Eloi Adam
Erika Fikenscher|Erika Fikenscher
Fan Qiuyue|Fan Qiuyue
Federico Santos|Federico Santos
Frederik Køhler|Frederik Køhler
G. Nazir|G. Nazir
Gro Storvik|Gro Storvik
Håkan Linnarsson|Håkan Linnarsson
Henny Wesdorp|Henny Wesdorp
Ine Lanckriet|Ine Lanckriet
James Paterson|James Paterson
Javier Cardos Garcia|Javier Cardos Garcia
Jennifer Levallet|Jennifer Levallet
Johnny Borglum|Johnny Borglum
June Shipman|June Shipman
Karen Kiil|Karen Kiil
Kenji Lovang|Kenji Lovang
Kerri Scott|Kerri Scott
Kerry Xu|Kerry Xu
Khoo Eng Huah|Khoo Eng Huah
Korakrit Laotrakul|Korakrit Laotrakul
Line Nørgaard|Line Nørgaard
Lise Kissmeyer|Lise Kissmeyer
Luís Carvalho|Luís Carvalho
Manuela Olcese|Manuela Olcese
Michelle Cheung|Michelle Cheung
Morten Bødskov|Morten Bødskov
Niccolo Tagle|Niccolo Tagle
Nicole van Zijderveld|Nicole van Zijderveld
Oskari Saarinen|Oskari Saarinen
Pablo Masson|Pablo Masson
Per Thomas Mørk|Per Thomas Mørk
R. Perry|R. Perry
Rafael Davila|Rafael Davila
Rinoy Manavalan|Rinoy Manavalan
Shuto Morioka|Shuto Morioka
Søren Hansen|Søren Hansen
Sri Wulansari|Sri Wulansari
Stuart Spurling|Stuart Spurling
Suchanya Kanchanasaka|Suchanya Kanchanasaka
Suprobo Bagus|Suprobo Bagus
Svein Goli|Svein Goli
Wei Chun-Yi|Wei Chun-Yi
Wenche Hilt|Wenche Hilt
Yu Yu Wang|Yu Yu Wang
Yui Fujiwara|Yui Fujiwara
Alrick Toney|Alrick Toney
Jada Renales|Jada Renales
A. Atkins|A. Atkins
Alina Khachatryan|Alina Khachatryan
Allan Borch|Allan Borch
Andrea Quendler|Andrea Quendler
Angelika Golzner|Angelika Golzner
Angelika Kienzl|Angelika Kienzl
Armen Hunanyan|Armen Hunanyan
Armen Manukyan|Armen Manukyan
Arsen Khachatryan|Arsen Khachatryan
Ban Ee-jun|Ban Ee-jun
Birgit Pum|Birgit Pum
Carina Meinke|Carina Meinke
Clement Krobakpo|Clement Krobakpo
Conny Ertl|Conny Ertl
David Schwerin|David Schwerin
Devendra Herath|Devendra Herath
Dragana Mitrovic|Dragana Mitrovic
E. Kok|E. Kok
E. T. Scott|E. T. Scott
Eddie Ireland|Eddie Ireland
Elizabeth Roza|Elizabeth Roza
Eric Vuong|Eric Vuong
Fabian Steurer|Fabian Steurer
Franz Lunzer|Franz Lunzer
Gabriela Freuis|Gabriela Freuis
Gastón Ansaldo|Gastón Ansaldo
Gerti Kindlhofer|Gerti Kindlhofer
Gunay Huseynova|Gunay Huseynova
Günter Swoboda|Günter Swoboda
Habeeb Bello|Habeeb Bello
Halla Bouksani|Halla Bouksani
Harutyun Poghosyan|Harutyun Poghosyan
Hermann Forstner|Hermann Forstner
Ida Pili|Ida Pili
Indira Bhikha|Indira Bhikha
Inge Kitzmüller|Inge Kitzmüller
Ivan Sotirov|Ivan Sotirov
Jakob Wraber|Jakob Wraber
Jan Sedlmayr|Jan Sedlmayr
Janis Kawamoto|Janis Kawamoto
Jannik Maczejka|Jannik Maczejka
Johannes Schöpf|Johannes Schöpf
Kenn Lim|Kenn Lim
Lai Chien-Cheng|Lai Chien-Cheng
Leandro Kesler Lusa|Leandro Kesler Lusa
Lee Chia-Hao|Lee Chia-Hao
Lee-Ann de Wet|Lee-Ann de Wet
Mariano Fernandez|Mariano Fernandez
Michael Chappell|Michael Chappell
Michelle Zhang|Michelle Zhang
Narayan Ramdhani|Narayan Ramdhani
Nathalie Winkler|Nathalie Winkler
Natsumi Uesugi|Natsumi Uesugi
René Nichterwitz|René Nichterwitz
Rovshan Mchdiev|Rovshan Mchdiev
Rudy Dendeng|Rudy Dendeng
Rufika Olvita|Rufika Olvita
Sam Burnett|Sam Burnett
Samuel Ho|Samuel Ho
Sandra Flora|Sandra Flora
Serena Au Yeong|Serena Au Yeong
Simon Ofner|Simon Ofner
Sonja Michelitch|Sonja Michelitch
Stefan Leiss|Stefan Leiss
Susanne Hagleitner|Susanne Hagleitner
Susanne Schuster|Susanne Schuster
Tarana Kerimova|Tarana Kerimova
Thomas Fink|Thomas Fink
Thomas Purkarthofer|Thomas Purkarthofer
Tom Thomas|Tom Thomas
Traude Kohlhauser|Traude Kohlhauser
Ursula Schechtner|Ursula Schechtner
Vincent Choo|Vincent Choo
Werner Zirnwald|Werner Zirnwald
Winpoo Inkaew|Winpoo Inkaew
Xia Chunyu|Xia Chunyu
Xiao Li|Xiao Li
Yogeshsingh Mahadnac|Yogeshsingh Mahadnac
Rasika Raje|Rasika Raje
Sanjana Santosh|Sanjana Santosh
Dhruv Kapila|Dhruv Kapila
Aleksandr Manko|Aleksandr Manko
Tina Langhammer|Tina Langhammer
Alexandre Françoise|Alexandre Françoise
Aliaksei Voloshin|Aliaksei Voloshin
Alma Denisse Jauregui|Alma Denisse Jauregui
Andrey Astafiev|Andrey Astafiev
Isabella Linares|Isabella Linares
Anna Grankina|Anna Grankina
Annette Hilt|Annette Hilt
Benjamin Placzek|Benjamin Placzek
Bonolo Amos|Bonolo Amos
Carolina Pizano de Velazquez|Carolina Pizano de Velazquez
Christian Reynders|Christian Reynders
Clara Mas|Clara Mas
Claudia Klingelhöfer|Claudia Klingelhöfer
Clemens Smola|Clemens Smola
Daya Elsa Jacob|Daya Elsa Jacob
Dirk Otto|Dirk Otto
Dominique Francica|Dominique Francica
E. Allwood|E. Allwood
E. Dart|E. Dart
Edeltraud Schwarz|Edeltraud Schwarz
Erdenesuvd Bat-Erdene|Erdenesuvd Bat-Erdene
Erika Meisenhälter|Erika Meisenhälter
Evgenij Jakovchuk|Evgenij Jakovchuk
F. de la Macorra|F. de la Macorra
Fabienne Rohgoot|Fabienne Rohgoot
Ferdousy Khanum|Ferdousy Khanum
Flor Spanhove|Flor Spanhove
Francisco Aguirre|Francisco Aguirre
Frank Weber|Frank Weber
Frédéric Gaspard|Frédéric Gaspard
Ganchuluun Boldbaatar|Ganchuluun Boldbaatar
Gayatri Vartak|Gayatri Vartak
Yoon Han-na|Han Na Yoon
Haradhon|Haradhon
Hennadi Karabyn|Hennadi Karabyn
J. G. McLean|J. G. McLean
J. R. Southon|J. R. Southon
Jaime González|Jaime González
Jan Keymis|Jan Keymis
Jef Buckinckx|Jef Buckinckx
Johannes Szilagyi|Johannes Szilagyi
Linda Scheithauer|Linda Scheithauer
Juan Sañudo|Juan Sañudo
Jürgen Ladwig|Jürgen Ladwig
K. Diplock|K. Diplock
Karin Rüsseler|Karin Rüsseler
Katrien Claes|Katrien Claes
Khoo Boo Hock|Khoo Boo Hock
Klein|Klein
Kronthaler|Kronthaler
L. Rankin|L. Rankin
Lai Fook Young|Lai Fook Young
Lai Wui Meng|Lai Wui Meng
Stefan Sadlau|Stefan Sadlau
Lena Strackbein|Lena Strackbein
Liao Yue Jin|Liao Yue Jin
Liton|Liton
M. Birse|M. Birse
Manuel Armendariz|Manuel Armendariz
Manuel Thomas|Manuel Thomas
Maria Borg|Maria Borg
Maria Delgado|Maria Delgado
María Luisa del Castillo|María Luisa del Castillo
Marine Lemaire|Marine Lemaire
Michael Deuerling|Michael Deuerling
Munkhnaran Tumurbataar|Munkhnaran Tumurbataar
N. V. S. Vijetha|N. V. S. Vijetha
N. Wanklyn|N. Wanklyn
Nadine Vermeulen|Nadine Vermeulen
Navdeep Singh|Navdeep Singh
Neerav Luchmah|Neerav Luchmah
Olga Boyarovskaia|Olga Boyarovskaia
Olga Stankevich|Olga Stankevich
P. Buschmann|P. Buschmann
Pavel Shygaev|Pavel Shygaev
Penelope Salac|Penelope Salac
Philipp Faust|Philipp Faust
Thomas Riese|Thomas Riese
Pullen|Pullen
Radu Straut|Radu Straut
Rod Starkey|Rod Starkey
Roel Boonen|Roel Boonen
Rosario de Villareal|Rosario de Villareal
Rossina Núñez Yañez|Rossina Núñez Yañez
Rozina|Rozina
S. Dabrowski|S. Dabrowski
S. Smyth|S. Smyth
Sabina Rügamer|Sabina Rügamer
Sadek|Sadek
Samsul Islam Mehedi|Samsul Islam Mehedi
Sebastian Kreibich|Sebastian Kreibich
Sebastian Strödke|Sebastian Strödke
Senja Töpfer|Senja Töpfer
Shalini Shetty|Shalini Shetty
Silke Möller|Silke Möller
Sim Poh Lim|Sim Poh Lim
Stephen Sia|Stephen Sia
Sums|Sums
Suniti Rana|Suniti Rana
Susana Zarate|Susana Zarate
Svetlana Heykova|Svetlana Heykova
Tarek Shalhoum|Tarek Shalhoum
Ted Shear|Ted Shear
Tobias Güttinger|Tobias Güttinger
Tom Raes|Tom Raes
Uschi Haase|Uschi Haase
Uuganbayar Terbish|Uuganbayar Terbish
Valentijn Beckers|Valentijn Beckers
Valentin Mishenko|Valentin Mishenko
Varsha V. Belawadi|Varsha V. Belawadi
Victoria Ivanova|Victoria Ivanova
Vimal Shrestha|Vimal Shrestha
Wagatha|Wagatha
Ngandwe Miyambo|Ngandwe Miyambo
Baksi|Baksi
Bunga Fitriani Romadhini|Bunga Fitriani Romadhini
Aisha Nakiyemba|Aisha Nakiyemba
Amarjyoti Choudhury|অমৰজ্যোতি চৌধুৰী
Sanya Malhotra|ছানয়া মালহোত্ৰা
Aditi Gupta|অদিতি গুপ্তা
Prakashi Tomar|প্ৰকাশী তোমৰ
Kabir Phukan|কবীন ফুকন
Trailokyanath Goswami|ত্ৰৈলোক্য নাথ গোস্বামী
Laxminath Phookan|লক্ষ্মীনাথ ফুকন
|দিলীপ কুমাৰ বৰুৱা
Gauri Lankesh|গৌৰী লংকেশ
Suchitra Sebastian|সুচিত্ৰা চেবাষ্টিয়ান
Abhaya Hiranmayi|অভয়া হিৰন্ময়ী
Munia Ganguli|মুনিয়া গাঙ্গুলি
Madhuri Kanitkar|মাধুৰী কানিটকৰ
Navneet Aditya Waiba|নৱনীত আদিত্য ৱাইবা
Daroji Eramma|দাৰোজি এৰামমা
Kirti Menon|কীৰ্তি মেনন
Ankushita Boro|অঙ্কুশিতা বড়ো
Jeremy Lalrinnunga|জেৰেমী লালৰিন্নুংগা
Bertrand Devouard|Bertrand Devouard
Lovlina Borgohain|লাভলীনা বৰগোঁহাই
Parbati Kumar Goswami|পাৰ্বতী কুমাৰ গোস্বামী
Menaka Guruswamy|মেনকা গুৰুস্বামী
|আৰমান মালিক
Illias Ali|ইলিয়াছ আলি
Parismita Singh|পারিশমিতা সিংহ
Jayanta Nath|জয়ন্ত নাথ
Narthaki Nataraj|নৰ্তকী নটৰাজ
Virginie Saint-Martin|Virginie Saint-Martin
Hasibul Islam Mizan|হাছিবুল ইছলাম মিজান
Kutub Ahmed Mazumder|কুতুব আহমেদ মজুমদাৰ
Menaka P P Bora|মেনকা পি পি বৰা
Bhabananda Dutta|ভৱানন্দ দত্ত
Jagannath Barooah|জগন্নাথ বৰুৱা
Nirod Choudhury|নিৰোদ চৌধুৰী
Mamunul Haque|মামুনুল হক
Christian Hammers|Christian Hammers
Basanta Kumar Bhattacharyya|বসন্ত কুমাৰ ভট্টাচাৰ্য
Banasree Sengupta|বনশ্ৰী সেনগুপ্ত
Bhaben Das|ভবেন দাস
Ravi Kannan R|ৰবি কান্নান আৰ
Krishna Dasgupta|কৃষ্ণা দাশগুপ্ত
Jaret Martino|Jaret Martino
Ranjit Das|ৰঞ্জিত দাস
Yanting Ma|ইয়ান্টিং মা
Jiban Bora|জীৱন বৰা
Gert Kivistik|Gert Kivistik
Ilia Cota|Ilia Cota
Carlo Jurisevic|Carlo Jurisevic
Birkir Snaer Ingvason|Birkir Snaer Ingvason
Barbora Svrckova|Barbora Svrckova
Wendy Ducruex|Wendy Ducruex
Tatiana Droujinina|Tatiana Droujinina
Tatiana Bossak|Tatiana Bossak
Chantalle Gehrig|Chantalle Gehrig
Séverine Villance|Séverine Villance
Lada Koslikova|Lada Koslikova
Samanta Loschi|Samanta Loschi
Darnelle Moore|Darnelle Moore
Rachel Leroux|Rachel Leroux
Šárka Chmurová|Šárka Chmurová
Pappammal|পাপ্পাম্মাল
Sarah Wimmer|Sarah Wimmer
Sewabrat Baruah|সেৱাব্ৰত বৰুৱা
Riccardo Schöpf|Riccardo Schöpf
Eduard Crăciun|Eduard Crăciun
Irina Strebel|Irina Strebel
Sara Villani|Sara Villani
Andreas Haas|Andreas Haas
Joseph Williamson|Joseph Williamson
Mika Schneider|Mika Schneider
Daniel Berlinski|Daniel Berlinski
Franz Kafka|ফ্ৰান্‌জ কাফ্‌কা
Albert Einstein|এলবাৰ্ট আইনষ্টাইন
Nicolas Anelka|নিক'লাচ এনেল্কা
Subhas Chandra Bose|সুভাষ চন্দ্ৰ বসু
Vincent van Gogh|ভিনছেণ্ট ভেন গ’গ
Hans Christian Andersen|হান্স ক্ৰিশ্চিয়ান এণ্ডাৰছন
Joe Biden|জ' বিডেন
Jean-Jacques Rousseau|জঁ-জাক ৰুছ’
Leo Tolstoy|লীঅ' টলষ্টয়
Alfred Hitchcock|আলফ্ৰেড হিচকক
Asima Chatterjee|অসীমা চেটাৰ্জী
Shah Rukh Khan|শ্বাহৰুখ খান
Katrina Kaif|কেটৰিনা কাঈফ
Leon Trotsky|লিয়ন ট্ৰটস্কি
Bertrand Russell|বাৰ্ট্ৰেণ্ড ৰাছেল
Mark Zuckerberg|মাৰ্ক যুকাৰবাৰ্গ
Florence Nightingale|ফ্লোৰেন্স নাইটিংগেল
Jennifer Lopez|জেনিফাৰ ল'পেজ
Tomas Tranströmer|টমাছ ট্ৰান্সট্ৰ'মাৰ
Audrey Hepburn|অড্ৰী হেপ্‌বাৰ্ন
Muhammad Yunus|মুহাম্মদ ইউনুছ
Mary Shelley|মেৰী শ্বেলী
Sheikh Hasina|শেখ হাছিনা
Vijay Tendulkar|বিজয় টেণ্ডুলকাৰ
Jennifer Doudna|জেনিফাৰ ডাউডনা
Pranab Mukherjee|প্ৰণব মুখাৰ্জী
Arvind Kejriwal|অৰবিন্দ কেজৰিৱাল
Bing Crosby|বিং ক্ৰাজবি
Robin Williams|ৰবীন ৱিলিয়ামছ
Pandita Ramabai|পণ্ডিতা ৰমাবাঈ
Tawakel Karman|তাৱাক্কল কাৰমান
Jagjit Singh|জগজিৎ সিং
Manuel Friedrich|মেনুৱেল ফ্ৰাইড্ৰিচ
Farida Jalal|ফৰিদা জালাল
Ayesha Takia|আয়েশা টাকিয়া
Priyanka Chopra|প্ৰিয়ংকা চোপ্ৰা
Eusébio|ইউজেবিউ
Roger Penrose|ৰ'জাৰ পেনৰ'জ
Abul Kalam Azad|আবুল কালাম আজাদ
Jared Diamond|জাৰেড ডায়মণ্ড
Patanjali|পতঞ্জলি
K. R. Narayanan|কে আৰ নাৰায়ণন
Typhoid Mary|মেৰী মেলন
Sridevi|শ্ৰীদেৱী
Leander Paes|লিয়েণ্ডাৰ পেজ
Mukesh Ambani|মুকেশ আম্বানী
Khan Abdul Ghaffar Khan|খান আব্দুল গফ্ফৰ খান
Lawrence Ferlinghetti|লৰেঞ্চ ফেৰলিংঘেট্টি
Anushka Shetty|অনুষ্কা শেট্টী
Shankar Dayal Sharma|শঙ্কৰ দয়াল শৰ্মা
Kumārajīva|কুমাৰজীৱ
Irrfan Khan|ইৰফান খান
Adoor Gopalakrishnan|আদুৰ গোপালকৃষ্ণন
Fraser Stoddart|জেমছ ফ্ৰাছাৰ ষ্টদদাৰ্ট
Bhagat Singh|ভগৎ সিং
H. D. Deve Gowda|এইচ ডি দেৱেগৌড়া
Balkrishna Doshi|বালকৃষ্ণ দোশী
P. V. Sindhu|পি. ভি. সিন্ধু
Basu Chatterjee|বাসু চেটাৰ্জী
Syed Nabi|চৈয়দ ৰহিম নাবি
Rukmini Devi Arundale|ৰুক্মিণী দেৱী অৰুণ্ডেল
Vijaya Lakshmi Pandit|বিজয়লক্ষ্মী পণ্ডিত
Jhumpa Lahiri|ঝুম্পা লাহিড়ী
Sharmila Tagore|শৰ্মিলা ঠাকুৰ
Elena Cornaro Piscopia|এলেন ক'ৰনাৰ' পিচ্‌ক'পিয়া
Aruna Asaf Ali|অৰুণা আছফ আলি
Medha Patkar|মেধা পাটকৰ
Smita Patil|স্মিতা পাটিল
Suhasini Maniratnam|সুহাসিনী মণিৰত্নম
Michio Kaku|মিচ্ছিঅ' কাকু
Dadasaheb Phalke|দাদাচাহেব ফাল্কে
Vijay|বিজয়
Ronaldo|ৰ'নাল্ড'
Patience Cooper|পেচেন্‌চ কুপাৰ
Kamala Surayya|কমলা দাস
Timothy Dexter|টিমথী ডেক্সটাৰ
Janamejaya|জন্মেজয়
Jayaprakash Narayan|জয়প্ৰকাশ নাৰায়ণ
Gopinath Bordoloi|গোপীনাথ বৰদলৈ
Atif Aslam|আতিফ আচলম
Badruddin Ajmal|বদৰুদ্দিন আজমল
Balbir Singh, Sr.|বলবীৰ সিং
Bing Xin Xu|Xu Bingxin
Ishwar Chandra Vidyasagar|ঈশ্বৰচন্দ্ৰ বিদ্যাসাগৰ
Chidambaram Subramaniam|চিদাম্বৰম সুব্ৰমনিয়াম
Brahma Pala|ব্ৰহ্মপাল
David Woodard|ডেভিড উদাৰ্ড
Maithili Sharan Gupt|মৈথিলীচৰণ গুপ্ত
Emelie Lennartsson|Emelie Fabbeke
Harish-Chandra|হৰিশ-চন্দ্ৰ
Lee Meng Yean|Lee Meng Yean
Shoba|শোভা
Marja Ridder|Marja Ravelli
Uddhava|উদ্ধৱ
Jayanta Talukdar|জয়ন্ত তালুকদাৰ
Shreya Ghoshal|শ্ৰেয়া ঘোষাল
Kazi Lhendup Dorjee|काज़ी लेनडप डोर्जी
Suniti Kumar Chatterji|সুনীতি কুমাৰ চট্টোপাধ্যায়
Jasraj|পণ্ডিত যশৰাজ
Raja Birbal|বীৰবল
Bhaktisiddhanta Saraswati|ভক্তিসিদ্ধান্ত ষরস্ৱতী
Cornelia Dorabuji|কৰ্ণেলিয়া সৰাবজী
Savitribai Phule|সাৱিত্ৰীবাই ফুলে
Moushumi Chatterjee|মৌচুমী চেটাৰ্জী
Gargi Vachaknavi|গাৰ্গী
Bibhutibhushan Bandyopadhyay|বিভূতিভূষণ বন্দ্যোপাধ্যায়
Ismat Chughtai|ইস্মত চুগতাই
Mumtaz|মুমতাজ (অভিনেত্ৰী)
Srimanta Sankardeva|শ্ৰীমন্ত শংকৰদেৱ
Siddharth Narayan|সিদ্ধাৰ্থ সূৰ্যনাৰায়ণ
Shakuntala Devi|শকুন্তলা দেৱী
Kader Khan|কাদেৰ খান
Rakhee Gulzar|ৰাখী গুলজাৰ
Sarada Devi|সাৰদা দেৱী
Kadambini Ganguly|কাদম্বিনী গাংগুলী
Samir Roychoudhury|সমীৰ ৰায়চৌধুৰী
Salil Chowdhury|সলিল চৌধুৰী
Nigamananda Paramahansa|স্বামী নিগমানন্দ
Girish Karnad|গিৰীশ কৰ্ণাড
Dhondo Keshav Karve|ধন্দ কেশৱ কৰ্ৱে
Tessy Thomas|টেছি থমাছ
Saranya Ponvannan|সাৰন্য পোনভান্নন
Usha Uthup|ঊষা উথুপ
Asha Parekh|আশা পাৰেখ
Roopa Ganguly|ৰূপা গাংগুলী
Arvind Gupta|অৰবিন্দ গুপ্তা
Banikanta Kakati|বাণীকান্ত কাকতি
Nadira Babbar|নাদিৰা বব্বৰ
Jan Štohanzl|জান স্তহাঞ্জ
Abu Nechim|আবু নেচিম
Ambika Charan Choudhury|অম্বিকাচৰণ চৌধুৰী
Amla Ruia|আমলা ৰুইয়া
Ananda Chandra Dutta|আনন্দ চন্দ্ৰ দত্ত
Ananya Chatterjee|অনন্যা চট্টোপাধ্যায়
Anu Aga|অনু আগা
Anuj Dhar|অনুজ ধৰ
Anuradha Roy|অনুৰাধা ৰায়
Armaan Malik|আৰমান মালিক
Baijayant Panda|জয় পাণ্ডা
Banoo Jehangir Coyaji|বানু জাহাংগীৰ কয়াজী
Bejan Daruwalla|বেজান দাৰুৱালা
Bikramjeet Kanwarpal|বিক্ৰমজিৎ কঁৱৰপাল
Sukaphaa|চুকাফা
Maitreyi|মৈত্ৰেয়ী
Chand Sadagar|চান্দ সদাগৰ
Mihir Das|মিহিৰ দাস
Devaki Jain|দেৱকী জৈন
Devdutt Pattanaik|দেৱদত্ত পাটনায়ক
Durga Boro|দুৰ্গা বড়ো
Ganesh Gogoi|গণেশ গগৈ
Ghanakanta Bora|ঘনকান্ত বৰা বৰবায়ন
Hagrama Mohilary|হাগ্ৰামা মহিলাৰী
Harivara Vipra|হৰিবৰ বিপ্ৰ
Harvey J. Alter|হাৰ্ভি জে. অল্টাৰ
Nathan Brown|নাথান ব্ৰাউন
Indra Pala|ইন্দ্ৰপাল
Jaddanbai|জদ্দনবাঈ
Jagdeep|জগদীপ
Jagdish Mukhi|জগদীশ মুখী
Kirit Pradyot Deb Barma|কিৰিত প্ৰদ্যুৎ দেৱ বৰ্মন
Lalit Mohan Suklabaidya|ললিত মোহন শুক্লবৈদ্য
Mahadev Deka|মহাদেৱ ডেকা
Malavika Wales|মালবিকা ৱেলছ
Meena Alexander|মীনা আলেকজেণ্ডাৰ
Moloya Goswami|মলয়া গোস্বামী
Mustansir Barma|মুস্তানছিৰ বাৰ্মা
Nirmala Sitaraman|নিৰ্মলা সীতাৰমন
Poornima Arvind Pakvasa|পূৰ্ণিমা অৰবিন্দ পাকভাসা
Rani Rampal|ৰাণী ৰামপাল
Ravindra Jain|ৰবীন্দ্ৰ জৈন
Renu C. Laskar|ৰেণু চি. লস্কৰ
Robin Banerjee|ৰবীন বেনাৰ্জী
Sansuma Khunggur Bwiswmuthiary|চাঞ্চুমা খুংগুৰ বিচমূতিয়াৰী
Sardara Singh|চৰদাৰা সিং
Mohammed Shami|মহম্মদ শ্বামি
Sister Shivani|শিৱানী বৰ্মা
Majeed Amjad|মজিদ আমজাদ
Srikanth Sastry|শ্ৰীকান্ত শাস্ত্ৰী
Sudipta Sengupta|সুদীপ্তা সেনগুপ্তা
Sujatha Ramdorai|সুজাতা ৰামদ'ৰাই
Suklenmung|চুক্লেণমুং
Sumita Devi|সুমিতা দেবী
Taarak Mehta|তাৰক মেহতা
Tapas Paul|তাপস পাল
Trevor Beattie|Trevor Beattie
Vimalakka|বিমলাক্কা
Vinita Bali|বিনিতা বালী
Yakub Memon|য়াকুব মেমন
Ishan Debnath|ঈশান দেবনাথ
Kamala Harris|কমলা হেৰিছ
Mia Love|মিয়া লাভ
Lakshmi Nandan Bora|লক্ষ্মীনন্দন বৰা
Satyanath Bora|সত্যনাথ বৰা
Debananda Bharali|দেবানন্দ ভৰালি
Sarat Chandra Goswami|শৰৎচন্দ্ৰ গোস্বামী
Wilson Tukire|Wilson Tukire
Madhurjya Borah|মাধুৰ্য বৰা
Shraddha Kapoor|শ্ৰদ্ধা কাপুৰ
Raaj J Konwar|ৰাজজ্যোতি কোঁৱৰ
Bimla Buti|বিমলা বুটি
Vinod Krishan|বিনোদ কৃষন
Ragini Trivedi|ৰাগিনী ত্ৰিবেদী
Sanjida Khatun|সনজীদা খাতুন
Natasja Nobels|Natasja Nobels
Ram Nath Kovind|ৰাম নাথ কোৱিন্দ
Malavat Poorna|মালাৱাত পূৰ্ণা
Nangeli|নাঙেলি
Sudeshna Sinha|সুদেষ্ণা সিন্‌হা
Anupama Bhattacharjya|অনুপমা ভট্টাচাৰ্য
Dipa Karmakar|দীপা কৰ্মকাৰ
Nip Barua|নিপ বৰুৱা
Elam Endira Devi|এলম ইন্দিৰা দেৱী
Keshav Mahant|কেশৱ মহন্ত
Gomdhar Konwar|গোমধৰ কোঁৱৰ
Francisco Javier Fernández Luque|জাভি ফাৰ্ণাণ্ডেজ
Peter Costa|পিটাৰ ক'ষ্টা
Tarun Saikia|তৰুণ শইকীয়া
Atul Chandra Barua|অতুল চন্দ্ৰ বৰুৱা
Lakshiram Barua|লক্ষ্মীৰাম বৰুৱা
|হিতেশ ডেকা
|হেৰিয়েট বি.এল. কট্টাৰ
Jitendra Kumar|জীতেন্দ্ৰ কুমাৰ
Chandraprava Saikiani|চন্দ্ৰপ্ৰভা শইকীয়ানী
Kailasavadivoo Sivan|কে. শিৱান
Madaram Brahma|মদৰাম ব্ৰহ্ম
Darshan Raval|দৰ্শন ৰাৱল
Vyjayanthi Chari|বৈজয়ন্তী চাৰী
Yumlembam Gambhini Devi|য়ুমলেম্বম গম্ভিনী দেৱী
Neelamani Devi|নীলমণি দেৱী
Neeraj Kabi|নীৰজ কাবি
Sukanya Rahman|সুকন্যা ৰহমান
|জিতেন হাজৰিকা
Bharati Shivaji|ভাৰতী শিৱাজী
Kuladhar Saikia|কুল শইকীয়া
|ৰত্নকান্ত বৰকাকতী
|পীতাম্বৰ দেৱ গোস্বামী
Dipali Barthakur|দীপালী বৰঠাকুৰ
Promode Gogoi|প্ৰমোদ গগৈ
|বিষ্ণুপ্ৰিয়া দেৱী
|সতৰাম চাৰিঙীয়া ফুকন
Dwipen Baruah|দ্বীপেন বৰুৱা
|দীনেশ চন্দ্ৰ গোস্বামী
|গোকুল পাঠক
Thonakal Gopi|থোনাকল গোপী
Rohit Sardana|ৰোহিত চাৰ্দানা
Reinhard Hechenberger|Reinhard Hechenberger
Nicola Chan Lam|Nicki Chan-Lam
Yola DaCosta|Yola DaCosta
Felicitas Matlane Cheer|Felicitas Matlane Cheer
Bermary Altagracia Polanco Muñoz|Bermary Altagracia Polanco Muñoz
Jagjit Kaur|জগজিৎ কৌৰ
Munawwar Sultana|মুনাৱৰ চুলতানা
Grzegorz Bekrycht|Grzegorz Bekrycht
Cudzik|Cudzik
Kinga Bednarkiewicz|Kinga Bednarkiewicz
Feliks Kościelski|Feliks Kościelski
Bożena Rachelska|Bożena Rachelska
Włodzimierz Błażyński|Włodzimierz Błażyński
Józefa Ciurys|Józefa Ciurys
Artur Ćmiel|Artur Ćmiel
Krystyna Kopeć|Krystyna Kopeć
Piotr Mazur|Piotr Mazur
Mariusz Borowiec|Mariusz Borowiec
Kamil Turonek|Kamil Turonek
Dariusz Czekan|Dariusz Czekan
Marlena Flis|Marlena Flis
Wojciech Poszelężny|Wojciech Poszelężny
Agata Świst|Agata Świst
Jerzy Grzywniak|Jerzy Grzywniak
Helena Radaczyńska|Helena Radaczyńska
Marek Krajewski|Marek Krajewski
Marzena Lipińska|Marzena Lipińska
Paweł Kaczyński|Paweł Kaczyński
Małgorzata Jura|Małgorzata Jura
Mateusz Walaszek|Mateusz Walaszek
Lole Courtois|Lole Courtois
Audrey Chaillou|Audrey Chaillou
Juliane Piron|Juliane Piron
Minet|Minet
Aase Hansson|Aase Hansson
Akseli Danskanen|Akseli Danskanen
Ayesha Akram|Ayesha Akram
Bebs David-Andersen|Bebs David-Andersen
Boris Ma|Boris Ma
Inge Brevik|Inge Brevik
Inge Flognfeldt|Inge Flognfeldt
Inger Gerkman|Inger Gerkman
Jimmy Pohan|Jimmy Pohan
Jørn Myrestrand|Jørn Myrestrand
Kari Jørgensen|Kari Jørgensen
Karsten Schultz|Karsten Schultz
Kim Duck-young|Kim Duck-young
Luis Siles|Luis Siles
Luisa Chua|Luisa Chua
Mads Thøgersen|Mads Thøgersen
Marina Fernández|Marina Fernández
Musarat Wasti|Musarat Wasti
Nhat Nguyen|Nhat Nguyen
Olly Taieth|Olly Talet
Rainer Brander|Rainer Brander
Saba Rasheed|Saba Rasheed
Sara Khan|Sara Khan
Sergey Petrov|Sergey Petrov
Sigrun Smith|Sigrun Smith
Tatyana Novikova|Tatyana Novikova
Timothy Moseley|Timothy Moseley
Yan Hang|Yan Hang
Ahmad Muhammad Waqas|Ahmad Muhammad Waqas
Akram Baig|Akram Baig
Amir Saeed|Amir Saeed
Ann Christine Damström|Ann Christine Damström
Arnau Duran|Arnau Duran
Callum Hemming|Callum Hemming
Christopher Martínez|Christopher Alexander Martinez Salvador
Crystal Pan|Crystal Pan
Damaris Ortiz Parada|Damaris Ortiz Parada
Dick Monthén|Dick Monthén
F. Hammersley|F. Hammersley
Fendy Iwanto|Fendy Iwanto
Hege Skagun|Hege Skagun
Hendry Winarto|Hendry Winarto
Hilmar Kass Jacobsen|Hilmar Kass Jacobsen
Ignacio de Vinatea|Ignacio de Vinatea
Ingrid Fikenscher|Ingrid Fikenscher
Jacob Dynnes Hansen|Jacob Dynnes Hansen
Jan Louda|Jan Louda
Jane Jacoby|Jane Jacoby
Jan-Sören Schulz|Jan-Sören Schulz
Jeppe Bay Madsen|Jeppe Bay Madsen
Jerome Careil|Jerome Careil
Jesus Sanchez Lama|Jesus Sanchez Lama
José Pedro|José Pedro
Kantaphon Wangcharoen|Kantaphon Wangcharoen
Kjersti Torp|Kjersti Torp
Laura Álvarez|Laura Alvarez
Marc Gallardo|Marc Gallardo
Mark Robertson|Mark Robertson
Miguel Barbado|Miguel Barbado
Muhammad Muqeet Tahir|Muhammad Muqeet Tahir
Murad Ali|Murad Ali
Pekka Ryhänen|Pekka Ryhänen
Peter Knudsen|Peter Knudsen
Piramon Chamnaktan|Piramon Chamnaktan
Rachel Sugden|Rachel Sugden
Robert Fox|Robert Fox
Romane Cloteaux-Foucault|Romane Cloteaux-Foucault
Sadia Arshad|Sadia Arshad
Sean Wilson|Sean Wilson
Sissel Svestad|Sissel Svestad
Soh Wooi Yik|Soh Wooi Yik
Steven Stallwood|Steven Stallwood
Thommy Sargito|Thommy Sargito
Valentina Korovkina|Valentina Korovkina
Valtteri Nieminen|Valtteri Nieminen
Vicent Riera|Vicent Riera
Vitaliya Chigintseva|Vitaliya Chigintseva
Vladimir Shishkov|Vladimir Shishkov
Yim Seung-ki|Yim Seung-ki
Yoshio Horikawa|Yoshio Horikawa
Yukie Sumida|Yukie Sumida
Laura Sánchez|Laura Sánchez
Tatiana Caicedo Muñoz|Tatiana Caicedo Muñoz
Cristina Poy|Cristina Poy
A. Matthews|A. Matthews
Alexander Moser|Alexander Moser
Andrew Ong|Andrew Ong
Anna Nazaryan|Anna Nazaryan
Armine Torosyan|Armine Torosyan
Athi Selladurai|Athi Selladurai
Beverly Hite|Beverly Hite
Bridget Ibenero|Bridget Ibenero
Choi Sang-won|Choi Sang-won
Christine Stadlmayr|Christine Stadlmayr
Clemens Graf|Clemens Graf
Dario Arnold|Dario Arnold
Debbie Godfrey|Debbie Godfrey
Dieter Altvater|Dieter Altvater
Elisa Widowitz|Elisa Widowitz
Elliott Clutterbuck|Elliott Clutterbuck
Emily Ang|Emily Ang
Esther Villanueva|Esther Villanueva
Fay Truscott|Fay Truscott
Franz Cermak|Franz Cermak
Franz Sommeregger|Franz Sommeregger
Fritz Plöckinger|Fritz Plöckinger
Garik Movsisyan|Garik Movsisyan
Gerda Kamschal|Gerda Kamschal
Gerda Mitterer|Gerda Mitterer
Gerhild Fischer|Gerhild Fischer
Guillermo Bronstrup|Guillermo Bronstrup
Gulnar Ebilova|Gulnar Ebilova
Hannes Riek|Hannes Riek
Harutyun Gabrielyan|Harutyun Gabrielyan
Heinz Gertz|Heinz Gertz
Herbert Mally|Herbert Mally
Hilde Themel|Hilde Themel
Hovhannes Avdalyan|Hovhannes Avdalyan
Jessica Reinholdsson|Jessica Reinholdsson
Kalombo Mulenga|Kalombo Mulenga
Karen Larsen|Karen Larsen
Karim Rézig|Karim Rézig
Katharina Hochmeir|Katharina Hochmeir
Keith Andrews|Keith Andrews
Kilian Meusburger|Kilian Meusburger
Kobita Dokhee|Kobita Dokhee
Kumi Honmura|Kumi Honmura
L. Little|L. Little
Laksika Kanlaha|Laksika Kanlaha
Laura Berríos|Laura Berríos
Lothar Engstler|Lothar Engstler
Luis Ramón Garrido|Luis Ramon Garrido
Lukas Rebhandl|Lukas Rebhandl
Lukas Weissenbäck|Lukas Weissenbäck
Malik Agayev|Malik Agayev
María José Avila|María José Avila
Mariam Muradyan|Mariam Muradyan
Matthias Bertsch|Matthias Bertsch
Melissa Trouerbach|Melissa Trouerbach
Miqayel Babayan|Miqayel Babayan
Mselem Juma|Mselem Juma
Natalie Herbst|Natalie Herbst
Nicklas Johansson|Nicklas Johansson
Nora Billard|Nora Billard
Nunung Mudijanto|Nunung Mudijanto
Orkhan Garagozov|Orkhan Garagozov
Peter Huemer|Peter Huemer
Rauf Habibov|Rauf Habibov
Roberto Bardeci|Roberto Bardeci
Roswitha Szczepanski|Roswitha Szczepanski
Ruth Kleinfelder|Ruth Kleinfelder
Samed Qaibov|Samed Qaibov
Santiago Bugallo|Santiago Bugallo
Sargis Isahakyan|Sargis Isahakyan
Silke Ambrosch|Silke Ambrosch
Simon Leung|Simon Leung
Sirine Ibrahim|Sirine Ibrahim
Venera Bdoyan|Venera Bdoyan
Weiß|Weiß
Wolfgang Hinteregger|Wolfgang Hinteregger
Wu Wenjing|Wu Wenjing
Yoon Im-soon|Yun Lim Soon
Zaven Muradyan|Zaven Muradyan
A. Lawrence Scott|A. Lawrence Scott
A. M. Bouchet|A. M. Bouchet
A. McKenzie|A. McKenzie
A. McNeill|A. McNeill
Aileen Chiñas|Aileen Chiñas
Alain de Leeuw|Alain de Leeuw
Alan Chan|Alan Chan
Alex Nel|Alex Nel
Alexander Schilling|Alexander Schilling
Alisher Kholmirzaev|Alisher Kholmirzaev
Ana Laura de la Torre|Ana Laura de la Torre
Andrew Compton|Andrew Compton
Anirban Chetia|Anirban Chetia
Anne Devillers|Anne Devillers
Annika Oliwa|Annika Oliwa
Antony Anchery Bennet|Antony Anchery Bennet
Arjun Reddy Pochana|Arjun Reddy Pochana
B. Whale|B. Whale
Benjamin Wahl|Benjamin Wahl
Boomer|Boomer
Botho Makubate|Botho Makubate
C. Koch|C. Koch
Carlos Emanuelle Morales Corzo|Carlos Emanuelle Morales Corzo
Cecilia Garza|Cecilia Garza
Charne Du Preez|Charne Du Preez
Choi Min-ji|Choi Min-ji
Christina Kunzmann|Christina Kunzmann
Christophe Valette|Christophe Valette
Claire Norbury|Claire Norbury
Corky Murray|Corky Murray
D. Singleton|D. Singleton
D. W. Earle|D. W. Earle
David Kramer|David Kramer
Dietrich Franke|Dietrich Franke
Domken|Domken
Duncan Rae|Duncan Rae
E. Crayton|E. Crayton
E. Hetley|E. Hetley
E. Wadsworth|E. Wadsworth
Enkhmandakh Purevsuren|Enkhmandakh Purevsuren
Enrique Parrales|Enrique Parrales
Ernestina Rivera|Ernestina Rivera
Evi Wagatha|Evi Wagatha
Evy Descamps|Evy Descamps
Friedhelm Erben|F. Erben
F. Martinez Rico|F. Martinez Rico
G. Martinez|G. Martinez
Gloria Chung|Gloria Chung
Gustavo Meré|Gustavo Meré
Hatice Nurgül Sen|Hatice Nurgül Sen
Hazel Trinidad|Hazel Trinidad
Helga Zolnhofer|Helga Zolnhofer
Hu Chuan-En|Hu Chuan-En
Ida Riley|Ida Riley
Ivan Botha|Ivan Botha
J. Verplancke de Diepenhede|J. Verplancke de Diepenhede
Jack Stuart|Jack Stuart
James Moffat|James Moffat
Jayan James|Jayan James
Jean Brice Montagnon|Jean Brice Montagnon
Jens Ehlert|Jens Ehlert
Jérôme Legrand|Jérôme Legrand
Jesús Olvera|Jesús Olvera
Jobaedur Rahman Rana|Jobaedur Rahman Rana
John Jaury|John Jaury
Katharina Sagstetter|Katharina Sagstetter
Kati Tibor|Kati Tibor
Khurshid Alam|Khurshid Alam
Kirstie Campbell|Kirstie Campbell
Konstantin Dubs|Konstantin Dubs
L. Garry|L. Garry
L. H. Wilson|L. H. Wilson
L. St. Lawrence|L. St. Lawrence
Laila|Laila
Lee Tuck Chew|Lee Tuck Chew
Luciana Raquel Verastegui|Luciana Raquel Verastegui
M. Ams|M. Ams
M. MacDonald|M. MacDonald
M. Zaman|M. Zaman
Maderer|Maderer
Magda Schreiner|Magda Schreiner
Manfred Tripp|Manfred Tripp
Manuel Vineeth|Manuel Vineeth
Marcela Nesvedová|Marcela Nesvedová
María Eugenia Muñoz|María Eugenia Muñoz
Maria Kizil|Maria Kizil
Marina Caubergs|Marina Caubergs
Massinger|Massinger
Matthias Klein|Matthias Klein
Mayank Behal|Mayank Behal
Mendjargal Munkhchimeg|Mendjargal Munkhchimeg
Mohsin|Mohsin
Mona Emrich|Mona Emrich
N. B. Basnyat|N. B. Basnyat
Nadine Kuhnert|Nadine Kuhnert
Neha Jojo|Neha Jojo
Nikzad Shiri|Nikzad Shiri
Norma Krafft|Norma Krafft
Nydia González|Nydia González
P. R. Joshi|P. R. Joshi
P. Vinay Kumar Reddy|P. Vinay Kumar Reddy
Pei Wei Chung|Pei Wei Chung
R. McNeill|R. McNeill
Raidorf|Raidorf
Rami Al-Sheikh|Rami Al-Sheikh
Robert Mommaerts|Robert Mommaerts
Roich|Roich
Sabine Huber|Sabine Huber
Sarada Jasti|Sarada Jasti
Shapla Akhter|Shapla Akhter
Shawkat Ali Khan Babu|Shawkat Ali Khan Babu
Shinji Shinkai|Shinji Shinkai
Shlok Ramchandran|Shlok Ramchandran
Shubho|Shubho
Stephan Schindler|Stephan Schindler
Steven Kirk|Steven Kirk
T. D. Newton|T. D. Newton
Tam Chui Chee|Tam Chui Chee
Tan Wee Tat|Tan Wee Tat
Tariq Fawir|Tariq Fawir
Thujen Pham|Thujen Pham
Trideb|Trideb
Urmi Lohani|Urmi Lohani
Veerle Rakels|Veerle Rakels
Y. Ellett|Y. Ellett
Yasmin|Yasmin
Yulia Liavitskaya|Yulia Liavitskaya
Zhou Bingqing|Zhou Bingqing
Zia Hossain|Zia Hossain
Gifty Mensah|Gifty Mensah
Abhishek Yelegar|Abhishek Yelegar
Rashmika Mandanna|ৰশ্মিকা মন্দান্না
Kiran Bala Bora|কিৰণ বালা বড়া
Eli Ahmed|এলি আহমেদ
Miguel López González|Miguel López González
Rodrigo Medina Benjumea|Rodrigo Medina Benjumea
Alfonso Toro Buiza|Alfonso Toro Buiza
José Jiménez Jimena|José Jiménez Jimena
Anjali Narzary|অঞ্জলী নাৰ্জাৰী
|সোণেশ্বৰ বৰা
Radha Kessar|ৰাধা কেচ্চাৰ
Gyan Pujari|জ্ঞান পূজাৰী
Giacomo Tocci|Giacomo Tocci
Charan Narzary|চৰণ নাৰ্জাৰী
Bhogeshwari Phukanani|ভোগেশ্বৰী ফুকননী
Shaktikanta Das|শক্তিকান্ত দাস
Donna Strickland|ডনা ষ্ট্ৰিকলেণ্ড
Gitanjali Rao|গীতাঞ্জলি ৰাও (বিজ্ঞানী)
Bibha Chowdhuri|বিভা চৌধুৰী
|বাহাদুৰ গাঁওবুঢ়া
Bulbul Chakraborty|বুলবুল চক্ৰৱৰ্তী
Hemanta Dutta|হেমন্ত দত্ত
Lakhimi Baruah|লখিমী বৰুৱা
Santwana Bordoloi|সান্ত্বনা বৰদলৈ
Fabienne Lupo Magnaudet|Fabienne Lupo Magnaudet
Bhagwat Patel|ভাগৱত পেটেল
|মাণিক চন্দ্ৰ বৰুৱা
Piyoli Phukan|পিয়লি ফুকন
Bidya Rao|বিদ্যা ৰাও
Troilokya Bhattacharya|ত্ৰৈলোক্য ভট্টাচাৰ্য
Ramesh Pathak|ৰমেশ পাঠক
Elvis Ali Hazarika|এলভিছ আলী হাজৰিকা
Indira P P Bora|ইন্দিৰা পি পি বৰা
Partha Chattopadhyay|পাৰ্থ চট্টোপাধ্যায়
Basen Murmu|বছেন মুৰ্মু
Kuranganayani|কুৰংগনয়নী
Pradip Baruah|প্ৰদীপ বৰুৱা
Bindhu Malini|বিন্দু মালিনী
Bhaskar Jyoti Mahanta|ভাস্কৰ জ্যোতি মহন্ত
Kelly Vedovelli|Kelly Vedovelli
Keertichandra Borbarua|কীৰ্তিচন্দ্ৰ বৰুবৰুৱা
Junab Ali|জুনাব আলী
Yanina Kuskova|Yanina Kuskova
Gautam Bora|গৌতম বৰা
Greta Karasiovaite|Greta Karasiovaite
Joseph Samudio|Joseph Samudio
Dimitrios Christakos|Dimitrios Christakos
Muhammad Shahmir Aiman Abdul Halim|Muhammad Shahmir Aiman Abdul Halim
Sakchai Phodingam|Sakchai Phodingam
Karina Louise Sørensen|Karina Louise Sørensen
Mira Peeters|Mira Peeters
Cybil Di Guistini|Cybil Di Guistini
Anna-Sophia Czilwik|Anna-Sophia Czilwik
Myriam Desrosiers|Myriam Desrosiers
Adéla Vlnova|Adéla Vlnova
Monika Richterova|Monika Richterova
Nicholas Timmings|Nicholas Timmings
Ruth Demeijer|Ruth Demeijer
Chantal Polansky|Chantal Polansky
Liliano Leenknegi|Liliano Leenknegi
Kim Van Gastel|Kim Van Gastel
Nicole Peitzmeier|Nicole Peitzmeier
Jonathan Eric Gustafson|Jonathan Eric Gustafson
Roman Sarmah|ৰোমান শৰ্মা
Dominik Hufschmid|Dominik Hufschmid
Lorenz Hollenbach|Lorenz Hollenbach
Matthias Grahé|Matthias Grahé
Bruno Schiemann|Bruno Schiemann
Justin Jacob|Justin Jacob
Tim Berners-Lee|টিম বাৰ্নাৰ্ছ লী
Carl Sagan|কাৰ্ল চাগান
André-Marie Ampère|আণ্ড্ৰে মেৰি এম্পিয়েৰ
Paul Verlaine|পল ভেৰ্লেন
Isaac Newton|আইজাক নিউটন
Charles Darwin|চাৰ্লছ ডাৰউইন
Michelangelo|মাইকেলেঞ্জেল'
Allen Ginsberg|এলেন গিন্সবাৰ্গ
Qin Shi Huangdi|ক্যিন ছি হোৱং
Marcel Proust|মাৰ্চেল প্ৰুষ্ট
Dan Brown|ডন ব্ৰাউন
Ernest Rutherford|আৰ্নেষ্ট ৰাডাৰফ'ৰ্ড
Mahavira|মহাবীৰ
Sachin Tendulkar|শচীন তেণ্ডুলকাৰ
Amitabh Bachchan|অমিতাভ বচ্চন
Fidel Castro|ফিডেল কাষ্ট্ৰ'
Maria Sharapova|মাৰিয়া ছাৰাপোভা
Angelina Jolie|এঞ্জেলিনা জলি
Diego Maradona|মাৰাড'না
Muammar Gaddafi|মোৱাম্মাৰ গাড্ডাফি
Adele|এডেল
Justin Bieber|জাষ্টিন বিবাৰ
Agatha Christie|আগাথা ক্ৰিষ্টি
Ho Chi Minh|হ' চি মিন
T. S. Eliot|টি এছ ইলিয়ট
Edwin Hubble|এডৱিন হাবল
J. M. Coetzee|জে. এম. কয়েৎজে
Richard Dawkins|ৰিচাৰ্ড ড'কিনছ্
Zico|জিক'
Imran Shah|ইমৰান শ্বাহ
Venkatraman Ramakrishnan|ভেংকটৰমণ ৰামাকৃষ্ণণ
C. V. Raman|চন্দ্ৰশেখৰ ভেঙ্কটৰমণ
Horatio Nelson|লৰ্ড নেলছন
Amartya Sen|অমৰ্ত্য সেন
Thor Heyerdahl|টুৰ হেয়াৰ্ডাল
Zakir Hussain|জাকিৰ হুছেইন (ৰাজনীতিবিদ)
Vidya Balan|বিদ্যা বালান
Alfredo Di Stéfano|আল্‌ফ্ৰেড' ডি ষ্টিফান'
Farah Khan|ফাৰাহ খান
Zeb-un-Nisa|জেব-উন-নিছা
Gabriel Batistuta|গেব্ৰিয়েল বাটিষ্টুটা
Mani Ratnam|মণি ৰত্নম
Zeenat Aman|জিনাত আমান
Evanna Lynch|ইভানা লিনছ
Bhāskara II|ভাস্কৰাচাৰ্য
Khaleda Zia|খালেদা জিয়া
Kalpana Chawla|কল্পনা চাওলা
Sarojini Naidu|সৰোজনী নাইডু
Rishi Kapoor|ঋষি কাপুৰ
Bartolomeo Cristofori|বাৰ্তোলোমিঅ' ক্ৰিষ্টফ'ৰি
Kabir|কবীৰ
V. V. Giri|বৰাহগিৰি ভেংকট গিৰি
Gopal Krishna Gokhale|গোপাল কৃষ্ণ গোখলে
Gary Snyder|গেৰী স্নাইডাৰ
Gulzarilal Nanda|গুলজাৰিলাল নন্দা
Abhinav Bindra|অভিনৱ বিন্দ্ৰা
Vyasa|বেদব্যাস
Chandra Shekhar|চন্দ্ৰ শেখৰ
Pramathesh Barua|প্ৰমথেশ চন্দ্ৰ বৰুৱা
Ram Mohan Roy|ৰাজা ৰামমোহন ৰায়
Neelam Sanjiva Reddy|নীলম সঞ্জীৱ ৰেড্ডী
Robin Cook|ৰবিন কুক
Peter Reid|পিটাৰ ৰেইড
Jahnu Barua|জাহ্নু বৰুৱা
Bismillah Khan|বিছমিল্লাহ খান
Esther Duflo|ইস্থাৰ ডাফ্লো
Melinda Gates|মেলিণ্ডা গেটছ
Devika Rani|দেবীকা ৰাণী
M. S. Subbulakshmi|এম এছ চুব্বালক্ষ্মী
Razia Sultana|ৰাজিয়া চুলতানা
Kavita Krishnamurthy|কবিতা কৃষ্ণমূৰ্তি
Gulzar|গুলজাৰ
Naseeruddin Shah|নাছিৰুদ্দিন শ্বাহ
Geeta Dutt|গীতা দত্ত
MS Dhoni|মহেন্দ্ৰ সিং ধোনি
Gregory Corso|গ্ৰেগোৰি কোৰছো
Andrea M. Ghez|এণ্ড্ৰিয়া এম. ঘেজ
Mahalakshmi Iyer|মহালক্ষ্মী আয়াৰ
Baldev Raj Chopra|বি. আৰ. চোপ্ৰা
Maya|মায়া
Steven Johnson|ষ্টিভেন জনছন
Jeetumoni Kalita|জিতুমণি কলিতা
Duncan Haldane|ফ্ৰেডৰিক ডুনকান মাইকেল হাল্ডেন
Kumar Bhaskara Varman|কুমাৰ ভাস্কৰ বৰ্মা
Viola Paulitz|Viola Müller-Paulitz
Fatma Begum|ফাটিমা বেগম
Bishnuram Medhi|বিষ্ণুৰাম মেধি
Bimala Prasad Chaliha|বিমলা প্ৰসাদ চলিহা
Michael Kosterlitz|জন মাইকেল কষ্টাৰলিটজ
Deepika Kumari|দীপিকা কুমাৰী
Lee Kwang-jin|Lee Kwang Jin
Ahmed Patel|আহমেদ পেটেল
Ranjit Shekhar Mooshahary|ৰঞ্জিৎ শেখৰ মুছাহাৰী
Shiva Thapa|শিৱ থাপা
S. P. Balasubrahmanyam|এছ. পি. বালসুব্ৰমনিয়ম
Ramamurti Shankar|ৰামামূৰ্তি শংকৰ
Javed Akhtar|জাভেদ আখটাৰ
Zaheer Khan|জাহীৰ খান
Madan Mohan Malaviya|মদন মোহন মালৱীয়
Ahilyabai Holkar|অহল্যাবাই হলকাৰ
Jaspal Bhatti|যশপাল ভাট্টি
Nayanthara|নয়নতাৰা
Lauren Booth|আমার ঘর ভািঙ্গয়ােছ েয়বা আমি বাধি তার ঘর। আপন করিেত কাদিয়া েবরাই েয েমাের করেছে পর
Ramdhari Singh Dinkar|ৰামধাৰী সিং 'দিনকৰ'
Girija Devi|গিৰিজা দেৱী
Jean-Pierre Sauvage|জিন-পিয়েৰী চাওভেজ
Subimal Basak|সুবিমল বসাক
Abala Bose|অবলা বসু
Wenche Lowzow|Wenche Lowzow
Savitri|সাৱিত্ৰী (অভিনেত্ৰী)
Rajnath Singh|ৰাজনাথ সিং
Mallika Sarabhai Shah|মল্লিকা সাৰাভাই
Priyamani|প্ৰিয়ামণি
Rohit Sharma|ৰোহিত শৰ্মা
Sudha Murthy|সুধা মূৰ্তি
Samantha Akkineni|সামান্থা আক্কিনেনী
Mithali Raj|মিতালী ৰাজ
C. S. Lakshmi|চি এচ লক্ষ্মী
Kittur Chennamma|কিট্টুৰ চেন্নাম্মা
Sunderlal Bahuguna|সুন্দৰলাল বহুগুণা
Protima Bedi|প্ৰতিমা বেদী
Arun Jaitley|অৰুণ জেটলী
Guru Ghasidas|ঘাসীদাস
Hem Chandra Barua|হেমচন্দ্ৰ বৰুৱা
Amish Tripathi|অমিষ ত্ৰিপাঠী
Ram Charan Teja|ৰাম চৰণ তেজা
Roddam Narasimha|ৰোদ্দম নৰসিম্‌হা
Anita Goel|অনিতা গোয়েল
Aadesh Shrivastava|আদেশ শ্ৰীবাস্তৱ
Adil Hussain|আদিল হুছেইন
Yogi Adityanath|যোগী আদিত্যনাথ
Adriaen Honich|Adriaen Honich
Alpana Banerjee|আল্পনা বন্দোপাধ্যায়
Amit Trivedi|অমিত ত্ৰিবেদী
Anuradha Acharya|অনুৰাধা আচাৰ্য
Anuradha Sharma Pujari|অনুৰাধা শৰ্মা পূজাৰী
Anwar Hussain|আনোৱাৰ হুচেইন
Janaki Ammal|জানকী অম্মল
Bala Hijam|বালা হিজাম
Beauty Sharma Barua|বিউটি শৰ্মা বৰুৱা
Bhattadeva|ভট্টদেৱ
Binodini Dasi|বিনোদিনী দাসী
Binoy Majumdar|বিনয় মজুমদাৰ
Bishnu Prasad Rabha|বিষ্ণুপ্ৰসাদ ৰাভা
Chandramukhi Basu|চন্দ্ৰমুখী বসু
Dipak Sarma|দীপক শৰ্মা
Fearless Nadia|ফিয়েৰলেচ নাদিয়া
Nripen Chakraborty|নৃপেন চক্ৰৱৰ্তী
Jagdish Singh Khehar|জগদীশ সিং খেহৰ
Janaki Devi Bajaj|জানকী দেৱী বাজাজ
Jayanta Hazarika|জয়ন্ত হাজৰিকা
Kaikesi|কৈকেষী
Kalicharan Brahma|কালীচৰণ ব্ৰহ্ম
Kamala Bhattacharya|কমলা ভট্টাচাৰ্য
Kanak Rele|কনক ৰেলে
Tony Joseph|টনি জোছেফ
Laluksola Borphukan|লালুকসোলা বৰফুকন
Lil Bahadur Chettri|লীল বাহাদুৰ চেত্ৰী
Mahendrapala|মহেন্দ্ৰপাল
Mary Clubwalla Jadhav|মেৰী ক্লাৱৱালা যাদৱ
Mohammad Nissar|মহম্মদ নিছাৰ
Nabin Chandra Bardoloi|নবীনচন্দ্ৰ বৰদলৈ
Padmanath Gohain Baruah|পদ্মনাথ গোহাঞি বৰুৱা
Birendra Nath Datta|বীৰেন্দ্ৰনাথ দত্ত
Prabhavati Devi|প্ৰভাৱতী দেৱী
Radhika Apte|ৰাধিকা আপ্টে
Rakul Preet Singh|ৰাকুল প্ৰীত সিং
Ranjan Gogoi|ৰঞ্জন গগৈ
Rehnesh TP|ৰেহনেছ টি পি
Renuka Devi Barkataki|ৰেণুকা দেৱী বৰকটকী
Sanjana Kapoor|সঞ্জনা কাপুৰ
Sarmistha Pritam|শৰ্মিষ্ঠা প্ৰীতম
Sati Joymati|জয়মতী কুঁৱৰী
Shweta Tripathi|শ্বেতা ত্ৰিপাঠী
Sitara Devi|চিতাৰা দেৱী
Siva Prasad Barooah|শিৱ প্ৰসাদ বৰুৱা
Sudoiphaa|চুদৈফা
Suhitpangphaa|চুহিত্পংফা
Sujinphaa|চুজিন্‌ফা
Sukhaamphaa|চুখাম্‌ফা
Sutingphaa|চুত্যিন্‌ফা
Tiruppattur Venkatachalamurti Ramakrishnan|টি ভি ৰামকৃষ্ণন
Tarun Ram Phukan|তৰুণ ৰাম ফুকন
Teejan Bai|তীজান বাঈ
Tun Tun|টুন টুন
Upendranath Brahma|উপেন্দ্ৰনাথ ব্ৰহ্ম
Upendranath Brahmachari|উপেন্দ্ৰনাথ ব্ৰহ্মচাৰী
V Shanta|ভি. শান্তা
William Francis Ganong, Jr.|ৱিলিয়াম ফ্ৰান্সিছ গেনং কনিষ্ঠ
Zohurul Hoque|জহৰুল হক
Savitha Sastry|সবিতা শাস্ত্ৰী
Anicia Proba|Anicia Proba
Binanda Chandra Barua|বিনন্দ চন্দ্ৰ বৰুৱা
Kaliram Medhi|কালিৰাম মেধি
Hem Barua|হেম বৰুৱা
Kanaklal Barua|কনকলাল বৰুৱা
Benudhar Rajkhowa|বেণুধৰ ৰাজখোৱা
Chandra Kumar Agarwala|চন্দ্ৰকুমাৰ আগৰৱালা
Arunima Sinha|অৰুণিমা সিনহা
Surya Kumar Bhuyan|সূৰ্যকুমাৰ ভূঞা
Nirmal Prabha Bordoloi|নিৰ্মলপ্ৰভা বৰদলৈ
Nilmoni Phukan|নীলমণি ফুকন (জ্যেষ্ঠ)
Raghunath Choudhary|ৰঘুনাথ চৌধাৰী
Dutee Chand|দূতী চান্দ
Muhi Ram Saikia|মুহিৰাম শইকীয়া
Alaa Wardi|অল্লা ৱৰ্দি
Nirmala Mishra|নিৰ্মলা মিশ্ৰ
Charles Alexander Bruce|চাৰ্লছ আলেকজেণ্ডাৰ ব্ৰুছ
Mahasundari Devi|মহাসুন্দৰী দেৱী
Padmanath Bhattacharya|পদ্মনাথ ভট্টাচাৰ্য বিদ্যাবিনোদ
Nagen Saikia|নগেন শইকীয়া
Bhubanmohan Baruah|ভূৱন মোহন বৰুৱা
Lalit Chandra Nath|ললিত চন্দ্ৰ নাথ
Madhulika Liddle|মধুলিকা লিড্ডল
Vilson Vattanirappel|Vilson Vattanirapel
Kanchan Chaudhary Bhattacharya|কাঞ্চন চৌধুৰী ভট্টাচাৰ্য
Mujib Pardeshi|মুজিব পৰদেশী
Archana Sharma|অৰ্চনা শৰ্মা (উদ্ভিদ বিজ্ঞানী)
Sujangphaa|চুজান্‌ফা
Parvathy Baul|পাৰ্বতী বাউল
Zohrabai Ambalewali|জোহৰাবাই অম্বালেৱালী
Emmanuelle Charpentier|ইমানুৱেল চাৰ্পেণ্টিয়ে
Raashi Khanna|ৰাশী খান্না
Sakshi Malik|সাক্ষী মালিক
Vinesh Phogat|বিনেশ ফোগাট
Mahi Chandra Miri|মহীচন্দ্ৰ মিৰি
Brajen Baruah|ব্ৰজেন বৰুৱা
Majeed Memon|মজিদ মেমন
|লুনা লহকৰ
Surabhi Lakshmi|সুৰভি লক্ষ্মী
Apoorva Sharma|অপূৰ্ব শৰ্মা
Nirupama Borgohain|নিৰূপমা বৰগোহাঞি
Beereshwar Barua|বীৰেশ্বৰ বৰুৱা
Aditi Pant|আদিতি পণ্ট
Naseem Banu|নাচিম বানু
Mukul Chandra Goswami|মুকুলচন্দ্ৰ গোস্বামী
Yogendran Krishnan|Krishnan Yogendran
Jürg Stäubli|Jürg Stäubli
Sati Sadhani|সতী সাধনী
Chanda Jog|চন্দা জ'গ
|উমাকান্ত শৰ্মা
|গীতাৱলী ৰাজকুমাৰী
|তিলক হাজৰিকা
Piyali Baruah|পিয়লি বৰুৱা
|মিতালী চৌধুৰী
|সুধালতা দুৱৰা
Gayatri Sankaran|গায়ত্ৰী শংকৰণ
Swaran Lata|স্বৰণ লতা (কণ্ঠশিল্পী)
Sai Pallavi|ছাই পল্লৱী
Chandamama Artist Shankar|কে চি শিৱশংকৰণ
Soumya Swaminathan|সৌম্যা স্বামীনাথন
Rewati Chetri|ৰেৱতী চেত্ৰী
Luis Jorge Rivera Herrera|লুইচ জৰ্জ ৰিভেৰা হেৰেৰা
Pushpalata Das|পুষ্পলতা দাস
Varun Singh Bhati|বৰুণ সিং ভাটী
|আইখেক বুঢ়াগোহাঁই
|উইলিয়াম ৱাৰ্ড
Padmavati Devi Phukanani|পদ্মাৱতী দেৱী ফুকননী
|মধুৰাম বড়ো
|কৰুণা কান্ত কলিতা
Adya Sharma|আদ্য শৰ্মা
|লোনা সোনোৱাল
Alain de Chambrier|Alain de Chambrier
Karabi Deka Hazarika|কৰবী ডেকা হাজৰিকা
Pratima Bandopadhyay|প্ৰতিমা বন্দোপাধ্যায়
Sonia Cambril|Sonia Cambril
Raheem A. Abdul|Aditya Elango
Hadil Kareem|Hadil Kareem
Gabriela Meilani Moningka|Gabriela Melani Moringka
Kuo Wen Wayne|Kuo Wen Wayne
Wiesław Wieczorek|Wiesław Wieczorek
Jerzy Skibicki|Jerzy Skibicki
Czesław Wojciechowski|Czesław Wojciechowski
Leszek Nowakowski|Leszek Nowakowski
Roman Nowik|Roman Nowik
Jerzy Szczerbicki|Jerzy Szczerbicki
Lidia Baczyńska|Lidia Baczyńska
Grażyna Trojan|Grażyna Trojan
Ewa Zdrojewska|Ewa Zdrojewska
Krzysztof Kruk|Krzysztof Kruk
Krzysztof Bruchwalski|Krzysztof Bruchwalski
Jarosław Bąk|Jarosław Bąk
Roman Golinowski|Roman Golinowski
Zofia Drogomirecka|Zofia Drogomirecka
Marcin Paluch|Marcin Paluch
Mirosław Adamczyk|Mirosław Adamczyk
Bartosz Kocik|Bartosz Kocik
Anna Rosko|Anna Rosko
Maciej Kowalik|Maciej Kowalik
Magdalena Jaworek|Magdalena Jaworek
Wojciech Buczyński|Wojciech Buczyński
Mirosław Szymański|Mirosław Szymański
Danuta Miska|Danuta Miska
Jacek Jagodziński|Jacek Jagodziński
Marzena Kozłowska|Marzena Kozłowska
Wiesław Rychlik|Wiesław Rychlik
Małgorzata Szymańska|Małgorzata Szymańska
Robert Kowalczyk|Robert Kowalczyk
Michał Cybulski|Michał Cybulski
Wojciech Skrodzki|Wojciech Skrodzki
Marta Byttner|Marta Byttner
Katarzyna Wójcik|Katarzyna Wójcik
Anie Gibon|Anie Gibon
Åge Henriksen|Åge Henriksen
Agnethe Juul|Agnethe Juul
Alexander Sumarokov|Alexander Sumarokov
Cécile Kaddour|Cécile Kaddour
Charlotte Jacobsen|Charlotte Jacobsen
Eero Läikkö|Eero Läikkö
Eliezer Ojeda|Eliezer Ojeda
Georgii Karpov|Georgii Karpov
Haakon Ringdal|Haakon Ringdal
Ingolf Paller|Ingolf Paller
Jamil|Jamil
Javier Sánchez|Javier Sánchez
Jesper Toft|Jesper Toft
Joel Findlay|Joel Findlay
John Stretch|John Stretch
Kari Johansen|Kari Johansen
Kelly Stern|Kelly Stern
Linnea Vainula|Linnea Vainula
Lisbeth Baumgartner|Lisbeth Baumgartner
M. Husainee|M. Husainee
Maika Phillips|Maika Phillips
Natchanon Tulamok|Natchanon Tulamok
Sachiyo Imai|Sachiyo Imai
Sho Zeniya|Sho Zeniya
Silvia Riera|Silvia Riera
Sofie Nielsen|Sofie Nielsen
Tatjana Shmakova|Tatjana Shmakova
Terttu Weckström|Terttu Weckström
Trine Leikvold|Trine Leikvold
Valérie Sarengat|Valérie Sarengat
Adam Pringle|Adam Pringle
Vyacheslav Elizarov|Vyacheslav Elizarov
Wenche Tønnesen|Wenche Tønnesen
A. D. Wadsworth|A. D. Wadsworth
A. Tan|A. Tan
Amalie Magelund|Amalie M. Krogh
Andrea Echevarria Ossa|Andrea Echevarria Ossa
Anne Klyve|Anne Klyve
Arnaud Franzi|Arnaud Franzi
Arnaud Merklé|Arnaud Merkle
Ashleigh Karl|Ashleigh Karl
Bengt Mellquist|Bengt Mellquist
Beth Richardson|Beth Richardson
Bettina Kristensen|Bettina Kristensen
Bruno Barrueto Deza|Bruno Barrueto Deza
Bruno Carvalho|Bruno Carvalho
Carol Wightman|Carol Wightman
Chen Wan-Ting|Chen Wan-Ting
Christopher Back|Christopher Back
Debbie Hore|Debbie Hore
Duarte Nuno Anjo|Duarte Nuno Anjo
Duncan Yao|Duncan Yao
Dylan Soedjasa|Dylan Soedjasa
Elliot Pike|Elliot Pike
Enrique Pancorbo|Enrique Pancorbo
Ernesto Osma|Ernesto Osma
Franziska Burkert|Franziska Burkert
Häkan Fossto|Häkan Fossto
Haward Chalen Aspiazu|Haward Chalen Aspiazu
Igor Gantchitis|Igor Gantchitis
Imran Mohib|Imran Mohib
James Boxall|James Boxall
Joana Lopes|Joana Lopes
José Javier Cardos|José Javier Cardos
Julie Macpherson|Julie Macpherson
Kåre Samuelsen|Kåre Samuelsen
Karin Christensen|Karin Christensen
Kevin Holland|Kevin Holland
Kimberly Windsor|Kimberly Windsor
Kjersti Haakonen|Kjersti Haakonen
Lin Ying-Chun|Lin Ying-Chun
Lorraine Fowler|Lorraine Fowler
Luka Milić|Luka Milić
Mads Hallas|Mads Hallas
Mads Muurholm Petersen|Mads Muurholm Petersen
Mads Sørensen|Mads Sørensen
Marie Louise Steffensen|Marie Louise Steffensen
Maria Kurochkina|Marina Kurochkina
Matthew Grimley|Matthew Grimley
Mille Pjedsted|Mille Pjedsted
Myra Dammert|Myra Dammert
Nathan Laemmel|Nathan Laemmel
Oscar Guo|Oscar Guo
Paul Reynolds|Paul Reynolds
Pavla Janošová|Pavla Janošová
Per Rose|Per Rose
Réka Madarász|Réka Madarász
Runa Plützer|Runa Plützer
Sara Leeves|Sara Leeves
Scott Menzies|Scott Menzies
Shinobu Ogura|Shinobu Ogura
Steve Isaac|Steve Isaac
T. Concepcion|T. Concepcion
Taj Moosvi|Taj Moosvi
Tangi Gouez|Tangi Gouez
Thomas Andersen|Thomas Andersen
Tony Preede|Tony Preede
Veronica Sandberg|Veronica Sandberg
Vivien Sándorházi|Vivien Sandorhazi
Zehra Erdem|Zehra Erdem
Zhanna Chornenkaya|Zhanna Chornenkaya
Alonso Medel|Alonso Medel
Armen Malkhasyan|Armen Malkhasyan
August Woschitz|August Woschitz
B. Welch|B. Welch
Bente Jeppesen|Bente Jeppesen
Billy Cheung|Billy Cheung
Britta Kirchhofer|Britta Kirchhofer
C. Aw|C. Aw
Cheryl Mullett|Cheryl Mullett
Lee Chia-Han|Lee Chia-Han
Cho A-ra|Cho A-ra
Christa Feser|Christa Feser
Claudia Gorin|Claudia Gorin
Claudia Lam|Claudia Lam
Craig Cassidy|Craig Cassidy
Croome|Croome
Crystal Wong|Crystal Wong
Cun Cun Haryono|Cun Cun Haryono
Daniel Pesserer|Daniel Pesserer
David Sobol|David Sobol
Davies Senono|Davies Senono
Dinare Nesirova|Dinare Nesirova
Ding Jiao|Ding Jiao
Dominik Trojan|Dominik Trojan
Dwi Aryanto|Dwi Aryanto
Elnara Mchdieva|Elnara Mchdieva
Elshan Abbasov|Elshan Abbasov
Ernst Liska|Ernst Liska
Eugene Uys|Eugene Uys
Hana Tarek Mohamed|Hana Tarek Mohamed
Hans Fauland|Hans Fauland
Harutyun Harutyunyan|Harutyun Harutyunyan
Heinz Ottmann|Heinz Ottmann
Inge Mönch|Inge Mönch
J. Badenach|J. Badenach
Jack Wu|Jack Wu
Jana Haas|Jana Haas
Jasmine Yeo Siao Yien|Jasmine Yeo Siao Yien
Johanthan Mangra|Johanthan Mangra
Jung Tae-keuk|Jung Tae-keuk
Kunjira Khongdee|Kunjira Khongdee
Lilli Greutter|Lilli Greutter
Linda Mazri|Linda Mazri
Luca Dobler|Luca Dobler
Manfred Kramer|Manfred Kramer
Manuel Dornig|Manuel Dornig
Manuela Lassinger|Manuela Lassinger
Maria Fröhlich|Maria Fröhlich
Martina Nöst|Martina Nöst
Melvin Appiah|Melvin Appiah
Michael Garay|Michael Garay
Miriam Sude|Miriam Sude
Nadine Reiter|Nadine Reiter
Narmin Azizova|Narmin Azizova
Nataliya Zhavoronkova|Nataliya Zhavoronkova
Nina Sorger|Nina Sorger
Paula Harrison|Paula Harrison
Raphaela Winkler|Raphaela Winkler
Rena Feyzullayeva|Rena Feyzullayeva
Renate Wallner|Renate Wallner
Richard Schneeberger|Richard Schneeberger
Ronel Pieterse|Ronel Pieterse
Sabine Salzer|Sabine Salzer
Sarvan Nagiev|Sarvan Nagiev
Shareen Matthews|Shareen Matthews
Shevaun Moody|Shevaun Moody
Sona Gevorgyan|Sona Gevorgyan
Stuart Rowlands|Stuart Rowlands
Sunway Ling|Sunway Ling
Thatphong Phayoongpol|Thatphong Phayoongpol
Thomas Biruhs|Thomas Biruhs
Thomas Pipan|Thomas Pipan
Tomas Thouyaret|Tomas Thouyaret
Vardan Kirakosyan|Vardan Kirakosyan
Walter Grasmugg|Walter Grasmugg
Yukina Imura|Yukina Imura
Zaven Mnatsakanyan|Zaven Mnatsakanyan
Zhou Chaomin|Zhou Chaomin
Saurabh Sharma|Saurabh Sharma
Rex Lardner|Rex Lardner
Jesús Arturo Barajas López|Jesús Arturo Barajas López
Citra Putri Sari Dewi|Citra Putri Sari Dewi
A. B. Pullen|A. B. Pullen
A. Longard|A. Longard
A. N. Azad Bablu|A. N. Azad Bablu
Adam Holleran|Adam Holleran
Ailsa Campbell|Ailsa Campbell
Akhtaruzzaman Nantu|Akhtaruzzaman Nantu
Akrur N. Rana|Akrur N. Rana
Amaury Jérôme Lejoint|Amaury Jérôme Lejoint
Anastasia Petrova|Anastasia Petrova
Andi Saputro Nugroho|Andi Saputro Nugroho
Andrei Vaganov|Andrei Vaganov
Andres Ramirez|Andres Ramirez
Andrey Kravchanka|Andrey Kravchanka
Anna Miroshnik|Anna Miroshnik
Anne Chien|Anne Chien
Anne Foblets|Anne Foblets
B. Howes|B. Howes
B. Solomon|B. Solomon
Baksi|Baksi
Bandar Sigit Pamungkas|Bandar Sigit Pamungkas
Budinan|Budinan
Carmela Martinez|Carmela Martinez
Carola Mühlberger|Carola Mühlberger
Christian Schmalhaus|Christian Schmalhaus
Clara Lassaux|Clara Lassaux
Claude Bar|Claude Bar
D. Wan|D. Wan
Damien Maquet|Damien Maquet
Daria Sherbinskaya|Daria Sherbinskaya
Dave Saunders|Dave Saunders
Dominique Kaiser|Dominique Kaiser
E. Kyme|E. Kyme
Ekaterina Chyprinenko|Ekaterina Chyprinenko
Elena Havriliuk|Elena Havriliuk
Els Carrein|Els Carrein
Fabian Hippold|Fabian Hippold
Florian Berchtenbreiter|Florian Berchtenbreiter
Francisco Sañudo|Francisco Sañudo
Gerardo Cedillo|Gerardo Cedillo
Gilles Laguesse|Gilles Laguesse
Greet van Haverbeke|Greet van Haverbeke
H. H. Fow|H. H. Fow
Heike Hallof|Heike Hallof
Igar Birukov|Igar Birukov
J. Gómez Luna|J. Gómez Luna
Jamari Rose|Jamari Rose
James Moon Lin Lan|James Moon Lin Lan
Jayashree Nair|Jayashree Nair
Jesús López|Jesús López
Jordy Vandewinkel|Jordy Vandewinkel
Kareem Shedeed|Kareem Shedeed
Konnullil Sebastian|Konnullil Sebastian
Laurence Charneux|Laurence Charneux
Lawrence de Pauw|Lawrence de Pauw
Liesse Vandersmissen|Liesse Vandersmissen
M. Cooke|M. Cooke
M. R. Subedi|M. R. Subedi
Mahathir Mustaffa|Mahathir Mustaffa
Maksim Makarenko|Maksim Makarenko
Martin Bareiß|Martin Bareiß
Mary Connor|Mary Connor
Maxim Konakh|Maxim Konakh
Mozammel Haque Montu|Mozammel Haque Montu
N. R. C. Wilson|N. R. C. Wilson
Nadja Draskovits|Nadja Draskovits
Nicole Harrison|Nicole Harrison
Niels Hansen|Niels Hansen
Nining Kustyaningsih|Nining Kustyaningsih
Norma Hernandez|Norma Hernandez
Oleg Mezian|Oleg Mezian
Ong Huck Lee|Ong Huck Lee
Oscar Lujan|Oscar Lujan
Oyuntuguldur Gan-Undur|Oyuntuguldur Gan-Undur
Öznur Çalışkan|Öznur Çalışkan
Pavel Valoshyn|Pavel Voloshin
Peggy Vilbig|Peggy Vilbig
Peter Streit|Peter Streit
Poorvisha Ram|Poorvisha Ram
Raeesah Rassoolkhan|Raeesah Rassoolkhan
Ram Rai|Ram Rai
Raymond Tan|Raymond Tan
Rinku|Rinku
Roland Müller|Roland Müller
Rosel Drolsbach|Rosel Drolsbach
Rowan Scheurkogel|Rowan Scheurkogel
Ruben Mejia|Ruben Mejia
Ruth Menchaca|Ruth Menchaca
Sam Van Den Broeck|Sam Van Den Broeck
Shahin|Shahin
Shakhriyor Khikmatov|Shakhriyor Khikmatov
Siddharath Thakur|Siddharath Thakur
Socorro Lam|Socorro Lam
Song Chang-yeop|Song Chang-yeop
Sonja Krüger|Sonja Krüger
Stefan Grüble|Stefan Grüble
Stefanie Bertels|Stefanie Bertels
Stephanie Bader|Stephanie Bader
Steven Knaepen|Steven Knaepen
Stijn De Langhe|Stijn De Langhe
Subbana Palghun|Subbana Palghun
Susana Zenea|Susana Zenea
Sviatlana Ligatsyk|Sviatlana Ligatsyk
Tami Parks|Tami Parks
Thomas Hutzler|Thomas Hutzler
Thomas Nirschl|Thomas Nirschl
V. Marot|V. Marot
Verena Roth|Verena Roth
Veronika Koldová|Veronika Koldová
Violetta Starcz|Violetta Starcz
Vishnu Sreekumar|Vishnu Sreekumar
W. E. Fossette|W. E. Fossette
Wittmann|Wittmann
Xiao Ting|Xiao Ting
Yassine Iliasse|Yassine Iliasse
Ulyana Zakharava|Yliana Zaxarova
Zhang Lei|Zhang Lei
Utpal Borpujari|উৎপল বৰপূজাৰী
Padmanav Bordoloi|পদ্মনাভ বৰদলৈ
Gilmar Jones|Gilmar Jones
Harika Veludurthi|Harika Veludurthi
Riyan Parag|ৰিয়ান পৰাগ
Lilabati Bhattacharjee|লীলাৱতী ভট্টাচাৰ্য
Gunjan Bhardwaj|গুঞ্জন ভৰদ্বাজ
Eusebio Calonge Francés|Eusebio Calonge Francés
Joaquín Pla Laporta|Joaquín Pla Laporta
Nayandeep Deka Baruah|নয়নদীপ ডেকা বৰুৱা
Jibeswar Baruah|জীৱেশ্বৰ বৰুৱা
Amrit Pritam|অমৃত প্ৰীতম
Brajendra Kumar Brahma|ব্ৰজেন্দ্ৰ কুমাৰ ব্ৰহ্ম
Basanti Devi Bisht|বাসন্তী বিষ্ট
Joyasree Goswami Mahanta|জয়শ্ৰী গোস্বামী মহন্ত
Manu Bhaker|মনু ভাকৰ
Prajakta Koli|প্ৰজক্তা কলি
Deeplina Deka|দীপলিনা ডেকা
Jens Hofer|Jens Hofer
Prafulla Baruah|প্ৰফুল্ল গোবিন্দ বৰুৱা
Jacopo Orsini|Jacopo Orsini
Baua Devi|বৌৱা দেৱী
Dara Ahmed|দাৰা আহমেদ
|মীনা আগৰৱালা
|মাধৱ বৈশ্য
Muthayya Vanitha|মুথৈয়া ভণিতা
Victor-Charles-Émile Dain|Victor-Charles-Émile Dain
Parvez Rob|পাৰভেজ ৰব
Ram Probesh Mondal|ৰাম প্ৰবেশ মণ্ডল
Ilene Marckx|Ilene Marckx
Rajesh Khaitan|ৰাজেশ খৈতান
Padma Barkotoky|পদ্ম বৰকটকী
Lakshmidhar Sarma|লক্ষ্মীধৰ শৰ্মা
Atan Burhagohain|আতন বুঢ়াগোহাঁই
Atanu Bhattacharyya|অতনু ভট্টাচাৰ্য
Rama Das|ৰমা দাশ
Ratna Ojha|ৰত্ন ওজা
Dharani Barman|ধৰণী বৰ্মণ
Anil Saikia|অনিল শইকীয়া
Anubhav Tulasi|অনুভৱ তুলসী
Akhil Ranjan Dutta|অখিল ৰঞ্জন দত্ত
Deepankar Medhi|দীপাংকৰ (দীপ) মেধি
Archana Mahanta|অৰ্চনা মহন্ত
Lianne Witkin|Lianne Witkin
Disha Ravi|দীশা ৰবি
Teodor Rusev|Teodor Rusev
Rokas Kmieliauskas|Rokas Kmieliauskas
Marc Oliver Pritzen|Marc Oliver Pritzen
Ranjitsinh Disale|ৰণজিত সিংহ ডিচলে
Tsveta Nesheva|Tsveta Nesheva
Doreen Weise|Doreen Weise
Nele Van Den Bossche|Nele Van Den Bossche
Sandra Degueldre|Sandra Degueldre
Claudia Marietta|Claudia Marietta
Karry Ellen Hellmuth|Karry Ellen Hellmuth
Patricia Hempel|Patricia Hempel
Ann Roegiers|Ann Roegiers
Saskia Van Duuren|Saskia Van Duuren
Marieke Haverdings|Marieke Haverdings
Arya Rajendran|আৰ্য ৰাজেন্দ্ৰন
Luisiana Pegoraro|Luisiana Pegoraro
Erika Schertl|Erika Schertl
Deira Mari|Deira Mari
Nadia Zuccherelli|Nadia Zuccherelli
Rashmi Narzary|ৰশ্মি নাৰ্জাৰী
Silvia Zoller|Silvia Zoller
Elfie Kunz|Elfie Kunz
Tultul Baruah|তুলতুল বৰুৱা
Karin Avenant|Karin Avenant
Ljudmilla Corneo|Ljudmilla Corneo
Cornelia Dreher|Cornelia Dreher
Pabitra Rabha|পবিত্ৰ ৰাভা
Manjamma Jogathi|মাঞ্জাম্মা জগতী
Gopiram Bargayn Burabhakat|গোপীৰাম বৰগায়ন বুঢ়াভকত
Mārtiņš Bots|Mārtiņš Bots
Detelina Marinova|Detelina Marinova
Dawn Richardson Wilson|Dawn Richardson Wilson
Mike Evelyn|Mike Evelyn
Reba Kanta Mohanta|ৰেৱকান্ত মহন্ত
Kenny Weyh|Kenny Weyh
Joyce Echaquan|Joyce Echaquan
Jimmy Wales|জিম্মী ৱেলছ
Larry Sanger|লেৰী ছেংগাৰ
Ludwig van Beethoven|লুটৱিস ফান বিটহ'ফন
Adolf Hitler|এডল্ফ হিটলাৰ
Bob Dylan|বব ডিলন
Genghis Khan|চেংগিজ খান
Leonardo da Vinci|লিঅ'নাৰ্ড' দা ভিন্সি
Mahatma Gandhi|মোহনদাস কৰমচান্দ গান্ধী
Robert Louis Stevenson|ৰবাৰ্ট লুই ষ্টিভেনছন
Bruce Willis|ব্ৰুচ ৱিলিছ
Marlene Dietrich|মাৰ্লিন ডিট্ৰিস
Salvador Dalí|চালভাদ'ৰ দালি
Pablo Picasso|পাবলো পিকাছো
Rembrandt|ৰে'ম্ব্ৰেণ্ট
Eminem|এমিনেম
Che Guevara|চে গোৱেৰা
Carl Friedrich Gauss|কাৰ্ল ফ্ৰিডৰিখ গাউছ
Alan Turing|এলান ট্যুৰিং
Christopher Columbus|ক্ৰিষ্টোফাৰ কলম্বাছ
Vasco da Gama|ভাস্কো দা গামা
Sergei Eisenstein|ছেৰ্গেই আইজেনষ্টাইন
Martin Luther King Jr.|মাৰ্টিন লুথাৰ কিং, অনুজ
Walt Disney|ৱাল্ট ডিজনী
Thomas Alva Edison|টমাছ আলভা এডিচন
Nikola Tesla|নিক'লা টেছলা
Sigmund Freud|চিগ্‌মণ্ড ফ্ৰয়েড
Gautama Buddha|গৌতম বুদ্ধ
Vallabhbhai Patel|বল্লভভাই পেটেল
Pythagoras|পাইথাগ’ৰাছ
J. K. Rowling|জে. কে. ৰাউলিং
Aung San Suu Kyi|আং-চান-চ্যু-কি
Madhubala|মধুবালা
Jackson Pollock|জেকছন পোলক
Reema Kagti|ৰীমা কাগতি
Asha Bhosle|আশা ভোঁচলে
Arjen Robben|আৰ্জেন ৰবিন
Octavio Paz|অক্টাৱিয়' পাছ
Jesse Owens|জেছি ওৱেন্‌ছ
K. R. Meera|কে আৰ মীৰা
Reinhard Genzel|ৰেইনহাৰ্ড গেনজেল
DJ Khaled|ডি জে খালিদ
Rachel Carson|ৰাচেল কাৰ্ছন
A. R. Rahman|এ. আৰ. ৰহমান
Niels Henrik Abel|নীলছ হেনৰিক এবেল
William James|উইলিয়াম জেম্‌ছ
M. G. Ramachandran|এম. জি. ৰামচন্দ্ৰন
E. C. Stuart Baker|ই চি ষ্টুৱাৰ্ট বেকাৰ
Nutan Bahl|নূতন
Deepika Padukone|দীপিকা পাডুকন
Rajendra Prasad|ৰাজেন্দ্ৰ প্ৰসাদ
Cobie Smulders|ক'বি স্মল্ডাৰ্ছ
Brahmagupta|ব্ৰহ্মগুপ্ত
Zeenat Mahal|জীনত মহল
Akshay Kumar|অক্ষয় কুমাৰ
Anita Desai|অনিতা দেশাই
M. Stanley Whittingham|এম. ষ্টেনলী হুইটটিনগাম
Shriya Saran|শ্ৰীয়া চৰণ
Nathuram Godse|নাথুৰাম গডছে
Joseph Swan|জোছেফ শ্বান
Abhishek Yadav|অভিচেক য়াদৱ
Rakesh Sharma|ৰাকেশ শৰ্মা
Raja Ravi Varma|ৰাজা ৰবি বৰ্মা
Zail Singh|জেইল সিং
C. Rajagopalachari|চক্ৰৱৰ্তী ৰাজাগোপালাচাৰী
Jamshedji Framji Madan|জামছেদজী ফ্ৰেমজী মদন
Wee Kim Wee|Wee Kim Wee
Tania Sachdev|টানিয়া শচদেৱ
Fatima Jinnah|ফাতিমা জিন্নাহ
Aparna Sen|অপৰ্ণা সেন
Meira Kumar|মীৰা কুমাৰ
Jahanara Begum Sahib|জাহানাৰা বেগম
Irom Chanu Sharmila|ইৰম চানু শৰ্মীলা
J. R. D. Tata|জাহাংগীৰ ৰতনজী দাদাভাই টাটা
Udit Narayan|উদিত নাৰায়ণ
Kishore Kumar|কিশোৰ কুমাৰ
Nalinidhar Bhattacharya|নলিনীধৰ ভট্টাচাৰ্য
Savitri Jindal|সাৱিত্ৰী জিন্দাল
Prasanta Chandra Mahalanobis|প্ৰশান্ত চন্দ্ৰ মহালানবিছ
Stephen Amell|ষ্টিফেন এমেল
Amrapali|আম্ৰপালি
Gangubai Hangal|গংগুবাঈ হংগল
Dattatreya|দত্তাত্ৰেয়
Chaitanya Mahaprabhu|চৈতন্য মহাপ্ৰভু
Dr. Zakir Naik|জাকিৰ নাইক
Saira Banu|চায়ৰা বানু
Purushottam Das Tandon|পুৰুষোত্তম দাস টেণ্ডন
Jogendra Nath Hazarika|যোগেন্দ্ৰ নাথ হাজৰিকা
Ott Tänak|অট টানক
Narayana Varman|নাৰায়ণ বৰ্মা
Susthita Varman|সুস্থিত বৰ্মা
Denis Mukwege|ডেনিছ মুকৱেগে
Dev Kant Baruah|দেৱকান্ত বৰুৱা
Subrata Pall|চুব্ৰতা পল
Ruskin Bond|ৰাস্কিন বণ্ড
Pingali Venkayya|পিঙ্গলি ভেংকয়া
Kesab Chandra Gogoi|কেশৱ চন্দ্ৰ গগৈ
Ursus Wehrli|আৰছাছ ৱেৰলী
Michael W. Young|মাইকেল ডব্লিউ. ইয়ং
Anup Soni|অনুপ সোনি
Guru Tegh Bahadur|গুৰু টেগ বাহাদুৰ
E. Gayathri|ই. গায়ত্ৰী
Urvashi Butalia|উৰ্বশী বুটালিয়া
Mamoni Raisom Goswami|মামণি ৰয়ছম গোস্বামী
Sudhir Ranjan Majumdar|সুধীৰ ৰঞ্জন মজুমদাৰ
Pandurang Vaman Kane|পাণ্ডুৰাংগ বমন কানে
Anandita Dutta Tamuly|আনন্দিতা দত্ত তামূলী
Anand Bakshi|আনন্দ বক্সী
Sachin Dev Burman|শচীন দেৱবৰ্মণ
Anandi Gopal Joshi|আনন্দীবাঈ যোশী
Anita Nair|অনিতা নায়াৰ
Bidhan Chandra Roy|বিধান চন্দ্ৰ ৰয়
Salim Ali|চালিম আলি
Parineeti Chopra|পৰিনীতি চোপ্ৰা
Jibanananda Das|জীবনানন্দ দাস
Prabhas|প্ৰভাস
Ben Feringa|বেৰনাৰ্ড লুকাছ ফেৰীনগা
Gopalkrishna Gandhi|গোপালকৃষ্ণ গান্ধী
Madhabi Mukherjee|মাধৱী মুখাৰ্জী
Hemanga Biswas|হেমাঙ্গ বিশ্বাস
Kanan Devi|কানন দেৱী
Padma Subrahmanyam|পদ্মা সুব্ৰামনিয়াম
Kailash Satyarthi|কৈলাস সত্যাৰ্থী
Bhanupriya|ভানুপ্ৰিয়া
Mukesh Khanna|মুকেশ খান্না
Jadav Payeng|যাদৱ পায়েং
Bhagyashree Patwardhan|ভাগ্যশ্ৰী
Begum Akhtar|বেগম আখটাৰ
Tarabai|তাৰাবাই ভোঁচলে
Sharada|সাৰদা
Riyaz Khan|ৰিয়াজ খান
Ila Arun|ইলা অৰুণ
Anarkali|আনাৰকলী
Mrinalini Sarabhai|মৃণালিনী সাৰাভাই
Padmini Kolhapure|পদ্মিনী কোহলাপুৰী
Bijoy Krishna Handique|বিজয় কৃষ্ণ সন্দিকৈ
Kalpana Lajmi|কল্পনা লাজমী
Sulakshana Pandit|সুলক্ষণা পণ্ডিত
Mala Sinha|মালা সিনহা
Madhavdeva|মাধৱদেৱ
Vibhuti Narain Rai|বিভূতি নাৰায়ণ ৰায়
Madhava Kandali|মাধৱ কন্দলী
Shamshad Begum|শমশাদ বেগম
Katie Stevens|Katie Stevens
Adriaen Cornelisz Beeldemaker|Adriaen Cornelisz Beeldemaker
Ajamila|অজামিল
Ali Asgar|Ali asger
Ambikagiri Raichoudhury|অম্বিকাগিৰি ৰায়চৌধুৰী
Angami Zapu Phizo|আংগামী জাপো ফিজ’
Anjali Gopalan|অঞ্জলী গোপালন
Anna Chandy|আন্না চান্দী
Anwaruddin Choudhury|আনোৱাৰুদ্দিন চৌধুৰী
Muthulakshmi Reddy|মুথুলক্ষ্মী ৰেড্ডী
Atul Chandra Hazarika|অতুল চন্দ্ৰ হাজৰিকা
Bakul Kayastha|বকুল কায়স্থ
Begum Aizaz Rasul|বেগম ঐজাজ ৰচুল
Bijoya Chakravarty|বিজয়া চক্ৰৱৰ্তী
Dip Gogoi|দীপ গগৈ
Gugu Gill|গুগু গিল
Gunabhiram Barua|গুণাভিৰাম বৰুৱা
Jim Ankan Deka|জিম অংকন ডেকা
Himanta Biswa Sarma|হিমন্ত বিশ্ব শৰ্মা
Hiren Gohain|হীৰেন গোহাঁই
Indraneil Sengupta|ইন্দ্রনীল সেনগুপ্তা
Indu Jain|ইন্দু জৈন
Sharda|সাৰদা (কণ্ঠশিল্পী)
Jeet Ganguly|জিৎ গাংগুলী
Jogeswar Singha|যোগেশ্বৰ সিংহ
Johan Letzelter|জহান লেটজেল্টাৰ
Juthika Roy|যুথিকা ৰায়
Kapil Sharma|Kapil Sharma
Kirip Chaliha|কিৰিপ চলিহা
Kirti Kulhari|কীৰ্তি কুলহাৰী
Steve Darby|ষ্টীভ ডাৰ্বি
Sukhaangphaa|চুখ্ৰাংফা
Mahendra Mohan Choudhry|মহেন্দ্ৰ মোহন চৌধুৰী
Mahim Bora|মহিম বৰা
Mamang Dai|মামাং দাই
Manpreet Kaur|মনপ্ৰীত কৌৰ
Momai Tamuli Borbarua|মোমাই তামুলী
Monali Thakur|মোনালী ঠাকুৰ
Moran Sarkar|মৰাণ চৰকাৰ
Nigar Sultana|নিগাৰ চুলতানা
Padmaja Naidu|পদ্মজা নাইডু
Panna Dai|ধাত্ৰী পান্না
Pitambar Dvija|পীতাম্বৰ কবি
Pratima Barua Pandey|প্ৰতিমা বৰুৱা পাণ্ডে
Radha Govinda Baruah|ৰাধাগোবিন্দ বৰুৱা
Ramen Deka|ৰমেন ডেকা
Rebati Mohan Dutta Choudhury|ৰেৱতী মোহন দত্ত চৌধুৰী
Sabitri Chatterjee|সাবিত্ৰী চট্টোপাধ্যায়
Sarabjit Singh|সৰৱজিৎ সিং
Saraswati Devi|সৰস্বতী দেৱী (সঙ্গীত পৰিচালক)
Shahnaz Husain|চেহনাজ হুছেইন
Shakib Khan|শাকিৱ খান
Shikhar Dhawan|শিখৰ ধৱন
Shanthanu Bhagyaraj|শান্তনু ভাগ্যৰাজ
Shyamal Mitra|শ্যামল মিত্ৰ
Sucheta Dalal|সুচেতা দালাল
Sukhamoy Sen Gupta|সুখময় সেন গুপ্ত
Suteuphaa|চুতেউফা
Toru Dutt|তৰু দত্ত
Vasanti N. Bhat-Nayak|বাসন্তী এন. ভাটনায়ক
Parag Kumar Das|পৰাগ কুমাৰ দাস
Kedarnath Singh|কেদাৰনাথ সিং
Manju Sharma|মঞ্জু শৰ্মা
Bhumanyu|ভূমন্যু
Yang Li Lian|Li Lian Yang
Suklingphaa|চুক্লিংফা
Nandita Swetha|নন্দিতা স্বেতা
Rohini Bhate|ৰোহিনী ভাটে
Kautilya Pandit|কৌটিল্য পণ্ডিত
Archana Bhattacharyya|অৰ্চনা ভট্টাচাৰ্য
N. V. Ramana|এন. ভি. ৰমনা
Babushaan|বাবুশান মহান্তি
Shashi Wadhwa|শশী ৱাধৱা
Neeta Sen|নীতা সেন
Purnima Sinha|পূৰ্ণিমা সিন্‌হা
George Baker|জৰ্জ বেকাৰ
Malini Awasthi|মালিনী অৱস্তী
Prafulla Kumar Das|প্ৰফুল্ল কুমাৰ দাস
Prodyut Bora|প্ৰদ্যুত বৰা
Christopher Moloney|ক্রিস্টোফার মলোনি
Gaurav Gogoi|গৌৰৱ গগৈ
Adrianne Wadewitz|এদ্ৰিয়ান ৱেডৱিত্জ
Manju Borah|মঞ্জু বৰা
Sunyeophaa|চুণ্যেউফা
Thomas Velley|Thomas Velley
Suhungmung|চুহুংমুং
Shila Mehta|শিলা মেহতা
Pooja Sharma|পূজা শৰ্মা
Sharmistha Mukherjee|শৰ্মিষ্ঠা মুখাৰ্জী
Jitu Rai|জিতু ৰায়
Rahmat Banu Begum|ৰমণী গাভৰু
Abdul Majid|আব্দুল মজিদ
Tapan Das|তপন দাস
Jitul Sonowal|জিতুল সোণোৱাল
Bhaben Barua|ভবেন বৰুৱা
Ilias Pollalis|ইলিয়াচ পল্লালিচ
Atanu Das|অতনু দাস
Nangsal Tamang|Nangsal Devi Tamang
Siba Prasad Thakur|শিৱ প্ৰসাদ ঠাকুৰ
Pulak Banerjee|পুলক বেনাৰ্জী
Haobam Ongbi Ngangbi Devi|হোবাম অংবি ঙাংবি দেৱী
Haramara Gaitan|Haramara Gaytan
Mayukh Hazarika|ময়ূখ হাজৰিকা
Gayatri Mahanta|গায়ত্ৰী মহন্ত
|কলাই কোঁচ
Nikumoni Baruah|নিকুমণি বৰুৱা
Pulak Gogoi|পুলক গগৈ
Brajen Borah|ব্ৰজেন বৰা
|মৌচুমী চহৰীয়া
|লক্ষ্মীকান্ত বৰুৱা
|মুনমী ফুকন
|ৰেবা ফুকন
Renuka Ravindran|ৰেণুকা ৰবিন্দ্ৰন
Draupadi Murmu|দ্ৰৌপদী মূৰ্মু
Anjan Dutta|অঞ্জন দত্ত
Sheena Bora|শ্বীনা বৰা হত্যাকাণ্ড
Tayabun Nisha|তয়াবুন নিছা
Rajni Basumatary|ৰজনী বসুমতাৰী
Shobhana Narasimhan|শোভানা নৰসিংহ
Arup Kumar Dutta|অৰূপ কুমাৰ দত্ত
Sayani Gupta|ছায়ানী গুপ্তা
Parineeta Borthakur|পৰিণীতা বৰঠাকুৰ
Dhrubajyoti Phukan|ধ্ৰুৱজ্যোতি ফুকন
|অসীম বোথ্ৰা
|নিংনি ভাৱৰীয়া
|সোণাৰাম চুতীয়া
Ramen Baruah|ৰমেন বৰুৱা
|আলি হাইদৰ
Gyannath Bora|জ্ঞাননাথ বৰা
|যমুনেশ্বৰী খাটনিয়াৰ
Gunada Das Kour|গুণদা দাস কৌৰ
|লুম্মেৰ দাই
Trailokya Dutta|ত্ৰৈলোক্য দত্ত
|শ্ৰীহৰি বৰিকৰ
Prahlad Chandra Tasa|প্ৰহ্লাদ চন্দ্ৰ তাছা
Mariyappan Thangavelu|মাৰীয়াপ্পান থানগাভেলু
Kumud Chandra Hazarika|ৰঞ্জু হাজৰিকা
Bill Berry|W. E. Berry
Mohamad Syazmil Idham Zainal Abidin|Mohamad Syazmil Idham Zainal Abidin
Fiorella Sadowski|Fiorella Farrugia
Jacqueline Tappin|Jacqueline Tappin
Sheila Ryder|Sheila Ryder
Maoni Hu He|Hu He Maoni
Hwang Jung-woon|Woon Hwang-jung
Vladzislav Kushnir|Uladzislau Kushnir
Jerzy Zieliński|Jerzy Zieliński
Krystyna Dudzińska|Krystyna Dudzińska
Ryszard Król|Ryszard Król
Barbara Rojewska|Barbara Rojewska
Stanisław Jeżewski|Stanisław Jeżewski
Marian Belka|Marian Belka
Wiesław Danielski|Wiesław Danielski
Bogusława Płonek|Bogusława Płonek
Maria Muszak|Maria Muszak
Elżbieta Malinowska|Elżbieta Malinowska
Stanisław Czyszczoń|Stanisław Czyszczoń
Karol Hawel|Karol Hawel
Ewa Krawczyk|Ewa Krawczyk
Leonard Łącki|Leonard Łącki
Ryszard Bernardyn|Ryszard Bernardyn
Elżbieta Trojanowska|Elżbieta Trojanowska
Jerzy Gwóźdź|Jerzy Gwóźdź
Piotr Rduch|Piotr Rduch
Jacek Prędki|Jacek Prędki
Paweł Dróżdż|Paweł Dróżdż
Katarzyna Garbacka|Katarzyna Garbacka
Andrzej Skowroński|Andrzej Skowroński
Andrzej Dryżałowski|Andrzej Dryżałowski
Iwona Karwowska|Iwona Karwowska
Renata Golis|Renata Golis
Jolanta Szleszyńska|Jolanta Szleszyńska
Mateusz Szałankiewicz|Mateusz Szałankiewicz
Sylvie Robert|Sylvie Robert
Fabianne Chaboussie|Fabianne Chaboussie
Dugué|Dugué
Anabel Cháfer|Anabel Cháfer
Anita Steiner|Anita Steiner
Anne Katrine Hansen|Anne Katrine Hansen
Bengisu Erçetin|Bengisu Erçetin
Bengt Söderberg|Bengt Söderberg
Berit Hagtvedt|Berit Hagtvedt
Bernardo Atilano|Bernardo Atilano
Büşra Ünlü|Büşra Ünlü
David Stenström|David Stenström
Harry Troupp|Harry Troupp
Irina Asovkina|Irina Asovkina
Jane Pedersen|Jane Pedersen
Jessica Jonggowisastro|Jessica Jonggowisastro
Joel König|Joel König
Jonas Geigenberger|Jonas Geigenberger
Kirsten Meier|Kirsten Meier
Leo Rossi|Leo Rossi
Lisser Ytterborg|Lisser Ytterborg
Nargis Gyara|Nargis Gyara
Nighat Sultana|Nighat Sultana
Pål Øian|Pål Øian
Per Corneliussen|Per Corneliussen
Rasmus Espersen|Rasmus Espersen
Ricardo Silva|Ricardo Silva
Sy See Cheung|Sy See Cheung
Sylvi Jormanainen|Sylvi Jormanainen
Talia Saunders|Talia Saunders
Adrian Alcaide|Adrian Alcaide
Viggo Christiansen|Viggo Christiansen
Ben Hume|Ben Hume
Björn Logius|Bjoern Logius
Camila Duany|Camila Duany
Carla Pelay|Carla Pelay
Christian Erichsen|Christian Erichsen
Christine Dickinson|Christine Dickinson
Ciara Doheny|Ciara Doheny
Daigenis Saturria|Daigenis Saturria
David King|David King
Dimitri Pankov|Dimitri Pankov
F. D. Icasa|F. D. Icasa
Georgia Hughes|Georgia Hughes
Gustav Ihrlund|Gustav Ihrlund
Guy Gibson|Guy Gibson
Inge Mette Olsen|Inge Mette Olsen
Jan Junker|Jan Junker
Jara Sierra|Jara Sierra
Jesse Lehtimäki|Jesse Lehtimäki
Jin Yujia|Jin Yujia
Josephine Wu|Josephine Wu
Julie Davidsen|Julie Davidsen
Julius von Pfaler|Julius von Pfaler
Jun Bong-chan|Jun Bong-chan
Kåre Sandvik|Kåre Sandvik
Karen Morales|Karen Morales
Kasper Fangel|Kasper Fangel
Kent Palmer|Kent Palmer
Zydon Vinales|Zydon Vinales
Kornkamon Sukklad|Kornkamon Sukklad
L. Swindell|L. Swindell
Olga Dubrovina|Olga Dubrovina
Larissa Rogatneva|Larissa Rogatneva
Lilli B. Pedersen|Lilli B. Pedersen
Line Christophersen|Line Christophersen
Lorraine Mar|Lorraine Mar
Lotte Hartvich|Lotte Hartvich
Lucio Coronato|Lucio Coronato
Maria Kool|Maria Kool
Marta Calleja|Marta Calleja
Matthew Honey|Matthew Honey
Megan Heaney|Megan Heaney
Michelle Skødstrup|Michelle Skødstrup
Muhammed Saleem|Muhammed Saleem
Nathan David|Nathan David
Nils Hansen|Nils Hansen
Peter Walden|Peter Walden
Quirino Ynchausti|Quirino Ynchausti
S. A. A. Rizvi|S. A. A. Rizvi
Sokhang Krang|Sokhang Krang
Stig Wassenius|Stig Wassenius
Tshepo Perekisi|Tshepo Perekisi
Victoria Kosheleva|Victoria Kosheleva
William Mellersh|William Mellersh
Yaren Dölcü|Yaren Dölcü
A. Mullins|A. Mullins
Agustina Zudaire|Agustina Zudaire
Alexander Serov|Alexander Serov
Alvard Hovsepyan|Alvard Hovsepyan
Anahit Manukyan|Anahit Manukyan
Andrew Harvey|Andrew Harvey
Andrew Surman|Andrew Surman
Armin Griebler|Armin Griebler
Arthur Gevorgyan|Arthur Gevorgyan
Bastian Lizama|Bastian Lizama
Benjamin Schlemmer|Benjamin Schlemmer
Bernd Huemer|Bernd Huemer
Bernd Kuprian|Bernd Kuprian
Bernd Mazagg|Bernd Mazagg
Birgit Gruber|Birgit Gruber
C. Samson|C. Samson
Chris Ong|Chris Ong
Christa Petersberger|Christa Petersberger
Christina Dander|Christina Dander
Christoph Muhri|Christoph Muhri
Daniel Humblers|Daniel Humblers
E. Dimbleby|E. Dimbleby
E. McCay|E. McCay
Edwin van Dalm|Edwin van Dalm
Elena Kwok|Elena Kwok
Elio Treska|Elio Treska
Elizabeth Brett|Elizabeth Brett
Elshan Mehdiyev|Elshan Mehdiyev
Erich Mader|Erich Mader
Erwin Kirchhofer|Erwin Kirchhofer
Eva Wratschge|Eva Wratschge
F. Choon|F. Choon
Franz Fuchs|Franz Fuchs
Gabriel Urteaga Hammond|Gabriel Urteaga Hammond
Gastón Harkes|Gastón Harkes
Gea Denanda|Gea Denanda
Gerda Schrittwisser|Gerda Schrittwisser
Gor Hakobyan|Gor Hakobyan
Guggi Schechtner|Guggi Schechtner
Herdi Baumgartner|Herdi Baumgartner
Himanshu Thakkar|Himanshu Thakkar
Hrachya Mnatsakanyan|Hrachya Mnatsakanyan
Ines Mendoza|Ines Mendoza
Ingrid Fischer|Ingrid Fischer
Irene Hohl|Irene Hohl
Isolde Pertl|Isolde Pertl
Jack Wade|Jack Wade
Jan Wannenmacher|Jan Wannenmacher
Jane Griffiths|Jane Griffiths
Janine Lais|Janine Lais
Jenny Cepeda|Jenny Cepeda
Jessica Lim|Jessica Lim
Jia Wei|Jia Wei
Johanita Scholtz|Johanita Scholtz
Joline Chua Jet Ling|Joline Chua Jet Ling
Jorge Possiel|Jorge Possiel
Josef Radlinger|Josef Radlinger
Karin Duijvestijn|Karin Duijvestijn
Laura Samvelyan|Laura Samvelyan
Lee Yu-rim|Lee Yu-rim
Levon Torosyan|Levon Torosyan
Lisa Vuong|Lisa Vuong
Louise Mckenzie|Louise Mckenzie
Markus Hellauer|Markus Hellauer
Markus Pacher|Markus Pacher
Michael Haese|Michael Haese
Misautova Lora|Misautova Lora
Mitchell Wheller|Mitchell Wheller
Mitzi Abigail Purnama|Mitzi Abigail Purnama
Monika Lackner|Monika Lackner
N. Nichols|N. Nichols
Nina Almer|Nina Almer
Orkhan Galandarov|Orkhan Galandarov
Otto Eckarth|Otto Eckarth
Pang Yuet Mui|Pang Yuet Mui
Pauli Schabl|Pauli Schabl
Peter Sandre|Peter Sandre
Prisca Azuine|Prisca Azuine
Rahim Salimov|Rahim Salimov
Richard Mirnig|Richard Mirnig
Ricky Irwin|Ricky Irwin
Ronaldo Meyer|Ronaldo Meyer
Rowan Henderson|Rowan Henderson
Roy Dempsey|Roy Dempsey
Samy Khaldi|Samy Khaldi
Schrättner|Schrättner
Shi Longfei|Shi Longfei
Vishal Sawaram|Vishal Sawaram
Werner Jackl|Werner Jackl
Yong Shyu-Jeng|Yong Shyu-Jeng
Yu Hua|Yu Hua
Satwiksairaj Rankireddy|Satwiksairaj Rankireddy
A. Woodward|A. Woodward
Abdul Hannan|Abdul Hannan
Adrián de la Vega|Adrián de la Vega
Alexandr Borodavkin|Alexandr Borodavkin
Allan Tai|Allan Tai
Aloysius Vijay Anthony Raj|Aloysius Vijay Anthony Raj
Amrullo Bakhshullaev|Amrullo Bakhshullaev
Andy Knaepen|Andy Knaepen
Antje Fregin|Antje Fregin
Arno Vandenhoucke|Arno Vandenhoucke
Artyom Savatyugin|Artem Savatyugin
B. Grouch|B. Grouch
B. Mani|B. Mani
B. Richardson|B. Richardson
Barbara Mckinley|Barbara Mckinley
Berta Pineda|Berta Pineda
Birger Abts|Birger Abts
Brigitte Menacher|Brigitte Menacher
C. J. Wheatley|C. J. Wheatley
C. Phillips|C. Phillips
Clive L. Sheerin|Clive L. Sheerin
Corinna Lux|Corinna Lux
Cosmin Ioan|Cosmin Ioan
Daan Philips|Daan Philips
Davaasuren Battur|Davaasuren Battur
David Welch|David Welch
Debbie Janssens|Debbie Janssens
Diana Zapata|Diana Zapata
Diego Morales|Diego Morales
Dmitri Kyzmitski|Dmitri Kyzmitski
Dulal|Dulal
E. Allen|E. Allen
E. J. Rishworth|E. J. Rishworth
Edeltraud Vonmetz|Edeltraud Vonmetz
Enrique Mathey|Enrique Mathey
Erdenechimeg Bayarsaikhan|Erdenechimeg Bayarsaikhan
François Champagne|François Champagne
Gabriel Aguilar|Gabriel Aguilar
Ganzorig Erdenebayar|Ganzorig Erdenebayar
Gediminas Andrikonis|Gediminas Andrikonis
Gert Thoné|Gert Thone
Grégory Vanvlaenderen|Grégory Vanvlaenderen
Günter Müller|Günter Müller
Hamid|Hamid
Hans Willems|Hans Willems
Heide Bichler|Heide Bichler
Helena Storch|Helena Storch
Imam|Imam
J. Flynn|J. Flynn
J. Lumley|J. Lumley
J. Wallis|J. Wallis
Jacqueline Rose Kunnath|Jacqueline Rose Kunnath
Jan Pin He|Jan Pin He
Jiang Tang|Jiang Tang
Jim Van Bouwel|Jim Van Bouwel
Joke Thone|Joke Thone
Judy Adamos|Judy Adamos
Julia Bitsoukova|Julia Bitsoukova
Julie Yu|Julie Yu
Jürgen Schmitz|Jürgen Schmitz
Justin Keen|Justin Keen
Kanchon|Kanchon
Kelli Vilu|Kelli Vilu
Khatun|Khatun
Khondker Mokter Hossain|Khondker Mokter Hossain
L. Moran|L. Moran
Lauren Meheust|Lauren Meheust
Laurent Koch|Laurent Koch
Lim Soo-bin|Lim Soo-bin
M. Arefin Badar|M. Arefin Badar
M. C. Juhel|M. C. Juhel
M. H. Fell|M. H. Fell
Maite Lamont|Maite Lamont
Marianne Heinz|Marianne Heinz
Mario Umaña|Mario Umaña
Marisol Domínguez|Marisol Domínguez
Maximilian Bobeth|Maximilian Bobeth
Mir Tahir Ishaq|Mir Tahir Ishaq
Muhammad Hafizi Hashim|Muhammad Hafizi Hashim
Narayn Chandra Ghosh|Narayn Chandra Ghosh
Nasrin|Nasrin
Nawras Abdul Wahid|Nawras Abdul Wahid
Neale R. Thompson|Neale R. Thompson
Nebedita|Nebedita
Nina Dietsch|Nina Dietsch
Nitya Sosale|Nitya Sosale
Olesia Dikan|Olesia Dikan
Olga Petrova|Olga Petrova
P. Anderson|P. Anderson
P. Roberts|P. Roberts
Paisan Loaharanu|Paisan Loaharanu
Pat Gallagher|Pat Gallagher
Philip Merz|Philip Merz
Philip Troke|Philip Troke
Phillippe Gennaux|Phillippe Gennaux
Priscille Tjitrodipo|Priscille Tjitrodipo
Rehana Abdul Latif|Rehana Abdul Latif
Rina|Rina
Rita Basnyat|Rita Basnyat
Robert Franke|Robert Franke
Rosa María Guerrero|Rosa María Guerrero
Royena|Royena
Rumana Ahmed|Rumana Ahmed
Saera Banu Munni|Saera Banu Munni
Sampada Sahasrabudhe|Sampada Sahasrabudhe
Sanyam Shukla|Sanyam Shukla
Sapna Prabhu|Sapna Prabhu
Shamima Sultana Mita|Shamima Sultana Mita
Sheem Sandooyea|Sheem Sandooyea
Silvia Barragan|Silvia Barragan
Smids|Smids
Sofie Merciny|Sofie Merciny
Sofie Robbrecht|Sofie Robbrecht
Sonia Yee|Sonia Yee
Stefaan de Rycke|Stefaan de Rycke
Steffie Daemen|Steffie Daemen
Stephanie Spicer|Stephanie Spicer
Stephen Lobb|Stephen Lobb
Sven Van Delsen|Sven Van Delsen
Svetlana Petrova|Svetlana Petrova
Tania Aboobakar|Tania Aboobakar
Tanja Spahr|Tanja Spahr
Teh Chong Chen|Teh Chong Chen
Thomas Arnalsteen|Thomas Arnalsteen
Tuvshinjargal Erdenebat|Tuvshinjargal Erdenebat
Uschi Neumann|Uschi Neumann
Valeria Montero|Valeria Montero
Valerie Descamps|Valerie Descamps
Valeriya Mushtakova|Valeriya Mushtakova
Vitali Ziazulia|Vitali Ziazulia
Wahid Thakiyudheen|Wahid Thakiyudheen
Yara Azad|Yara Azad
Ye Min Aung|Ye Min Aung
Sergey Nevgen|Siarhiej Niaŭhień
Shreyanshi Pardeshi|Shreyanshi Pardeshi
Thanyasuda Wongya|Thanyasuda Wongya
Chen Shiau-Cheng|Chen Shiau-Cheng
Mekonen Gebrelu|Mekonen Gebrelu
Yusuke Onodera|Yusuke Onodera
Ayelech Yakob|Ayelech Yakob
Prashant Goswami|প্ৰশান্ত গোস্বামী
Pablo Pintado|Pablo Pintado
Amrita Gogoi|অমৃতা গগৈ
Karimul Haque|কৰিমুল হক
Alankrita Shrivastava|অলংকৃতা শ্ৰীবাস্তৱ
Manoranjan Lahari|মনোৰঞ্জন লাহৰী
|নলিনী বৰুৱা
Nadir Alvarez|Nadir Alvarez
Frank Hauenschild|Frank Hauenschild
Prabhavathi Devi Saraswathi|প্ৰভাৱতী দেৱী সৰস্বতী
Harnaam Kaur|হৰনাম কৌৰ
Madhuri Chattopadhyay|মাধুৰী চট্টোপাধ্যায়
Binalakshmi Nepram|বিনালক্ষ্মী নেপ্ৰাম
Seema Bhatnagar|সীমা ভাটনাগৰ
Aimee Baruah|আইমী বৰুৱা
Sara Ali Khan|ছাৰা আলী খান
Rudra Kandali|ৰুদ্ৰ কন্দলী
Sylvia Hoffman|Sylvia Hoffman
Arundhati Katju|অৰুন্ধতী কাট্‌জু
|যাদুৰাম ডেকা বৰুৱা
Mayur Bora|ময়ূৰ বৰা
Meenakshi Srinivasan|মিনাক্ষী শ্ৰীনিবাসন
CarryMinati|অজয় নাগৰ
Jatin Mipun|যতিন মিপুন
Ridhima Pandey|ৰিধিমা পাণ্ডে
Nalin Duwara|নলিন দুৱৰা
Bhringeswar Sarma|ভৃংগেশ্বৰ শৰ্মা
Haliram Mahanta Thakur|হলিৰাম মহন্ত ঠাকুৰ
Kushal Konwar Sarma|কুশল কোঁৱৰ শৰ্মা
Liam Christie|Liam Christie
Keaan Van Venrooij|Keaan Van Venrooij
Altaf Mazid|আলতাফ মজিদ
Jayanta Kumar Sarma|জয়ন্ত কুমাৰ শৰ্মা
Cristina Michelle Mata Pitti|Cristina Michelle Mata Pitti
Nikola Levkov|Nikola Levkov
Virag Buzsaki|Virag Buzsaki
Jennifer Manefield|Jennifer Manefield
Caroline Payot-Podevin|Caroline Payot-Podevin
Rhonda Quick|Rhonda Quick
Letizia Giardinelli|Letizia Giardinelli
Valentina Poli|Valentina Poli
Maya Escolar|Maya Escolar
Simone Trafelet|Simone Trafelet
Tara Mulder|Tara Mulder
Cindy Bauwens|Cindy Bauwens
Gitana Gruodyte|Gitana Gruodyte
Ruth Ellway|Ruth Ellway
Moira Tarraran|Moira Tarraran
Carolyn Maxwell|Carolyn Maxwell
Nidumolu Sumathi|নিদুমোলু সুমথি
Yamin Hazarika|য়ামিন হাজৰিকা
Juri Gatt|Juri Gatt
Ionuț Șișcanu|Ionuț Șișcanu
Natalia Jamróz|Natalia Jamróz
Sebastian Mitterer|Sebastian Mitterer
Phil Harres|Phil Harres
Jannis Maul|Jannis Maul
Barack Obama|বাৰাক অ'বামা
Napoleon|নেপোলিয়ন
Louis Pasteur|লুই পেষ্ট'ৰ
Jawaharlal Nehru|জৱাহৰলাল নেহৰু
Michael Jackson|মাইকেল জেকচন
Confucius|কনফুচিয়াছ
Le Corbusier|লী ক'ৰবাজিয়ে
Bill Gates|বিল গেটছ
Francisco Goya|ফ্ৰান্সিছক' গয়া
Gabriel García Márquez|গাব্ৰিয়েল গাৰ্ছিয়া মাৰ্কেছ
Mark Twain|মাৰ্ক টোৱেইন
Henry Ford|হেনৰী ফৰ্ড
Johannes Kepler|জহান্স কেপলাৰ
Adam Smith|এডাম স্মিথ
Freddie Ljungberg|ফ্ৰেড্ৰিক জাংবাৰ্গ
Maxim Gorki|মেক্সিম গৰ্কী
Ernest Hemingway|আৰ্ণেষ্ট হেমিঙৱে
Andrew Garfield|এণ্ড্ৰিউ গাৰফিল্ড
Abdus Salam|আব্দুছ ছালাম
Rituparno Ghosh|ঋতুপৰ্ণ ঘোষ
Benazir Bhutto|বেনাজিৰ ভুট্টো
Friedrich Engels|ফ্ৰিড্ৰিখ এংগেল্স
Chetan Bhagat|চেতন ভগত
Aishwarya Rai|ঐশ্বৰ্যা ৰায়
J. J. Thomson|জোছেফ জন টমছন
Paul Dirac|পল ডিৰাক
Pratibha Patil|প্ৰতিভা পাটিল
Prachi Desai|প্ৰাচী দেশাই
Ferdinand Lassall|ফাৰ্ডিনাণ্ড লাচালে
Friedlieb Ferdinand Runge|ফ্রেণ্ডলিব ফাৰ্ডিনাণ্ড ৰংগ
John Keats|জন কীটছ
Srinivasa Ramanujan|শ্ৰীনিবাস ৰামানুজন
Ravi Shankar|ৰবি শংকৰ
Didier Queloz|ডিডিয়াৰ কুয়েলজ
Lev Landau|লে'ভ লাণ্ডাউ
Amrita Sher-Gil|অমৃতা শ্বেৰগিল
Manna Dey|মান্না দে
Juhi Chawla|জুহি চাওলা
Sonia Gandhi|ছোনিয়া গান্ধী
Valentino Rossi|ভেলেণ্টিন’ ৰ’ছি
Ashraf Ghani Ahmadzai|আশ্ৰফ ঘানী
Adi Shankara|আদি শংকৰ
Ramdas Gandhi|ৰামদাস গান্ধী
Abhishek Bachchan|অভিষেক বচ্চন
Panini|পাণিনি
Taslima Nasrin|তছলিমা নাছৰিন
Morarji Desai|মোৰাৰজী দেশাই
Arunachalam Muruganantham|অৰুণাচলম মুৰুগানান্থম
P. V. Narasimha Rao|পি ভি নৰসিংহ ৰাও
Ramdev|ৰামদেৱ
Deepa Mehta|দীপা মেহতা
Bal Gangadhar Tilak|বাল গঙ্গাধৰ তিলক
Anil Kapoor|অনিল কাপুৰ
Elon Musk|ইলন মাস্ক্
Abraham Kovoor|আব্ৰাহাম থ'মাছ কুভুৰ
James Hadley Chase|জেমছ হেডলি ছেজ
Vikram Seth|বিক্ৰম শেঠ
Bhama Srinivasan|ভামা শ্ৰীনিবাসন
Annie Besant|এনী বেছান্ট
Jaya Bachchan|জয়া বচ্চন
Lakshmi Sahgal|লক্ষ্মী সেহগল
Parveen Babi|পাৰৱীন বাবী
Helen|হেলেন
Karanam Malleswari|কৰ্ণম মালেশ্বৰী
Rama Dasgupta|সুচিত্ৰা সেন
Rahul Dravid|ৰাহুল দ্ৰাবিড়
Bachendri Pal|বাচেন্দ্ৰী পাল
Kumaraswami Kamaraj|কুমাৰ স্বামী কামৰাজ নাদাৰ
Sourav Ganguly|সৌৰভ গাঙ্গুলি
Vijay Kumar|বিজয় কুমাৰ
Ernst Stojaspal|Ernst Stojaspal
Ataur Rahman Khan|আতাউর রহমান খান
Varāhamihira|বৰাহমিহিৰ
John B. Goodenough|জন বেনিষ্টাৰ গুডএনাফ
Gorakhnath|গোৰক্ষনাথ
Ganapati Varman|গণপতি বৰ্মা
Mahendra Varman|মহেন্দ্ৰ বৰ্মা
Sthita Varman|স্থিত বৰ্মা
Prabhu Deva|প্ৰভু দেবা
Divyanka Tripathi|দিৱ্যঙ্কা ত্ৰিপাঠী
Sunenphaa|প্ৰমত্ত সিংহ
Gregg L. Semenza|গ্ৰেগ লিয়নাৰ্ড চেমেনজা
Hiteswar Saikia|হিতেশ্বৰ শইকীয়া
Sushma Swaraj|সুষমা স্বৰাজ
Thomas Stavngaard|Thomas Stavngaard
Yogeshwar Dutt|যোগেশ্বৰ দত্ত
Lin Jiancheng|Lin Jiancheng
M. S. Narasimhan|এম. এছ. নৰসিংহন
Janaki Ballav Patnaik|জানকী বল্লভ পাটনায়ক
Małgorzata Kurdelska|Małgorzata Janiaczyk
Mike Brown|Michael Brown
Najma Heptulla|নাজমা হেপতুল্লা
Soumitra Chatterjee|সৌমিত্ৰ চেটাৰ্জী
Bhabendra Nath Saikia|ভবেন্দ্ৰ নাথ শইকীয়া
Durvasa|দুৰ্বাসা
Sun Zhian|Sun Chin An
Udham Singh|উধাম সিং
Koke|ক'কে
Amrita Singh|অমৃতা সিং
Zerifa Wahid|জেৰিফা ৱাহিদ
Romila Thapar|ৰমিলা থাপাৰ
Raghuveer Chaudhari|ৰঘুবীৰ চৌধাৰী
Arthur Guyton|আৰ্থাৰ গাইটন
Ram Kinker Baij|ৰামকিঙ্কৰ বেইজ
Ashapoorna Devi|আশাপূৰ্ণা দেৱী
Juan de Arespacochaga|Juan de Arespacochaga
Bala|বালা
Sundar Pichai|সুন্দৰ পিচাই
R. K. Laxman|আৰ কে লক্ষ্মণ
Ramya Krishnan|ৰামায়া কৃষ্ণন
Anand Kumar|আনন্দ কুমাৰ
Vishal|বিশাল কৃষ্ণ
Suraiya|সুৰাইয়া
Bhalchandra Nemade|ভালচন্দ্ৰ নেমাডে
Deendayal Upadhyaya|দীনদয়াল উপাধ্যায়
Sarat Chandra Sinha|শৰৎ চন্দ্ৰ সিংহ
Elīza Tīruma|Elīza Tīruma
Anna Mani|আন্না মণি
Akhil Gogoi|অখিল গগৈ
Akkitham Achuthan Namboothiri|অক্কিতম অচ্যুতম নম্বুথিৰী
Amar Singh|অমৰ সিং
Amit Chakma|অমিত চাকমা
Anita Ratnam|অনিতা ৰত্নম
Anjali Gupta|অঞ্জলি গুপ্তা
Arati Saha|আৰতি সাহা
S. I. Padmavati|এছ. আই. পদ্মাৱতী
Asif Kottayil|আচিফ কত্তায়িল
Bebe Nanaki|বেবে নানকী
Mukundakam Sharma|মুকুন্দকাম শৰ্মা
Devendra Jhajharia|দেৱেন্দ্ৰ ঝাঝাৰীয়া
Dhrubajyoti Bora|ধ্ৰুৱজ্যোতি বৰা
Dipak Misra|দীপক মিশ্ৰ
Gita Gopinath|গীতা গোপীনাথ
Hansa Jivraj Mehta|হংসা জীৱৰাজ মেহতা
Harishankar Brahma|হৰিশংকৰ ব্ৰহ্ম
Kabindra Purkayastha|কবীন্দ্ৰ পুৰকায়স্থ
Kalanidhi Narayanan|কলানিধি নাৰায়ণন
Kamal Ranadive|কমল ৰণদিৱে
Krishna Kanta Handique|কৃষ্ণকান্ত সন্দিকৈ
Kumudini Lakhia|কুমুদিনী লাখিয়া
Lalit Kumar Doley|ললিত কুমাৰ দলে
Lalrindika Ralte|লাল্ৰিণ্ডিকা ৰাল্টেল
Leila Seth|লীলা শেঠ
Maniram Dewan|মণিৰাম দেৱান
Meena Rana|মীনা ৰাণা
Moirangthem Maniram Singha|মৈৰঙঠম মণিৰাম সিংহ
Moni Kumar Subba|মণি কুমাৰ চুব্বা
Monisha|মনিষা উন্নি
Nalini Bala Devi|নলিনীবালা দেৱী
Nambi Narayanan|নাম্বি নাৰায়ণন
Om Birla|ঔম বিৰলা
Pitambar Deva Goswami|পীতাম্বৰ দেৱগোস্বামী
Rajkumari Dubey|ৰাজকুমাৰী ডুবে
Ravish Kumar|ৰবীশ কুমাৰ
Roshan Ara Begum|ৰোচন আৰা বেগম
Sandhya Mukhopadhyay|সন্ধ্যা মুখাৰ্জী
Sarbananda Sonowal|সৰ্বানন্দ সোণোৱাল
Seiminlen Doungel|চেমিনলেন দংগেল
Sindhutai Sapkal|সিন্ধুতাঈ সপকাল
Subhash Singh|চিংগম চুভাচ চিং
Sudingphaa|চুদিংফা
Sunil Kothari|সুনীল কোঠাৰী
Suphakphaa|চুফক্‌ফা
Supimphaa|চুপিম্‌ফা
Suremphaa|চুৰেম্‌ফা
T.A. Sarasvati Amma|টি.এ. সৰস্বতী আম্মা
Tabu Taid|টাবু টাইড
Tarali Sarma|তৰালি শৰ্মা
Temsula Ao|টেমচুলা আও
Tikendrajit|টিকেন্দ্ৰজিৎ
Tyao Khamti|ত্যাও খাম্‌টি
Wajid Khan|ৱাজিদ খান
Utpal Kumar Basu|উৎপলকুমাৰ বসু
Jogesh Das|যোগেশ দাস
Rajanikanta Bordoloi|ৰজনীকান্ত বৰদলৈ
Achyut Lahkar|অচ্যুত লহকৰ
Amrit Bhushan Dev Adhikari|অমৃতভূষণ দেৱ অধিকাৰী
Mafizuddin Ahmed Hazarika|মফিজুদ্দিন আহমদ হাজৰিকা
Moghai Ojah|মঘাই ওজা
Nripen Goswami|নৃপেন গোস্বামী
Srubabati Goswami|শ্ৰুবৱতী গোস্বামী
Rakhi Birla|ৰাখী বিৰলা
Sultana|চুলতানা (অভিনেত্ৰী)
Minati Mishra|মিনতি মিশ্ৰ
Pedrito Martinez|Pedrito Martínez
Jamuna Barua|যমুনা বৰুৱা
Jupitora Bhuyan|জুপিতৰা ভুঞা
Pinaki Chandra Ghose|পিনাকী চন্দ্ৰ ঘোষ
Harsimrat Kaur Badal|হৰচিমৰত কৌৰ বাদল
Bidya Devi Bhandari|বিদ্যা দেৱী ভাণ্ডাৰী
Fatima Sana Shaikh|ফাটিমা ছানা শ্বেইখ
Kadambari Devi|কাদম্বৰী দেৱী
Divya Khosla Kumar|দিব্যা খোসলা কুমাৰ
Vidita Vaidya|বিদিতা অশোক বৈদ্য
Meenu Thakur|মিনু ঠাকুৰ
Rongbong Terang|ৰংবং তেৰাং
|চাৰু গোহাঁই
Mula Gabharu|মূলা গাভৰু
Atul Bordoloi|অতুল বৰদলৈ
Nishita Goswami|নিশিতা গোস্বামী
Pranjal Saikia|প্ৰাঞ্জল শইকীয়া
Ravi Sarma|ৰবি শৰ্মা
|সত্য প্ৰসাদ বৰুৱা
Ram Malik|ৰাম মালিক
Puravi Baramrudai|পূৰবী বৰমুদৈ
Medini Sharma|মেদিনী চৌধুৰী
Lalita Babar|ললিতা বাবৰ
Ajit Iqbal Singh|অজিৎ ইকবাল সিং
Alen Deory|এলেন দেউৰী
Reeta Devi|ৰীতা দেৱী
Aparna Dixit|অপৰ্ণা দীক্ষিত
Rupi Kaur|ৰুপি কৌৰ
Indra Bania|ইন্দ্ৰ বণিয়া
|আৰিমত্ত
Dwiban Baruah|দ্বিবন বৰুৱা
|ষ্টেন বৰুৱা
Amalendu Guha|অমলেন্দু গুহ
Prince Narula|প্ৰিঞ্চ নাৰুলা
Nikola Tvrtković|Nikola Tvrtković
Preeti Barua|প্ৰীতি বৰুৱা
John Berry White|জন বেৰী হোৱাইট
Krishna Das|কৃষ্ণ দাস
Jitendra Nath Goswami|জিতেন্দ্ৰনাথ গোস্বামী
|হৰিপ্ৰসাদ বৰুৱা
Kalamandalam Girija|কালামান্দালাম গিৰিজা
Nadia Murad Basee|নাদিয়া মুৰাদ
Janhvi Kapoor|জাহ্নৱী কাপুৰ
Ameena Ahmad Ahuja|আমিনা আহমেদ আহুজা
Omeo Kumar Das|অমিয় কুমাৰ দাস
José María Mendoza Ussía|José María Mendoza Ussía
Uma Dogra|উমা ডগ্ৰা
Anindita Paul|অনিন্দিতা পাল
M. Sarada Menon|এম. সাৰদা মেনন
Peter Schuchert|Peter Schuchert
Shama Bhate|শামা ভাটে
Nandini Jumani|জুমণি নেওগ
|নীলপৱন বৰুৱা
Santanu Kausik Baruah|শান্তনু কৌশিক বৰুৱা
Sher Choudhury|শ্বেৰ চৌধুৰী
|উইলিয়াম ফ্ৰেডেৰিক ছুডমাৰ্ছন
Bhabaprasad Chaliha|ভৱপ্ৰসাদ চলিহা
|অশোক শইকীয়া
|ৰঞ্জনা শৰ্মা বৰদলৈ
|ৰুণু দেৱী
Bidyut Chakrabarty|বিদ্যুৎ চক্ৰৱৰ্তী
|মহানন্দ শৰ্মা
Kameshwar Brahma|কামেশ্বৰ ব্ৰহ্ম
Neena Gupta|নীনা গুপ্তা (গণিতজ্ঞ)
Anima Choudhury|অনিমা চৌধুৰী
Jiří Král|Kral
Fabien Kaddour|Fabian Kaddour
Ajoy Kumar Dutta|অজয় কুমাৰ দত্ত
Wolfgang Siedler|Wolfgang Siedler
Paweł Wasilewski|Paweł Wasilewski
Anna Wolska|Anna Wolska
Bogumiła Chodownik|Bogumiła Chodownik
Teresa Łuczak|Teresa Łuczak
Paweł Marks|Paweł Marks
Jacek Mrozowski|Jacek Mrozowski
Barbara Zimna|Barbara Zimna
Andrzej Kołodyński|Andrzej Kołodyński
Radosław Tukendorf|Radosław Tukendorf
Kamil Raszkiewicz|Kamil Raszkiewicz
Klaudia Rogalska|Klaudia Rogalska
Weronika Grudzina|Weronika Grudzina
Anna Grabowska|Anna Grabowska
Sylwia Wiechowska|Sylwia Wiechowska
Artur Zbroński|Artur Zbroński
Bożena Matusik|Bożena Matusik
Edyta Tarasewicz|Edyta Tarasewicz
Anna Belicka|Anna Belicka
Lachat|Lachat
Adrian Marquez|Adrian Marquez
Anastasiia Kurdyukova|Anastasiia Kurdyukova
Anna Lundin|Anna Lundin
Anne Svarstad|Anne Svarstad
Anne-Marie Palmén|Anne-Marie Palmén
Aurélie Allet|Aurélie Allet
Benjamin Gunnarstein|Benjamin Gunnarstein
Bongani von Bodenstein|Bongani von Bodenstein
Carl Johan Godenhjelm|Carl Johan Godenhjelm
Christian Larsen|Christian Larsen
Corina Herrle|Corina Herrle
David Leal|David Leal
Francisco Santos|Francisco Santos
Gerd Rønne|Gerd Langholen
Hans Christian Seeberg|Hans Christian Seeberg
Hjalmar Lystad|Hjalmar Lystad
Irshad Ahmed|Irshad Ahmed
Jesper Toftlund|Jesper Toftlund
Kaj Österberg|Kaj Österberg
Kenshin Shimabukuro|Kenshin Shimabukuro
Kim Ga-eun|Kim Ga-eun
Kimihiro Yamaguchi|Kimihiro Yamaguchi
Larissa Beljutina|Larissa Beljutina
Leonardo Isa|Leonardo Isa
Lynne Scutt|Lynne Scutt
Magali Bravo|Magali Bravo
Maria Jesús Rodríguez|Maria Jesús Rodríguez
Mary Leeves|Mary Leeves
Mary Tan|Mary Tan
Natchpapha Chatupornkarnchana|Natchpapha Chatupornkarnchana
Patrik Isaksson|Patrik Isaksson
Paw Eriksen|Paw Eriksen
Preben Boesen|Preben Boesen
Rafael Fernández|Rafael Fernández
Raymond Bayot|Raymond Bayot
Reidar Engebretsen|Reidar Engebretsen
Roar Kaupang|Roar Kaupang
Rolf Aurin|Rolf Aurin
Thore Næss|Thore Næss
Ulrik Bo Hansen|Ulrik Bo Hansen
A. Dzyuba|A. Dzyuba
Adulrach Namkul|Adulrach Namkul
Anastasia Kudinova|Anastasia Kudinova
Andrew Haliday|Andrew Haliday
Andy Wood|Andy Wood
Angelica Wiratama|Angelica Wiratama
Blai Ramírez|Blai Ramirez
Brent Munday|Brent Munday
Carmen Lopez|Carmen Lopez
Céline Dagelet|Céline Dagelet
Cherie Chow|Cherie Chow
D. J. Kirby|D. J. Kirby
Daniel Yin-Hai Lee|Daniel Yin-Hai Lee
Daniella Oei|Daniella Oei
David Hong|David Hong
Diego Subauste Tokumura|Diego Subauste Tokumura
Ethan Haggo|Ethan Haggo
Eva María Peralvarez|Eva María Peralvarez
Eva Murio|Eva Murio
Eva Ratanasena|Eva Ratanasena
Fabien Jacob|Fabien Jacob
Frederik Lindquist|Frederik Lindquist
Freja Ravn|Freja Ravn
Gil Martins|Gil Martins
Helene Håkonsen Søgaard|Helene Håkonsen Søgaard
Iiro Nokkala|Iiro Nokkala
Ingrid Bergersen|Ingrid Bergersen
Israel Gutiérrez|Israel Gutiérrez
Ivan Baboshin|Ivan Baboshin
J. Pineda|J. Pineda
Jeremias Cortez|Jeremias Cortez
José Nascimento|José Nascimento
Julia Schmidt|Julia Schmidt
Kaitlyn McLeod|Kaitlyn McLeod
Keith Arthur|Keith Arthur
Koki Watanabe|Koki Watanabe
Kounal Soubbaroyan|Kounal Soubbaroyan
Lesley Paine|Lesley Paine
Liao Chun-Yi|Liao Chun-Yi
Pit Seng Low|Low Pit Seng
Lu Feng-Chieh|Lu Feng-Chieh
Lubov Fedotova|Lubov Fedotova
Maija Krzywacki|Maija Krzywacki
Markus Leijonberg|Markus Leijonberg
Mats Svensson|Mats Svensson
Mette Justesen|Mette Justesen
Miguel Serrano|Miguel Serrano
Mikael Lundquist|Mikael Lunqvist
Natalia Rogova|Natalia Rogova
Neeloufar Ahmed|Neeloufar Ahmed
Nikolay Afanasev|Nikolay Afanasev
Noelia Córdoba|Noelia Córdoba
Oliver Bush|Oliver Bush
Paula López|Paula Lopez
Percy Leví|Percy Leví
Pernilla Carlsson|Pernilla Carlsson
Petri Hautala|Petri Hautala
Ren Xiangyu|Ren Xiangyu
Roger Mistri|Roger Mistri
S. Lebedev|S. Lebedev
Syed Shabbar Hussain|Syed Shabbar Hussain
T. Gordijenko|T. Gordijenko
Tang Huaidong|Tang Huaidong
Tanguy Citron|Tanguy Citron
Timothy Lam|Timothy Lam
Trevor Woods|Trevor Woods
Willani Setiawati|Willani Setiawati
Ye Binghong|Ye Binghong
Natalia Romero|Natalia Romero
Ángela Ordóñez|Ángela Ordóñez
Magly Villamizar Ordoñez|Magly Villamizar Ordoñez
Maryi Ordoñez Cabrera|Maryi Ordoñez Cabrera
Adham Hatem Elgamal|Adham Hatem Elgamal
Agnes Frattinger|Agnes Frattinger
Aimi Sakamoto|Aimi Sakamoto
Alejandro Meyer|Alejandro Meyer
Alisa Sapniti|Alisa Sapniti
Anabell Fenkart|Anabell Fenkart
Andre Rhonnie|Andre Rhonnie
Andrea Schribertschnig|Andrea Schribertschnig
Andrew Susanto|Andrew Susanto
Anni Ninaus|Anni Ninaus
Arman Vardanyan|Arman Vardanyan
Armen Arakelyan|Armen Arakelyan
B. Tan|B. Tan
Barbara Malz|Barbara Malz
Benjamin Ploberger|Benjamin Ploberger
Bettina Unterleitner|Bettina Unterleitner
Brigitte Hlinka|Brigitte Hlinka
Brünner|Brünner
Bryan Tang|Bryan Tang
Cecilia García Reid|Cecilia García Reid
Christa Rainer|Christa Rainer
Christa Schlögl|Christa Schlögl
Christian Hartner|Christian Hartner
Christina Baldauf|Christina Baldauf
Croydon Rutherford|Croydon Rutherford
Daniel Gönitzer|Daniel Gönitzer
Daniela Adamec|Daniela Adamec
David Jones|David Jones
Dean Potgieter|Dean Potgieter
Diana Minasyan|Diana Minasyan
Doris Reisinger|Doris Reisinger
E. Crowe|E. Crowe
Eddie Hung|Eddie Hung
Ederer|Ederer
Elena Nikitina|Elena Nikitina
Ester Mirzakhanyan|Ester Mirzakhanyan
F. M. Donohue|F. M. Donohue
Facundo Fernandez|Facundo Fernandez
Farida Mostafa|Farida Mostafa
Fernanda Saponara|Fernanda Saponara
Ganbar Ragimov|Ganbar Ragimov
Graeme Nelson|Graeme Nelson
Grete Pessl|Grete Pessl
Harald Pirsch|Harald Pirsch
Heidi Slavik|Heidi Slavik
Helga Part|Helga Part
Helmut Streit|Helmut Streit
Jacob Thygesen|Jacob Thygesen
Jan Horton|Jan Horton
Jane Bass|Jane Bass
Jean Boucher|Jean Boucher
Joana Pili|Joana Pili
Jobett Hereli|Jobett Hereli
Karim Musayev|Karim Musayev
Karine Minasyan|Karine Minasyan
Kim Won-ho|Kim Won-ho
Lee Chee Leong|Lee Chee Leong
Leon Seiwald|Leon Seiwald
Leopold Dangl|Leopold Dangl
Li Ting-Yin|Li Ting-Yin
Liliana Semeguén|Liliana Semeguén
Luciano Colavitta|Luciano Colavitta
Maria Kribernegg|Maria Kribernegg
Melanie Bschaiden|Melanie Bschaiden
Micaela Castillo Salazar|Micaela Castillo Salazar
Michael Giel|Michael Giel
Michael Schausberger|Michael Schausberger
Michael Trojan|Michael Trojan
Michelle Gray|Michelle Gray
Mohamed Juma|Mohamed Juma
Mohamed Mostafa Kamel|Mohamed Mostafa Kamel
Morten Sandal|Morten Sandal
Muhammad Fachrikar|Muhammad Fachrikar
Narmina Tagiyeva|Narmina Tagiyeva
Nikolas Ferruzola|Nikolas Ferruzola
Ong Soo Kit|Ong Soo Kit
Philip Birker|Philip Birker
Rafael Witzmann|Rafael Witzmann
Rehan Khan|Rehan Khan
Renate Assanek|Renate Assanek
Rosa Tito Rigau|Rosa Tito Rigau
Rudolf Holzinger|Rudolf Holzinger
Ruzanna Hakobyan|Ruzanna Hakobyan
Serj Arakelyan|Serj Arakelyan
Sevinc Akhundova|Sevinc Akhundova
Spoorti Rattan|Spoorti Rattan
Stone|Stone
Susanne Neumeister|Susanne Neumeister
Syifa Fauziah|Syifa Fauziah
Teo Kok Seng|Teo Kok Seng
Toural Rasulov|Toural Rasulov
Turner|Turner
Vaqif Azizova|Vaqif Azizova
Walter Schreiber|Walter Schreiber
Wee Ung Hii|Wee Ung Hii
Wiebke Schrempf|Wiebke Schrempf
William Ponsonby|William Ponsonby
Yong Yudianto|Yong Yudianto
Yu Jin|Yu Jin
Zita Bánhegyi|Zita Bánhegyi
Kisona Selvaduray|Kisona Selvaduray
Horst Rosenstock|Horst Rosenstock
Abu Naser Azaz|Abu Naser Azaz
Adele MacDonald|Adele MacDonald
Afsana Ferdousy Runa|Afsana Ferdousy Runa
Alexander Antipov|Alexander Antipov
Amanda Andern|Amanda Andern
Anke Kübler|Anke Kübler
Annelie Tan|Annelie Tan
Anona Pak|Anona Pak
Aseda Khatun Ruma|Aseda Khatun Ruma
Austin Yu|Austin Yu
Brid Stepper|Brid Stepper
C. Ayling|C. Ayling
C. Leather|C. Leather
Carl Fenton|Carl Fenton
Carol Liem|Carol Liem
Carola Lanzinger|Carola Lanzinger
Chen Mui Kheng|Chen Mui Kheng
Claude Libois|Claude Libois
David Pohan|David Pohan
Dayanis Álvarez|Dayanis Álvarez
Dzmitry Saidakou|Dzmitry Saidakou
Eugenio González Arellano|E. Gonzalez Arellano
Ed Yablonski|Ed Yablonski
Eddeeza Saha|Eddeeza Saha
Eugenio Tapia|Eugenio Tapia
Faber|Faber
Felix Künzer|Felix Künzer
Foo Yoon Keang|Foo Yoon Keang
G. Longard|G. Longard
Ganchuluun Daribal|Ganchuluun Daribal
Gerald Sherwell|Gerald Sherwell
Gerelmaa Batchuluun|Gerelmaa Batchuluun
Grant Tyro|Grant Tyro
Guillermo Allier|Guillermo Allier
H. D. Reid|H. D. Reid
H. Nagesh|H. Nagesh
Hartmann|Hartmann
I. Ellett|I. Ellett
Imke van der Aar|Imke van der Aar
Ine De Clerck|Ine De Clerck
Iva Vrova Al-Katrib|Iva Vrova Al-Katrib
Jana Bühl|Jana Bühl
Jörg Dahlhaus|Jörg Dahlhaus
Jos Warmoes|Jos Warmoes
Julia Boiarovskaya|Julia Boiarovskaya
Julia Suchan|Julia Suchan
Kamasha Robertson|Kamasha Robertson
Karen Tam|Karen Tam
Karim|Karim
Katrina Jenner|Katrina Jenner
Katsiaryna Zablotskaya|Katsiaryna Zablotskaya
Kenny Young|Kenny Young
Lenaïc Luong|Lenaïc Luong
Leon Aabenhus|Leon Aabenhus
Lin Ah Shin|Lin Ah Shin
Linda Drossaert|Linda Drossaert
Lisa Deichgräber|Lisa Deichgräber
Lucas Bednorsch|Lucas Bednorsch
Luís Filipe|Luís Filipe
M. Islam|M. Islam
Mahmuda|Mahmuda
Marcel Stechert|Marcel Stechert
Margara Bravo Mariño|Margara Bravo Mariño
María Esther Luna Felix|María Esther Luna Felix
Marijn Put|Marijn Put
Mark Revis|Mark Revis
Michael Hauber|Michael Hauber
Michael Walz|Michael Walz
Mitul|Mitul
Mohammad Jakaria|Mohammad Jakaria
Monsur Ahmed Khan Penu|Monsur Ahmed Khan Penu
Munkherdene Damdinerevgii|Munkherdene Damdinerevgii
Muriel Edmondson|Muriel Edmondson
Narayn|Narayn
Nigel Skelt|Nigel Skelt
Nilima Das|Nilima Das
Norma Urlick|Norma Urlick
Oh Bo-kyung|Oh Bo-kyung
Oleg Gutarev|Oleg Gutarev
Orosameli Cabrera|Orosameli Cabrera
P. Remy|P. Remy
Park So-ri|Park So-ri
Patrick de Ruisseau|Patrick de Ruisseau
Peter van der Sijpt|Peter van der Sijpt
Philippe Gennaux|Philippe Gennaux
Pooja Shrestha|Pooja Shrestha
R. B. Emslie|R. B. Emslie
R. Ball|R. Ball
Ram C. Vijay|Ram C. Vijay
Ron H. Lewis|Ron H. Lewis
S. B. Basnyat|S. B. Basnyat
Sabiha|Sabiha
Sabina Panthi|Sabina Panthi
Sam Kumar Sarker|Sam Kumar Sarker
Sandra Sakaria|Sandra Sakaria
Shagdar Byambajav|Shagdar Byambajav
Sharon Diaz|Sharon Diaz
Sibu|Sibu
Siven Gooriah|Siven Gooriah
Stefanie Arns|Stefanie Arns
Stephaan de Rycke|Stephaan de Rycke
Stephanie van Wel|Stephanie van Wel
Sultan Arefin Badar|Sultan Arefin Badar
T. Brott|T. Brott
T. O'Gorman|T. O'Gorman
Tanja Eberl|Tanja Eberl
Marcel Bachmann|Marcel Bachmann
Tapan|Tapan
Thomas Spörrer|Thomas Spörrer
Timo Courage|Timo Courage
Tsolmon Munkhbat|Tsolmon Munkhbat
Vladzislav Naumav|Uladzislau Naumau
Ullash|Ullash
Karin van Dijck|Van Dyck
Roel van Heuckelom|Van Heuckelom
W. Breeze|W. Breeze
Wong Tat Meng|Wong Tat Meng
Yomaira Sánchez|Yomaira Sanchez Feliz
Yvonne Fox|Yvonne Fox
Jean Boulet|J. Boulet
Anitha Kuppusamy|অনিতা কুপ্পুস্বামী
B. R. Sankeerth|B. R. Sankeerth
Bobby Sarma Baruah|ববী শৰ্মা বৰুৱা
Kavita Kane|কবিতা কেইন
Anurag Saikia|অনুৰাগ শইকীয়া
José López Zanón|José López Zanón
Juan de Haro Piñar|Juan de Haro Piñar
Sobha Brahma|শোভা ব্ৰহ্ম
Heerendra Nath Dutt|হীৰেন্দ্ৰ নাথ দত্ত
|ৰজনীকান্ত দত্ত
Raag Oinitom|ৰাগ ঐনিতম
Shanno Devi|ছন্নো দেৱী
Giovanni Battista Tocci|Giovanni Battista Tocci
Mofida Ahmed|মফিদা আহমেদ
Gaston Lecreux|Gaston Lecreux
Jwngdao Bodosa|জাংদাও বডোচা
Hema Srinivasan|হেমা শ্ৰীনিবাসন
Aparna Higgins|অপৰ্ণা হিগিনছ্
Abiy Ahmed|আবি আহমেদ আলি
Moumita Dutta|মৌমিতা দত্ত
Meneses Monroy|Meneses Monroy
Katindra Swargiary|কাতিন্দ্ৰ স্বৰ্গীয়াৰী
|হিতেশ্বৰ বৰবৰুৱা
|পূৰ্ণিমা দেৱী বৰ্মন
Bhaskar Hazarika|ভাস্কৰ হাজৰিকা
A. Lalitha|এ ললিতা
Kamalananda Bhattacharya|কমলানন্দ ভট্টাচাৰ্য্য
Dipak Bhattacharjee|দীপক ভট্টাচাৰ্য
Licypriya Kangujam|লিচিপ্ৰিয়া কাংগুজাম
Manoj Kumar Das|মনোজ কুমাৰ দাস
Li Wenliang|লি ৱেনলিয়াং
Raghunath Das Mahanta|ৰঘুনাথ দাস মহন্ত
Minal Dakhave Bhosale|মিনাল দাখৱে ভোঁচলে
Dipika Deka|দীপিকা ডেকা
Banikona Ghoshal|বাণীকণা ঘোষাল
Kulada Kumar Bhattacharya|কুলদা কুমাৰ ভট্টাচাৰ্য
Dinanath Bezbarua|দীননাথ বেজবৰুৱা
Himanshu Prasad Das|হিমাংশু প্ৰসাদ দাস
Prafulla Dutta Goswami|প্ৰফুল্ল দত্ত গোস্বামী
Bihuram Boro|বিহুৰাম বড়ো
Amala Bezbaruah|অমলা বেজবৰুৱা
Dost Habibur Rahman|দোস্ত হবিবুৰ ৰহমান
Luciano Méndez|Luciano Méndez
Anowar Hussain|আনোৱাৰ হুছেইন
Gauri Barman|গৌৰী বৰ্মন
Alekss Krasts|Alekss Krasts
Panagiotis Christopoulos-Cheller|Panagiotis Christopoulos-Cheller
Anastasios Kourmpetis|Anastasios Kourmpetis
Neftali Martinez|Neftali Martinez
Raja Prithu|পৃথু
Julie Hutsebaut|Julie Hutsebaut
Marina Khodchenkova|Marina Khodchenkova
Clarissa Breuer|Clarissa Breuer
Pramod Boro|প্ৰমোদ বড়ো
Alena Popadova|Alena Popadova
Caroline Orens|Caroline Orens
Elisa Neri|Elisa Neri
Negringa Raudonite|Negringa Raudonite
Laurence Restoin|Laurence Restoin
Deborah Geentjens|Deborah Geentjens
Delphine Deschamps|Delphine Deschamps
Marie Kolarikova|Marie Kolarikova
Natascha Klewitz|Natascha Klewitz
Jozef Hušla|Jozef Hušla
Yar Lutuf Khan|য়াৰ লুতফুল খান
Priyanka Das Rajkakati|প্ৰিয়ংকা দাস ৰাজকাকতি
Krists Lindenblats|Krists Lindenblats
Jung Hyun-woo|Jung Hyun-woo
Apurba Kumar Saikia|অপূৰ্ব কুমাৰ শইকীয়া
Dominic Meinel|Dominic Meinel
