George Washington|જ્યોર્જ વૉશિંંગટન
Douglas Adams|ડગ્લાસ એડમ્સ
Plato|પ્લેટો
Narendra Modi|નરેન્દ્ર મોદી
Indira Gandhi|ઈન્દિરા ગાંધી
Jacques Chirac|જેક શિરાક
V. P. Kalairajan|વી. પી. ક્લાઈરાજન.
Marie Curie|મૅરી ક્યુરી
Archimedes|આર્કિમીડીઝ
Sima Qian|સિમા કીઆન
Muhammad|મુહમ્મદ
A. P. J. Abdul Kalam|અબ્દુલ કલામ
Salman Rashid Khan|સલમાન ખાન
Harivansh Rai Bachchan|હરિવંશરાય બચ્ચન
Lil Wayne|લિલ વેય્ન
Émile Durkheim|એમિલ દર્ખેમ
Vijaygupta Maurya|વિજયગુપ્ત મોર્ય
Bruce Lee|બ્રુસ લી
Edgar Allan Poe|એડગર ઍલન પો
Malala Yousafzai|મલાલા યુસુફઝઈ
Theodore Roosevelt|થિયોડોર રૂઝવેલ્ટ
Alexander Graham Bell|એલેક્ઝાન્ડર ગ્રેહામ બેલ
Alexander Fleming|એલેક્ઝાન્ડર ફ્લેમિંગ
Robert Koch|રોબર્ટ કોચ
Helen Keller|helen keller
Rudolf Mössbauer|રુડૉલ્ફ મોસબાઉઅર
Behramji Malabari|બહેરામજી મલબારી
Catherine Zeta-Jones|કેથરિન ઝેટા-જોન્સ
Arjan Bajwa|અરજણ બાજવા
Mehboob Khan|મહેબૂબ ખાન
Satish Alekar|સતિષ અલેકર
Shanta Shelke|શાંતા શેલકે
Tryambak Shankar Shejwalkar|ત્ર્યંબક શંકર શેજવલકર
Liam Neeson|લિયામ નિસન
Genelia D'Souza|જેનીલિયા ડિસોઝા દેશમુખ
Shripad Narayan Pendse|શ્રીપાદ નારાયણ પેન્ડસે
Elsa Einstein|એલ્સા આઇનસ્ટાઇન
Padamsinh Bajirao Patil|પદ્મસિંહ બાજીરાવ પાટીલ
John Milton|જોન મિલ્ટન
Harrison Ford|હેરિસન ફોર્ડ
Mirza Ghalib|મિર્ઝા ગાલિબ
Sammy Angott|સામી એંગોટ
Albert A. Michelson|આલ્બર્ટ અબ્રાહમ માઈકલસન
Bahadur Shah Zafar|બહાદુર શાહ ઝફર
Zulfiqar Ali Bhutto|ઝુલ્ફીકાર અલી ભુટ્ટો
Humphry Davy|હમ્ફ્રી ડેવી
Sania Mirza|સાનિયા મિર્ઝા
Nawaz Sharif|નવાઝ શરીફ
Danny Boyle|ડેની બોયલ
Mahasweta Devi|મહાશ્વેતા દેવી
Charles Lucien Bonaparte|ચાર્લ્સ લુસિઅન બોનાપાર્ટ
Kirron Kher|કિરણ ખેર
Aruna Irani|અરુણા ઈરાની
Bāṇabhaṭṭa|બાણભટ્ટ
Aishwarya R. Dhanush|ઐશ્વરીયા આર. ધનુષ
Satchidananda Saraswati|સ્વામી સચ્ચિદાનંદ
Ramakrishna|રામકૃષ્ણ પરમહંસ
Preity Zinta|પ્રીટિ ઝિન્ટા
Dido|ડિડો
Amir Khosrow|અમીર ખુશરો
Hariprasad Chaurasia|હરિપ્રસાદ ચૌરસિયા
John B. Watson|જે. બી. વોટસન
Bhimrao Ramji Ambedkar|બાબાસાહેબ આંબેડકર
Mumtaz Mahal|મુમતાઝ મહેલ
Madhuri Dixit|માધુરી દીક્ષિત
Atal Bihari Vajpayee|અટલ બિહારી વાજપેયી
Alex García|એલેક્સ ગાર્સિયા
Lal Bahadur Shastri|લાલ બહાદુર શાસ્ત્રી
Kasturba Gandhi|કસ્તુરબા
Joe Louis|જૉ લુઈસ
Vinayakan|વિનાયકન
Urvashi|ઉર્વશી
Dharamvir Bharati|ધર્મવીર ભારતી
Siddique|સીદ્દગી
Gaurishankar Udayshankar|ગૌરીશંકર ઉદયશંકર ઓઝા
Malaika Arora|મલાઈકા અરોરા
Napoleon Hill|નેપોલિયન હિલ
Fakhruddin Ali Ahmed|fakhruddin ali ahmed
Eddie Eagan|એડી ઇગન
Jamsetji Tata|જમશેદજી તાતા
Abhimanyu|અભિમન્યુ
Mills Lane|મિલ્સ લેન
Mary Kom|મેરી કોમ
Chazz Witherspoon|ચૅઝ વિઠેરસ્પુન
Matthew Saad Muhammad|મેથ્યુ સાદ મુહમ્મદ
Shruti Haasan|શ્રુતિ હાસન
Nazrul Islam|કાઝી નઝરૂલ ઇસ્લામ
Ram Swarup|રામ સ્વરૂપ
Jake LaMotta|જેક લામોટા
Mandakini|મંદાકિની
Motilal Nehru|મોતીલાલ નહેરૂ
Azim Premji|અઝીમ પ્રેમજી
Mangal Pandey|મંગલ પાંડે
Manvendra Singh Gohil|માનવેંદ્રસિંહ ગોહીલ
Ahmad Wali|અહમદ વલી
Ahmed Kathrada|અહમદ કથ્રાદા
Leela Majumdar|લીલા મજમુદાર
Robert F. Wagner|રોબર્ટ એફ. વેગ્નર
Nayantara Sahgal|નયનતારા સહગલ
Percy Spencer|percy l spencer
Surya Sen|સૂર્ય સેન
Mishkín-Qalam|મિશ્કીન કલમ
Saina Nehwal|સાયના નેહવાલ
Meena Kumari|મીના કુમારી
Mira Nair|મીરા નાયર
Mahadevi Varma|મહાદેવી વર્મા
Kiran Mazumdar-Shaw|કિરણ મઝુમદાર-શો
Vijay Amritraj|વિજય અમૃતરાજ
Asin|અસિન
Mohan Agashe|મોહન આગાશે
Seeta Devi|સીતા દેવી
Bina Rai|બીના રાય
Cleophis|ક્લિયોફિસ
Nur Jahan|નુર જહાં
Thakazhi Sivasankara Pillai|તકાજી શિવશંકર પલ્લઈ
M. F. Husain|એમ એફ હુસૈન
Jackie Shroff|જેકી શ્રોફ
Muhammad Zakariya Kandhalawi|મુહમ્મદ ઝકરિયા કાંધલવી
Johann Zoffany|જોહાન ઝોફની
Erick Avari|એરિક અવરી
Nandita Das|નંદિતા દાસ
Vijay Arora|વિજય અરોરા
Ashok Mehta|અશોક મહેતા
Pooja Bhatt|પૂજા ભટ્ટ
B. B. Nimbalkar|બી.બી. નીમાબલકાર
Abdul Patel|અબ્દુલ પટેલ
Sarah-Jane Dias|સારાહ-જેન ડાયસ
Chintamani Nagesa Ramachandra Rao|સી.એન.આર.રાવ
Kundan Lal Saigal|કુંદનલાલ સાયગલ
Shah Abdul Latif Bhittai|શાહ અબ્દુલ લતીફ ભીતાઈ
Girish Kasaravalli|ગિરિશ કાસરવલ્લી
Matsyendranath|મત્સ્યેન્દ્રનાથ
Yajnavalkya|યાજ્ઞવલ્કય
Sharad Malhotra|शरद मल्होत्रा
Vijaypat Singhania|વિજયપત સિંઘાનિયા
Ashfaqulla Khan|અશફાકઉલ્લા ખાન
Rohini Hattangadi|રોહિણી હટ્ટગદી
Vidhu Vinod Chopra|વિધુ વિનોદ ચોપરા
John Patrick O'Brien|જોન પી. ઓ'બ્રાયન
Ajay Pohankar|અજય પોહંકર
Sukumar Azhikode|સુકુમાર અઝીકોડે
Sugriva|સુગ્રીવ
Rohini Devi|રોહિણી
Raageshwari|રાગેશ્વરી
Megha|મેઘ
Sadhana Sargam|સાધના સરગમ
P. Susheela|પી. સુશીલા
Shweta Mohan|શ્વેતા મોહન
Mamta Mohandas|મમતા મોહનદાસ
Mohanlal|મોહનલાલ વિશ્વનથન નાયર
Biju Narayanan|બીજૂ નારાયણન
Suresh Peters|સુરેશ પેટર્સ
Anna Katharina Valayil|અન્ના કૈથરીના વલાઈલ
Nallari Kiran Kumar Reddy|નલ્લારી કિરણ કુમાર રેડ્ડી
Seth Low|સેઠ લો
Manoj Kumar|મનોજ કુમાર
Vallabha Acharya|વલ્લભાચાર્ય
Mukesh|મુકેશ
Nizam-ud-din Auliya|નિઝામુદ્દીન ઔલિયા
Tillotama Shome|ટિલોટામા શોમ
Tulsi Lahiri|તુલસી લાહિરી
Madhur Jaffrey|મધુર જાફરી
Santosh Sivan|સંતોષ સિવાન
Jhulelal|ઝૂલેલાલ
Anshuman Gaekwad|અંશુમાન ગાયકવાડ
Sandeep Patil|સંદિપ પાટિલ
Pannalal Patel|પન્નાલાલ પટેલ
Agnivesa|અગ્નિવેશ
Birsa Munda|બિરસા મુંડા
Atul Bedade|અતુલ બેદાડે
Ashok Patel|અશોક કુરજીભાઇ પટેલ
Anwarmiya Kaji|અનવરમિંયા કાજી
Anila Dalal|અનિલા દલાલ
Pandurang Shastri Athavale|પાંડુરંગ શાસ્ત્રી આઠવલે
Pranav Mistry|પ્રણવ મિસ્ત્રી
Ashwini Bhatt|અશ્વિની ભટ્ટ
Ashtavakra|અષ્ટાવક્ર
Hemachandra|હેમચંદ્રાચાર્ય
Narsinh Mehta|નરસિંહ મહેતા
Yuvraj Singh|સોલંકી યુવરાજસિંહ
Parthiv Patel|પાર્થિવ પટેલ
Falguni Pathak|ફાલ્ગુની પાઠક
Ichharam Desai|ઇચ્છારામ દેસાઈ
Hemant Chauhan|હેમંત ચૌહાણ
Kalapi|કલાપી
Kanhoji Angre|કાન્હોજી આંગ્રે
Krishnalal Shridharani|કૃષ્ણલાલ શ્રીધરાણી
Kekhusro Kabraji|કેખુશરો કાબરાજી
Gunvantrai Acharya|ગુણવંતરાય આચાર્ય
Chandrakant Mehta|ચંદ્રકાન્ત મહેતા
Chinu Modi|ચિનુ મોદી
Jayant Gadit|જયંત ગાડીત
Joseph Macwan|જોસેફ મેકવાન
|ડોંગરેજી મહારાજ
Dolarrai Mankad|ડોલરરાય માંકડ
|તુકારામ
Tribhuvandas Kishibhai Patel|ત્રિભુવનભાઇ કીશીભાઇ પટેલ
Deepakbhai P. Mehta|દીપકભાઇ પ્ર. મેહતા
Dhananjay Shah|ધનંજય શાહ
Dhirendra Mehta|ધીરેન્દ્ર મહેતા
|પીઠો ભગત
Pujalal Dalwadi|પૂજાલાલ દલવાડી
Pravin Darji|પ્રવીણ દરજી
Bajrangdas Bapa|બજરંગદાસબાપા
Manjari Desai|મંજરી દેસાઈ
Manilal H. Patel|મણિલાલ હ. પટેલ
Mansukhlal Jhaveri|મનસુખલાલ ઝવેરી
Krishnakumarasinh Bhavasinh Gohil|કૃષ્ણકુમારસિંહ ભાવસિંહ ગોહીલ
Mohanlal Dave|મોહનલાલ દવે
Raman Soni|રમણ સોની
Rajendra Shukla|રાજેન્દ્ર શુક્લ
|રૂસવા
|શહીદ વીર મેઘમાયો
|શિવકુમાર જોષી
Shripad Raghunath Joshi|શ્રીપાદ રઘુનાથ જોશી
|સર પ્રભાશંકર પટ્ટણી
Saif Palanpuri|સૈફ પાલનપુરી
Jhinabhai Desai|સ્નેહરશ્મિ
Hamirji Gohel|હમીરજી ગોહિલ
Harshadray Manibhai Trivedi|હર્ષદરાય ત્રિવેદી
Hemu Gadhavi|હેમુ ગઢવી
Anil Devgan|અનિલ દેવગણ
Carl Frederik von Breda|james watt
Ashok Dinda|અશોક ડિન્ડા
Justin Trudeau|જસ્ટિન ટ્રુડો
Paresh Rawal|પરેશ રાવલ
Sadhana Shivdasani|સાધના શિવદાસાની
Anisul Hoque|અનીસુલ હૉક્યુ
Nivedita Bhasin|નિવેદિતા ભસીન
Ashok Chavan|અશોક ચવ્હાણ
Shakti Chattopadhyay|શક્તિ ચટોપાધ્યાય
Achintya Kumar Sengupta|અચિંત્યકુમાર સેનગુપ્તા
Basudeb Dasgupta|બાસુદેબ દાસગુપ્તા
Rabindra Guha|રવીન્દ્ર ગુહા
Uday Shankar|ઉદય શંકર
Nagarjun|નાગાર્જુન
Saroj Khan|સરોજ ખાન
Nitin Gadkari|નિતિન ગડકરી
Rambha|રંભા
Praveen Kumar|પ્રવિણ કુમાર
S. Sreesanth|એસ.શ્રીસંત
Nana Joshi|નાના જોશી
Balu Mahendra|બાલુ મહેન્દ્ર
Sucheta Kripalani|સુચેતા કૃપલાની
Narendra Hirwani|નરેન્દ્ર હિરવાણી
Mirabehn|મીરાબેન
Saritha|સરિતા
Kakkanadan|કક્કનદાન
Sukumari|સુકુમારી
Nadhiya|નઢીયા
Tripuraneni Gopichand|ત્રિપુરાણેનિ ગોપીચંદ
Tshering Wangdu|તશેરિંગ વાંગડુ
Rakhi Sawant|રાખી સાવન્ત
Jiah Khan|જીયા ખાન
Irawati Karve|ઇરાવતી કર્વે
Saranya Mohan|સરણ્યા મોહન
Preeti Jhangiani|પ્રીતિ જહાંગિયાની
Vinaya Prasad|વિન્યા પ્રસાદ
Jamini Roy|જામીની રોય
Sri Lal Sukla|શ્રી લાલ સુકલા
Ali Sardar Jafri|અલી સરદાર જાફરી
Gopinath Kaviraj|ગોપીનાથ કવિરાજ
Kesarbai Kerkar|કેસરબાઈ કેરકર
Malika Pukhraj|મલિકા પુખરાજ
Krishna Sobti|કૃષ્ણા સોબતી
Satyadev Dubey|સત્યદેવ દુબે
Mogubai Kurdikar|મોગુબાઈ કુર્દીકર
Rajeev Srinivasan|રાજીવ શ્રીનિવાસન
Kapila Vatsyayan|કપિલા વાત્સ્યાયન
Nagaraja Rao Havaldar|નાગરાજા રાવ હવાલદાર
Dadu Dayal|દાદુ દયાલ
Shamshad Hussain|શમશાદ હુસૈન
Barkha Dutt|બરખા દત્ત
Santokh Singh Dhir|સંતોક સિંહ ધીર
Hasrat Mohani|હસરત મોહાની
Srinivasa Rao Srirangam|શ્રીનિવાસ રાવ શ્રીરંગમ
M. M. Keeravani|એમ. એમ. કીરવાની.
Srikanto Acharya|શ્રીકાંત આચાર્ય
Hard Kaur|હાર્ડ કૌર
Deepali Joshi-Shah|દીપાલી જોશી-શાહ
Godabarish Mishra|ગોદાવરિશ મિશ્ર
Ravindra Prabhat|રવીન્દ્ર પ્રભાત
Drashti Dhami|દ્રષ્ટિ ધામી
Santanu Kumar Acharya|શાંતનુકુમાર આચાર્ય
Guillermo Lasso|ગિલ્લેર્મો લાસો
Max Einhorn|મેક્સ આઈનહોર્ન
A. Colin McClung|એ. કોલિન મCક્લંગ
A. Maria Irudayam|એ. મારિયા ઇરૂદાયમ
Aari|આરી
Abbas Tyabji|અબ્બાસ તૈયબજી
Abbas Zaryab|અબ્બાસ ઝરિયાબ
Abhijit Mukherjee|અભિજીત મુખર્જી
Addison Bain|એડિસનબેન
Adin Falkoff|એડિન ફાલ્કોફ
Ali Shamsi Pasha|pasa jeil
Alia Bhatt|આલિયા ભટ્ટ
Alladi Ramakrishnan|અલાદી રામક્રિષ્નન
Alyque Padamsee|અલીક પદમશી
Amin Kamil|અમીન કામિલ
Amrapali Dubey|આમ્રપાલી દુબે
Anchal Sabharwal|આંચલ સબરવાલ
Angela Jonsson|એન્જેલા જોનસન
Anita Raj|અનિતા રાજ
Ankan Sen|અંકન સેન
Ankita Raina|અંકિતા રૈના
Arthur E. Bryson|આર્થર ઇ. બ્રાયસન
Arthur Emmons Raymond|આર્થર ઇમોન્સ રેમન્ડ
Arthur W. Murphy|આર્થર ડબલ્યુ. મર્ફી
Aswath Damodaran|અસ્વથ દામોદરન
B. Ravi Pillai|બી. રવિ પિલ્લાઈ
B. Sriramulu|બી૰ શ્રીરામુલુ
Badarayana|બાદરાયણ
Berthold Ribbentrop|બર્થોલ્ડ રિબેન્ટ્રોપ
Bhagwandas Patel|ભગવાનદાસ પટેલ
Bhimjee Parikh|ભીમજી પરીખ
Bhulabhai Desai|ભુલાભાઈ દેસાઈ
Bill Parkyn|બિલ પાર્કિન
Bir Bikram Kishore Debbarman|વીર વિક્રમ કિશોર
Bishnu Pada Ray|વિષ્ણુ પદ રાય
Chandrakant Raghunath Patil|સી આર પાટિલ
Chhabildas Mehta|છબીલદાસ મહેતા
Chitrabhanu|ચિત્રભાનુ
Christian Pike|ક્રિશ્ચિયન પાઇક
Dahyabhai Patel|ડાહ્યાભાઈ પટેલ
Damayanti Joshi|દમયંતી જોશી
Dana D. Nelson|ડાના ડી નેલ્સન
Daniel Callahan|ડેનિયલ કૈલહન
David Dalrymple|ડેવિડ ડાલ્રિમ્પલ
David Wilcock|ડેવિડ વિલકોક
Dewang Mehta|દેવાંગ મહેતા
Dilbagh Singh|દિલબાગસિંહ
Dinesh Kumar Mani|દિનેશકુમાર મણી
H. S. S. Lawrence|એચ. એસ. એસ. લોરેન્સ
Har Dayal|લાલા હરદયાળ
Harshal Pushkarna|હર્ષલ પુષ્કર્ણા
Rita Chowdhury|રીટા ચૌધરી
Ram Vilas Paswan|રામવિલાસ પાસવાન
Jayant Parmar|જયન્ત પરમાર
Jayanta Bandyopadhyay|જયંતા બંદ્યોપધ્યાય
Jayshreeben Patel|પટેલ જયશ્રીબેન કનુભાઈ
Jitendra Singh|જિતેન્દ્ર સિંહ
Jyoti Kirit Parikh|જ્યોતિ કિરીટ પરીખ
K. Kavitha|કલવાકુન્ટ્લ કવિતા
K. N. Ramchandran|કે૰એન૰ તિરુ રામચન્દ્રન
K. R. Srinivasa Iyengar|કે. આર. શ્રીનિવાસ અય્યંગર
Kamla Devi Patle|કમલા દેવી પટલે
Kristappa Nimmala|ક્રિસ્ટપ્પા નિમ્મલા
Kumar|કુમાર
Laxmi Narayan Tripathi|લક્ષ્મી નારાયણ ત્રિપાઠી
Ramakanta Rath|રમાકાન્ત રથ
Navdeep Singh|નવદીપ સિંઘ
M. K. Binodini Devi|એમ. કે. વિનોદિનીદેવી
M. Ramalingam|એમ. રામલિંગમ
M. Thambi Durai|એમ૰ તંબીદુરૈ
Madhavi Sardesai|માધવી સરદેસાઈ
Mahesh Dattani|મહેશ દત્તાણી
Malchand Tiwari|માલચંદ તિવારી
Manjit Tiwana|મનજીત ટિવાણા
Mansoor Amjad|મન્સૂર અમજદ
Manvendra Singh|માનવેન્દ્ર સિંહ
Marina Iqbal|મરિના ઇકબાલ
Mi. Pa. Somasundaram|પી. મા. સોમુસુંદરમ
Mohammad Akram|મોહમ્મદ અકરમ
Mina Swaminathan|મીના સ્વામિનાથન
Miran Bux|મિરન બક્સ
Mohamad Abdul Tayyab|મોહમદ અબ્દુલ તૈયબ
Mohammad Ansari|મોહમ્મદ અંસારી
Mohammad Irshad|મોહમ્મદ ઇર્શાદ
Mohammad Laeeq|મોહમ્મદ લઈક
Mohammad Naeem|મોહમ્મદ નઇમ
Mohammad Naeem|મોહમ્મદ નઇમ
Mohammad Naeem|મોહમ્મદ નઇમ
Mohammad Ramzan|મોહમ્મદ રમઝાન
Mohan Kundariya|મોહન કુન્દરિયા
Narayan Desai|નારાયણ દેસાઈ
Narendra Singh Tomar|નરેન્દ્ર સિંહ તોમર
Nilmani Phookan (Junior)|નિલમણી ફૂકન
Norman Anil Kumar Browne|નોર્મન અનિલકુમાર બ્રાઉને
Ponnusamy Venugopal|પી૰ વેણુગોપાલ
Pappu Yadav|પપ્પૂ યાદવ
Pashupati Nath Singh|પશુપતિનાથ સિંહ
Pervin Shroff|પરવીન શ્રોફ
Pooja Gaur|પુજા ગોર
Prabhudas Patwari|પ્રભુદાસ પટવારી
Raj Kaushal|રાજ કૌશલ
Ramesh Oza|રમેશભાઈ ઓઝા
Rangasami L. Kashyap|રંગસામી એલ. કશ્યપ
Ranjitram Mehta|રણજિતરામ મહેતા
Rashmi Bansal|રશ્મિ બંસલ
Richa Chadha|રિચા ચઢ્ઢા
Yamini Krishnamurthy|યામીની કૃષ્ણમૂર્તિ
S. K. Shivakumar|શિવકુમાર એસ. કે
Sandipani|સાંદીપનિ
Sanjay Shamrao Dhotre|સંજય શામરાવ ધોત્રે
Satheesha Rai|સતીષા રાય
Sharan Rani Backliwal|શરણ રાની માથુર
Sona Ram|કર્નલ સોનારામ
Sooni Taraporevala|સુની તારાપોરવાલા
Sudarshan Bhagat|સુદર્શન ભગત
Sunil Kumar Ahuja|સુનિલકુમાર આહુજા
Tarla Dalal|તરલા દલાલ
Tathagata Satapathy|તથાગત સત્પથી
Thangso Baite|થાંગસો બાઇતે
Thokchom Meinya|ડૉ થોકચોમ મેઇન્યા
Uday Kotak|ઉદય કોટક
Udit Raj|ઉદિત રાજ
Veeru Devgan|વીરુ દેવગણ
Harita Kaur Deol|હરિતા કૌર દેઓલ
Anna Torvalds|અન્ના ટોરવાલ્ડ્સ
Chandraghanta|ચન્દ્રઘંટા
Jayakrishna Indraji|જયકૃષ્ણ ઇન્દ્રજી ઠાકર
P. C. Mohan|પી૰સી૰ મોહન
Ponty Chadha|પોન્ટી ચઢ્ઢા
Suhasini Ganguly|સુહાસિની ગાંગુલી
Anandshankar Dhruva|આનંદશંકર ધ્રુવ
Unnava Lakshmi Narayana|ઉન્નવ લક્ષ્મી નારાયણ
Dhan Singh Thapa|ધન સિંઘ થાપા
Jagat Singh|જગતસિંઘજી મહારાજ
Shameem Dev Azad|શમીમ દેવ આઝાદ
A. T. Patil|અશોક તાપીરામ પાટિલ
Chandralekha|ચંદ્રલેખા
Minnie M. Mathan|મીની એમ. માથન
Aruna Dhathathreyan|અરુણા ધથથ્રેયણ
Ranjana Desai|રંજના પ્રકાશ દેસાઈ
Rama Devi|રમા દેવી
Cuckoo Moray|કૂકકૂ  મોરેય
Homi Mody|homi mody
Ratilal Chandaria|રતિલાલ ચંદરયા
Anasuya Sarabhai|અનસુયા સારાભાઈ
Kirit Premjibhai Solanki|કિરીટ પ્રેમજીભાઈ સોલંકી
Ram Shankar Katheria|રામ શંકર
Vicky Batra|વિકી બત્રા
Nikhat Zareen|નિખત ઝરીન
Shivam Patil|શિવમ પાટિલ
Laxman Giluwa|લક્ષ્મણ ગિલુવા
Chintaman Vanaga|ચિંતામન વનગા
G. Nagesh|જી૰ નાગેશ
Neha Mehta|નેહા મેહતા
Upendra Kushwaha|ઉપેન્દ્ર કુશવાહા
Narendra Keshav Sawaikar|નરેંદ્ર કેશવ સવાઇકર
Ramdas Tadas|રામદાસ તડસ
Sundaram Thangavelu|સુંદરમ થાંગાવેલુ
Pusapati Ashok Gajapati Raju|અશોક ગજપતિ રાજૂ પૂસપાટિ
Rory Bosio|રોરી બોસિઓ
Joice George|જોઇસ જૉર્જ
Mahesh Sharma|મહેશ શર્મા
A. P. Jithender Reddy|એપી જિતેન્દર રેડ્ડી
Balka Suman|બાલ્કા સુમન
Butta Renuka|બુટ્ટા રેણુકા
Ch Malla Reddy|ચ મલ્લા રેડ્ડી
Dharambir|ધરમબીર
K C Patel|કે૰સી૰ પટેલ
Kapil Krishna Thakur|કપિલ કૃષ્ણ ઠાકુર
Konda Vishweshwar Reddy|કોંડા વિશ્વેશ્વર રેડ્ડી
Arka Keshari Deo|અરકા કેશરી દેવ
Radheshyam Biswas|રાધેશ્યામ બિસ્વાસ
Rammohan Naidu Kinjarapu|રામમોહન એન કિંજરપુ
Hemendra Chandra Singh|હેમેન્દ્ર ચન્દ્ર સિંહ
Badaruddoza Khan|બદ્રુદ્દોજ઼ા ખાન
Daddan Mishra|દદ્દન મિશ્રા
Pushpendra Singh Chandel|કુંવર પુષ્પેન્દ્ર સિંહ ચંદેલ
Rahul Kaswan|રાહુલ કાસવાન
Rajesh Pandey|રાજેશ પાણ્ડે
Ramcharan Bohara|રામચરણ બોહરા
Ravindra Kushawaha|રવિન્દ્ર કુશવાહા
Chandra Prakash Joshi|ચન્દ્રપ્રકાશ જોશી
Shrikant Shinde|શ્રીકાંત શિંદે
Krupal Tumane|કૃપાલ તુમાને
V. Pannerselvam|વી૰ પન્નીરસેલ્વમ
R. Gopalkrishnan|આર૰ ગોપાલકૃષ્ણન
K. Parasuraman|કે૰ પરસુરમન
S. Rajendran|એસ૰ રાજેન્દ્રન
Tushar Kalia|તુષાર કાલિયા
Sharad Tripathi|શરદ ત્રિપાઠી
A K Azizul Huq|এ কে আজিজুল হক
Sitanshu Yashaschandra|સિતાંષુ યશશ્ચન્દ્ર
Kalamandalam Satyabhama|કલામન્દલમ સત્યભામા
Geeta Mahalik|ગીતા મહાલિક
H. C. Verma|એચ.સી. વર્મા
Ranchhodji Diwan|રણછોડજી દીવાન
Indravijaysinhji|ઇન્દ્રવિજયસિંહજી જાડેજા
Usha Chinoy|ઉષા ચિનોય
M. K. Saroja|એમ.કે. સરોજા
Dyas|રા' દિયાસ
Rajesh Kumar|રાજેશ કુમાર
Ratnamanirao Jhote|રત્નમણિરાવ જોટે
Villy Aellen|Villy Aellen
Saroop Dhruv|સરૂપ ધ્રુવ
Rasika Dugal|રસિકા દુગ્ગલ
Wajihuddin Alvi|વજીહુદ્દીન અલવી
Durba Banerjee|દુર્બા બેનર્જી
Purnachandra Bidika|પૂર્ણચંદ્ર બિદિકા
|સંબાનંદ મોનપ્પા પંડિત
Bimal Patel|બિમલ પટેલ
Millind Gaba|મિલિન્દ ગાબા
Mickey Singh|મિકી સિંઘ
Harshaali Malhotra|હર્ષાલી મલ્હોત્રા
Kanti Bhatt|કાંતિ ભટ્ટ
Girdhar|ગિરધર
Lilavati Munshi|લીલાવતી મુનશી
Emmy Koch|એમ્મી કોચ
Shriram Madhav Nene|શ્રીરામ માધવ નેને
Bhavesh Bhatt|ભાવેશ ભટ્ટ
Mavjibhai Desai|માવજીભાઇ દેસાઈ
Akash Ambani|આકાશ અંબાણી
Dhwanil Parekh|ધ્વનિલ પારેખ
Sammudi Balasubramaniam|સમમુદિ બાલસુબ્રમણ્યમ્
Dinakararaya Keshavlal Vaidya|દિનકરરાય કેશવલાલ વૈદ્ય
Rajendra Patel|રાજેન્દ્ર પટેલ
Vijayray Vaidya|વિજયરાય વૈદ્ય
Kadambari Jethwani|કાદમ્બરી જેઠવાણી
Anwer Sultan|અન્વર સુલતાન
Anil Bokil|અનિલ Bokil
Shyam Sadhu|શ્યામ સાધુ
Manuel Martínez Chumillas|Manuel Martínez Chumillas
Giribala Mohanty|ગિરિબાલા મોહંતી
Ángel Cadarso del Pueyo|Ángel Cadarso del Pueyo
Vennu Mallesh|વેન્નુ મલેશ
Rami Rahim|રામી રહીમ
Shunya Palanpuri|શૂન્ય પાલનપુરી
|અતુલ પુરોહિત
Pranlal Vyas|પ્રાણલાલ વ્યાસ
Anjana Singh|અંજાન સિંહ
Kishorsingh Solanki|કિશોરસિંહ સોલંકી
Lalremsiami|Lalremsiami
Nysa Devgan|ન્યસા દેવગણ
Sahil Khattar|સાહિલ ખટ્ટર
Pravin Joshi|પ્રવીણ જોષી
Orso Orsini|Orso Orsini
Abhinandan Varthaman|અભિનંદન વર્ધમાન
RJ Vigneshkanth|આરજે વિગ્નેશકાંઠ
Mansukhram Tripathi|મનસુખરામ ત્રિપાઠી
Kuldip Patel|કુલદીપ પટેલ
Vaju Kotak|વજુ કોટક
Fanny Vaucher|Fanny Vaucher
Harihar Khambholja|હરિહર ખાંભોળજા
A. N. Jani|અ. ન. જાની
Kate Sayer|Kate Sayer
Shankarlal Parikh|શંકરલાલ પરીખ
Hargovinddas Kantawala|સર્જક:હરગોવિંદદાસ દ્વારકાદાસ કાંટાવાળા
Matubhai Kantawala|મટુભાઈ કાંટાવાળા
Anna Kulikova|Anna Kulikova
Urmi Parikh|ઊર્મિ પરીખ
Jean-Pierre Lloyd|Jean-Pierre Lloyd
Areke Hassink|Areke Hassink
Paula Fedirchuk|Paula Fedirchuk
Claudia Migliorini|Claudia Migliorini
Sylvia Debboudt|Sylvia Debboudt
Miranda De Permentier|Miranda De Permentier
Aurélie Anaise|Aurélie Anaise
Gulnara Fatkullina|Gulnara Fatkullina
Kanji Bhuta Barot|કાનજી ભુટા બારોટ
Jahangir Edalji Sanjana|જહાંગીર એદલજી સંજાણા
Mirza Nikolajev|Mirza Nikolajev
Elīna Ieva Vītola|Elīna Ieva Vītola
Kyle Murray|Kyle Murray
Prasad Brahmbhatt|પ્રસાદ બ્રહ્મભટ્ટ
Devji Modha|દેવજી મોઢા
Stefan Kiefer|Stefan Kiefer
Stanley Kubrick|સ્ટેનલી કુબરિક
Galileo Galilei|ગૅલિલિયો ગૅલિલિ
Giuseppe Garibaldi|જુઝૅપ્પે ગેરિબાલ્ડી
Socrates|સોક્રેટિસ
Anne Frank|ઍન્ની ફ્રૅન્ક
Rajiv Gandhi|રાજીવ ગાંધી
Céline Dion|સેલિન ડીયોન
Novak Djokovic|નોવાક ડીજોકોવિક
Hillary Clinton|હિલેરી ક્લિન્ટન
Kalidasa|કાલિદાસ
Ibn Battuta|ઇબન બતૂતા
Akbar|અકબર
Ronald Reagan|રોનાલ્ડ રીગન
Rafael Nadal|રફેલ નડાલ
William Rowan Hamilton|વિલિયમ રૉવન હેમિલ્ટન
Sabyasachi Chakraborty|સબ્યસાચી ચક્રવર્તી
Stephen Hawking|સ્ટીફન હૉકિંગ
Allan Green|એલન ગ્રીન
Bhavabhūti|ભવભૂતિ
Hema Malini|હેમા માલિની
Joan Crawford|જોન ક્રોફોર્ડ
Jim Carrey|જિમ કેરી
Julia Roberts|જુલિયા રોબર્ટ્સ
John Wayne|જ્હોન વેઇન
Blake Jenner|બ્લેક જેનર
Harold Pinter|હેરોલ્ડ પિન્ટર
Salman Rushdie|સલમાન રૂશદી
Satyendra Nath Bose|સત્યેન્દ્રનાથ બોઝ
Swami Vivekananda|સ્વામી વિવેકાનંદ
Emile Griffith|એમિલ ગ્રિફિથ
Rajinikanth|રજનીકાંત
Bal Thackeray|બાલ ઠાકરે
Lonnie Bradley|લોની બ્રેડલી
Mike Tyson|માઈક ટાયસન
Madhu Shalini|મધુ શાલિની
Kaifi Azmi|કૈફી આઝમી
Selena Gomez|સેલિના ગોમેઝ
Guru Nanak|ગુરુનાનક
Subhash Kak|સુભાષ કાક
Louis Braille|લૂઈ બ્રેઈલ
Tavoris Cloud|ટાવરિસ ક્લાઉડ
Howard Jackson|હોવર્ડ જેકસન
Satsvarupa dasa Goswami|સત્સ્વરૂપદાસ ગોસ્વામી
Tanuja|તનુજા
Tanishaa Mukerji|તનિષા મુખરજી
Frederick Sanger|ફેડ્રિક સેંગર
Lata Mangeshkar|લતા મંગેશકર
Dimple Kapadia|ડિમ્પલ કાપડિયા
Mohammad Ali Jinnah|મહમદ અલી ઝીણા
Dara Singh|દારાસિંહ
Jiddu Krishnamurti|જીદ્દુ કૃષ્ણમુર્તિ
Mary Robinson|મૅરી રોબિન્સન
Chandragupta Maurya|ચંદ્રગુપ્ત મૌર્ય
Freida Pinto|ફ્રીડા પિન્ટો
Zubeida|ઝુબેદા
Hrithik Roshan|ઋત્વિક રોશન
Bernardo Houssay|બર્નાર્ડો આલ્બર્ટો હોસી
Shivaji Bhonsle I|શિવાજી
I. K. Gujral|ઈન્દ્રકુમાર ગુજરાલ
Anoushka Shankar|અનુષ્કા શંકર
Nicky Romero|Nicky Romero
Milkha Singh|દોડવીર મિલખા સિંઘ
Konkona Sen Sharma|કોંકણા સેન ધર્મ
Mukesh|મુકેશ
Shalini Kumar|શાલિની કુમાર
Ambika|અંબિકા
Anjali|અંજલિ
Amrita Arora|અમૃતા અરોડા
Aga Khan IV|karim aga khan
Tulsidas|તુલસીદાસ
George Wallace|જ્યોર્જ વાલેસ
Jagadish Chandra Bose|જગદીશચંદ્ર બોઝ
Sugar Ray Robinson|સુગર રે રોબિન્સન
Floyd Mayweather Jr.|ફ્લોઈડ મેવેધર જુનિયર
Robert Quiroga|રોબર્ટ ક્વિરોગા
Vikram Sarabhai|વિક્રમ સારાભાઇ
Homi Jehangir Bhabha|હોમિ ભાભા
Jameel McCline|જમીલ એમસીલાઇન
Earnie Shavers|એર્નીએ શેવર્સ
Abrar-ul-Haq|અબરાર-ઉલ-હક
Amitav Ghosh|અમિતાભ ઘોષ
Ray Arcel|રે આર્સેલ
Ricardo Williams|રિકાર્ડો વિલિયમ્સ
Big Sean|બિગ શોન
Meghnad Saha|મેઘનાદ સહા
Mithun Chakraborty|મીથુન ચક્રવર્તી
K. S. Ravikumar|કે એસ રવિકુમાર
Asha Puthli|આશા પુથલી
William O'Dwyer|વિલિયમ ઓ'ડવાયર
Nadira|નાદીરા
P. Leela|પી..લીલા
Shabana Azmi|શબાના આઝમી
Alka Yagnik|અલકા યાજ્ઞિક
Gayatri Joshi|ગાયત્રી જોશી
Ela Bhatt|ઈલા ભટ્ટ
Shobhna Samarth|શોભના સમર્થ
Sonu Nigam|સોનૂ નિગમ
Vinayak Damodar Savarkar|વિનાયક દામોદર સાવરકર
Amrita Prakash|અમૃતા પ્રકાશ
Sathya Sai Baba|સત્ય સાંઈ બાબા
Jamila Massey|જમિલા મસી
Megha Mittal|મેઘા મિત્તલ
Rooma Mehra|રૂમા મેહરા
Chanda Kochhar|ચંદા કોચર
Narada Michael Walden|નારદા માઈકેલ વાલ્ડેન
Feroze Gandhi|ફિરોઝ ગાંધી
Sam Manekshaw|જનરલ સામ માણેકશા
Prithviraj Chauhan|પૃથ્વીરાજ ચૌહાણ
Farhan Akhtar|ફરહાન અખ્તર
Rohan Kapoor|રોહન કપૂર
Sonakshi Sinha|સોનાક્ષી સિંહા
Sundaram Balachander|સુન્દરમ બાલચંદ્ર
Allu Arjun|અલ્લૂ અર્જુન
Chetan Anand|ચેતન આનંદ
R. Madhavan|આર.માધવન
Rajmohan Gandhi|રાજમોહન ગાંધી
Mahadev Desai|મહાદેવભાઇ દેસાઈ
Gemini Ganesan|જેમિની ગણેશન
Bhagwan Das|ભગવાન દાસ
Salisuka|શાલીશુક્લા
Jacques Kallis|જેક્સ કાલીસ
Rajyavardhan Rathore|રાજ્યવર્ધન સિંહ રાઠૌડ઼
Ranbir Kapoor|રણબીર કપૂર
Dennis Lillee|ડેનિસ લીલી
Dilip Shanghvi|દીલીપ સંઘવી
Manilal Gandhi|મણિલાલ ગાંધી
Agnez Mo|માંકેવી વયંસેવ
Sita Ram Goel|સીતા રામ ગોયલ
Harilal Gandhi|હરિલાલ ગાંધી
John Baptist Sequeira|જૉન બાપિસ્ટ સિક્વેરિયા
Asma Jahangir|અસ્મા જહાંગીર
Swami Kuvalayananda|સ્વામી કુવાલયાનંદ
Devavarman|દેવવર્મન
Shashi Deshpande|શશિ દેશપાંડે
Sanjay Kapoor|સંજય કપૂર
Iftekhar|ઇફ્તેખર
Umaswati|ઉમાસ્વાતી
Koenraad Elst|કોએનરાડ એલ્સ્ટ
Pratibha Ray|પ્રતિભા રાય
Myrto|માયર્ટો
Kausalya|કૌશલ્યા
Shankar Mahadevan|શંકર મહાદેવન
Mehboob|મહેબૂબ
Rahul Nambiar|રાહુલ નામ્બિયાર
Tippu|ટિપપૂ
Lathika|લથીકા
Pururavas|પુરૂરવા
Mohammad Kaif|મોહમ્મદ કૈફ
Raj Bagri, Baron Bagri|રાજ બગરી, બેરોન બગરી
Srinivasaraghavan Venkataraghavan|શ્રીનિવાસ વેંકટરાઘવન
Jessica Dragonette|જેસિકા દ્રાગોનેટ્ટે
Ketan Mehta|કેતન મેહતા
Shamita Shetty|શમિતા શેટ્ટી
Pawan Kumar Chamling|પવનકુમાર ચામલિંગ
Stuart Williams|Stuart Williams
Mandavi|માંડવી
Rubina Ali|રૂબીના અલી
Nanaji Deshmukh|નાનાજી દેશમુખ
Ravindra Jadeja|રવિન્દ્ર જાડેજા
Krishnamachari Srikkanth|ક્રિષ્નામાચારી શ્રીકાંત
Sukhdev Thapar|સુખદેવ
Ajay Jadeja|અજય જાડેજા
Kiran Bedi|કિરણ બેદી
Adam Tankaravi|અદમ ટંકારવી
Sadanand Viswanath|સદાનંદ વિશ્વનાથ
Aniruddh Brahmabhatt|અનિરુદ્ધ બ્રહ્મભટ્ટ
Nayan Mongia|નયન મોંગીયા
Anil Joshi|અનિલ જોશી
Amrutlal Yagnik|અમૃતલાલ યાજ્ઞિક
|અરજણ ભગત
Damodar Dharmananda Kosambi|ડી. ડી. કૌશામ્બી
Mushtaq Ali|સૈયદ મુસ્તાક અલી
Sharda Sinha|શારદા સિંહા
Kanhaiyalal Sethia|કન્હૈયાલાલ સેઠીયા
Andrew Symonds|એન્ડ્ર્યૂ સાયમન્ડ્સ
Asaram|આસારામજી બાપુ
|આધારાનંદ સ્વામી
Koppillil Radhakrishnan|ડો. કે. રાધાકૃષ્ણન
Craig McDermott|ક્રેગ મેકડરમોટ
|ઉપવાસી બાપુ
|કલ્યાણભાઇ બાબરભાઇ પટેલ
Ghulam Mohammed Sheikh|ગુલામમોહમ્મદ શેખ
|ગૌરીશંકર ગોવર્ધનરામ જોષી
Granville Seward Austin|ગ્રેનવિલ ઔસ્ટિન
Chandrakant Topiwala|ચંદ્રકાન્ત ટોપીવાળા
Maneka Gandhi|મેનકા ગાંધી
Malay Roy Choudhury|મલય રોય ચૌધરી
Jyothika|જ્યોતિકા
Jaybhikhkhu|જયભિખ્ખુ
Jyotish Jani|જ્યોતિષ જાનિ
Tansukhrai Oza|તનસુખરાય ઓઝા
Deepak Mehta|દીપક મહેતા
Devayat Bodar|દેવાયત બોદર
Dolatram Pandya|દોલતરામ પંડ્યા
Dharmashibhai Shah|ધરમશીભાઈ શાહ
Nrisinhdas Vibhakar|નૃસિંહદાસ વિભાકર
|પિંગળશી ગઢવી
|પોથન
Swami Premananda|પ્રેમાનંદ સ્વામી
Bachubhai Ravat|બચુભાઇ રાવત
|બાલ ગંગાધર તિલક
|બોડાણો
|ભિક્ષુ અખંડાનંદ
Mahmud Begada|મહમદ બેગડો
Asim Randeri|આસિમ રાંદેરી
Bhikaiji Cama|મેડમ કામા
Mohanbhai Patel|મોહનભાઇ પટેલ
Yashwant Trivedi|યશવંત ત્રિવેદી
Yusuf Meher Ally|યુસુફ મેહરઅલી
Ratilal Borisagar|રતિલાલ બોરીસાગર
Ravjibhai Manibhai Patel|રાવજીભાઇ મણિભાઇ પટેલ
Labhshankar Thakar|લાભશંકર ઠાકર
Vidyagauri Neelkanth|વિદ્યાગૌરી નીલકંઠ
Vinodini Neelkanth|વિનોદીની નીલકંઠ
Shirish Panchal|શિરિષ પંચાલ
Shekh Adam Abuwala|શેખ આદમ આબુવાલા
Satish Vyas|સતીશ વ્યાસ
Harinarayan Giradharlal Acharya|હરિનારાયણ ગિરધરલાલ આચાર્ય
Heera Pathak|હીરા પાઠક
William Damasus Lindanus|chaudhari
Gopal Godse|ગોપાલ ગોડસે
Ravichandran Ashwin|રવિચંદ્રન અશ્વિન
Dan Vlad|panchtantra
Pran|પ્રાણ
Rash Behari Bose|રાસબિહારી બોઝ
Madan Gopal Chitkara|મદન ગોપાલ ચિત્કાર
P. T. Usha|ptusha
Moin Akhter|મોઇન અખ્તર
Nirode Chowdhury|નીરોડે ચૌધરી
Rahul Sankrityayan|રાહુલ સંક્રત્યાયન
Suresh Raina|સુરેશ રૈના
Shobana|શોભના
C. K. Nayudu|સી.કે.નાયડુ
Yograj Singh|યોગરાજસિંઘ
Balasaraswati|બાલાસરસ્વતી
Kratika Sengar|કૃતિકા સેંગર
Ram Puniyani|રામ પુનિયાની
Yashpal Sharma|યશપાલ શર્મા
Rajesh Chauhan|રાજેશ ચૌહાણ
Roger Binny|રોજર બિન્ની
Prasanna|પ્રસન્ન
Habib Tanvir|હબીબ તનવીર
N. V. Krishna Warrier|એન. વી. કૃષ્ણ વારિયર
Mahavir Prasad Dwivedi|મહાવીર પ્રસાદ દ્વિવેદી
Chembai|ચેમ્બાઇ
Sadha|સધા
Vijaydan Detha|વિજયદાન દેથા
Maitreyi Devi|મૈત્રેય દેવી
Baba Sehgal|બાબા સહગલ
Madhavi|માધવી
Santha Devi|સંથા દેવી
Babu Antony|બાબુ એન્ટની
Sudama Panday 'Dhoomil'|સુદામા પાંડે 'ધુમિલ'
Sanjay Kumar|સંજય કુમાર
Suresh Oberoi|સુરેશ ઓબરોય
Vempati Chinna Satyam|વેમ્પતિ છિન્ના સત્યમ
Praful Bidwai|પ્રફુલ બિદવાઈ
Naresh Mehta|નરેશ મહેતા
Kovilan|કોવિલન
Agnivesh|અગ્નિવેશ
Nirmala Deshpande|નિર્મલા દેશપાંડે
Ahmed Raza Khan Barelvi|ઇમામ અહમદ રઝા
J. B. Kripalani|જે. બી. કૃપલાની
Suman Kalyanpur|સુમન કલ્યાણપુર
Rahi Masoom Raza|રહી માસૂમ રઝા
Josh Malihabadi|જોશ માલિહાબાદી
P. N. Oak|પી.એન. ઓક
Binod Bihari Verma|બિનોદ બિહારી વર્મા
Rajiv Pratap Rudy|રાજીવ પ્રતાપ રૂડી
Pherozeshah Mehta|ફિરોઝશાહ મહેતા
Surendra Mohanty|સુરેન્દ્ર મોહન્તિ
Nanak Singh|નાનક સિંહ
Durgabai Deshmukh|દુર્ગાબાઈ દેશમુખ
Muppavarapu Venkaiah Naidu|વૈંકયા નાયડુ
David Wise|davidwise
Sergio Mattarella|સર્જિયો માત્તારેલા
T. V. Sankaranarayanan|ટી.વી. શંકરનારાયણ
Mary M. Shirley|મેરી એમ. શિર્લે
Nithyasree Mahadevan|નિત્યશ્રી મહાદેવન
Victor H. Erlich|વિક્ટર એચ. એર્લિચ
AVS Raju|એ.વી.એસ. રાજુ
Aarudhra|આરુદ્ર
Vidyasagar|આચાર્ય વિદ્યાસાગર
Aditi Mangaldas|અદિતી મંગલદાસ
Adriaan van der Willigen|Adriaan van der Willigen
Adriaan van der Willigen Pz.|Adriaan van der Willigen Pz.
Adriaen Foly|Adriaen Foly
Alan R. Price|એલન આર ભાવ
Alexander Kinloch Forbes|એલેકઝાન્ડર ફાર્બસ
Amirbai Karnataki|અમીરબાઈ કર્ણાટકી
Amit Kumar|અમિત કુમાર
Amritlal Vegad|અમૃતલાલ વેગડ
Anand Babu|આનંદ બાબુ
Ananth Kumar Hegde|અનંત કુમાર હેગડ઼ે
Anindita Bose|અનિંદિતા બોઝ
Anirudh Agarwal|અનિરુધ અગ્રવાલ
Anjali Patil|અંજલિ પાટીલ
Anjana Basu|અંજના બાસુ
Anju Mahendru|અંજુ મહેન્દ્ર
Anuj Sawhney|અનુજ સોહની
Aram Chobanian|અરામ ચોબાનિયન
Arthur Chester Dahlberg|આર્થર ચેસ્ટર ડહલબર્ગ
Arvind Trivedi|અરવિંદ ત્રિવેદી
Balaji Vishwanath|બાલાજી વિશ્વનાથ ભટ્ટ
Bhagvat Singh|મહારાજા ભગવતસિંહજી
Bhagwati Charan Vohra|ભગવતી ચરણ વોહરા
Bhoja Bhagat|ભોજા ભગત
C. L. Ruala|સી૰ એલ૰ રુઆલા
Carlos Del Castillo|કાર્લોસ ડેલ કાસ્ટિલો
Carol Kuhlthau|કેરોલ કુહલતાઉ
Charles F. Wagner|ચાર્લ્સ એફ વેગનર
Chitresh Das|ચિત્રેશ દાસ
Chittaranjan Mitra|ચિતરંજન મિત્ર
Chris Oynes|nagarpalika
William Frederick Durand|વિલિયમ ફ્રેડરિક ડ્યુરન્ડ
Courtney Brown|કર્ટની બ્રાઉન
Curumsey Damjee|કરમશી દામજી
Dada Bhagwan|દાદા ભગવાન
Daniel Kammen|ડેનિયલ કામમેન
David Britz|ડેવિડ બ્રિટ્ઝ
Deepak Puri|દિપક પુરી
Deepender Singh Hooda|દીપેંદ્ર સિંહ હુડ્ડા
Dennis M. Bushnell|ડેનિસ એમ. બુશનેલ
Dennis McCarthy|ડેનિસ મેકાર્થી
Ganesh Damodar Savarkar|ગણેશ દામોદર સાવરકર
George Adam Smith|adam smith
Harekrishna Deka|હરેકૃષ્ણ ડેકા
Gajender Singh|ગજેન્દ્ર સિંઘ
Hitendra Kanaiyalal Desai|હિતેન્દ્ર દેસાઈ
Innocent|ઇનોસેંટ
Jagannatha Pandita Rayalu|Jagannatha Pandita Rayalu
Jeet Thayil|જીત થાઈલ
Joginder Singh Sahnan|જોગીન્દર સિંહ
Jose K. Mani|જોસ કે૰ મણિ
Kala Nath Shastry|કલાનાથ શાસ્ત્રી
Kalikesh Narayan Singh Deo|કલિકેશ સિંહ દેવ
Kalipatnam Ramarao|કાલીપટનમ રામારાવ
Kanaklata Barua|કનકલતા બરુઆ
Kartar Singh Duggal|કરતારસિંહ દુગ્ગલ
Kartik Aaryan|કાર્તિક આર્યન
Kavi Kant|મણિશંકર રત્નજી ભટ્ટ
Kodikunnil Suresh|કોડિકુન્નીલ સુરેશ
Krutika Desai Khan|કૃતિકા દેસાઈ ખાન
Kuldip Singh Chandpuri|કુલદીપ સિંઘ ચાંદપુરી
Kumar Shri Duleepsinhji|દુલિપસિંહજી
Kumari Kanchan Dinkerao Mail|કંચન
Leena Jumani|લીના જુમાની
Leleti Khumalo|લેલેટી ખુમાલો
Leslie Fernandez|લેસ્લી ફર્નાન્ડીઝ
Nityananda Mohapatra|નિત્યાનંદ મોહપાત્રા
M. K. Raghavan|એમ૰કે૰ રાઘવન
M. Mukundan|એમ. મુકુંદન
Madhu Sudan Kanungo|મધુ સુદાન કાનુંગો
Maheboob Khan|મહેબૂબ ખાન
Manzoor Akhtar|મંજુર અખ્તર
Maqsood-ul-Haq|મકસુદ-ઉલ-હક
Mary Verghese|મેરી વર્ગીઝ
Mithila Prasad Tripathi|મિથિલાપ્રસાદ ત્રિપાઠી
Mohammad Naeem|મોહમ્મદ નઇમ
Nandi Yellaiah|નંદી યેલ્લયાહ
Navalram Pandya|નવલરામ પંડ્યા
Neelam Mansingh Chowdhry|નિલમ માનસિંહ ચૌધરી
P. K. Warrier|પનિયિમ્પલી ક્રિશ્નનક્યુટી વાયરિયર
Poojari Kakkan|પી. કક્કન
P. Kumar|પી૰ કુમાર
Padma Desai|પદ્મા દેસાઈ
Poonam Mahajan Rao|પૂનમ મહાજન રાવ
Prabhatsinh Pratapsinh Chauhan|પ્રભાતસિંહ પ્રતાપસિંહ ચૌહાન
Prataprao Ganpatrao Jadhav|પ્રતાપરાવ ગણપતરાવ જાધવ
Rajen Gohain|રાજેન ગોહેન
Raju Shetti|રાજૂ શેટ્ટી
Rakesh Jhaveri|રાકેશ ઝવેરી
Ramakant Achrekar|રમાકાંત વી. આચરેકર
Ramanbhai Nilkanth|રમણભાઈ નીલકંઠ
Ramesh Bais|રમેશ બૈસ
Ramesh Sakharam Benegal|રમેશ સખારામ બેનેગલ
Ratna De|રત્ના ડે
Ravishankar Shukla|ravisankar shukla
Ravivarman Sharmila|રવિવરમણ શર્મિલા
S. P. Sudrania|એસ.પી.સુદ્રાનીયા
Sanwar Lal Jat|સાંવર લાલ જાટ
Saurabh Patel|saurabh patel
Shailesh Lodha|શૈલેશ લોઢા
Shantidas Jhaveri|શાંતિદાસ જવેરી
Shobha Pandit|શોભા પંડિત
Siddhanta Mahapatra|સિદ્ધાંત મહાપાત્રા
Sukumar|સુકુમાર
Supriya Pathak|સુપ્રિયા પાઠક
Supriya Sule|સુપ્રિયા સુલે
Tarun Tahiliani|tarun tahiliyani
Thupstan Chhewang|થુપ્સતાન છેવાંગ
Usha Mehta|ઉષા મહેતા
Vanraj Chavda|વનરાજ ચાવડા
Vincent Pala|વિન્સેંટ પાલા
Vishnu Deo Sai|વિષ્ણુ દેવ સાઈ
Vivaan Shah|વિવાન શાહ
Sudhir Kumar Chitradurga|સુધીરકુમાર ચિત્રદુર્ગ
Sushant Singh Rajput|સુશાંતસિંહ રાજપૂત
Mother Love|matru prem
Samprati|સંપ્રતિ
Dayaram K. Patel|ડો. દયારામભાઈ પટેલ
Tantia Bhīl|તાત્યો ભીલ
Jamsetjee Jejeebhoy|જમશેદજી જીજીભોય
Urjit Patel|ઉર્જિત પટેલ
Suren Gazaryan|સુરેન ગઝરયાન
Meenakshi Lekhi|મીનાક્ષી લેખી
Sarla Behn|સરલાબહેન
Surinderjeet Singh Ahluwalia|એસ૰એસ૰ અહલૂવાલિયા
Narbheram|સર્જક:નરભેરામ
Ambalal Sarabhai|અંબાલાલ સારાભાઈ
Kanu Gandhi|કનુ ગાંધી
Sir Chinubhai Madhowlal Ranchhodlal|સર ચીનુભાઇ માધવલાલ રણછોડલાલ
Bhavsinhji Gohil (II)|ભાવસિંહજી ગોહિલ (દ્વિતીય)
Hukmdev Narayan Yadav|હુકુમદેવ નારાયણ યાદવ
Bahadur Singh Koli|બહાદુર સિંહ કોલી
Nakshatra Bagwe|naxatra
A.N. Rai|એ.એન. રાય
Subhash Chandra Baheria|સુભાષ બહેડ઼િયા
Kaushalendra Kumar|કૌશલેન્દ્ર કુમાર
Kavi Shastri|કવિ શાસ્ત્રી
Heera Saraniya|નાબા કુમાર સરણિયા (હીરા)
Munmun Dutta|મુનમુન દત્તા
Maheish Girri|મહેશ ગિરી
Srinwanti Chakrabarti|શ્રીવંતી ચક્રવર્તી
Raghav Lakhanpal|રાઘવ લખનપાલ
Bharti Shiyal|ભારતી શિયાલ
Devji M Patel|દેવજી પટેલ
Rajesh Chudasama|રાજેશ ચુડાસમા
Dhananjay Mahadik|ધનંજય મહાદિક
Poonamben Madam|પૂનમબેન માદામ
Mahant Chand Nath|મહંત ચાંદનાથ
Nagendra Vijay|નગેન્દ્ર વિજય
Ashok Nete|અશોક મહાદેવરાવ નેતે
Nanabhau Patole|નાનાભાઊ પટોલે
Niranjan Jyoti|નિરંજન જ્યોતિ
Sanjaykaka Patil|સંજયકાકા પાટિલ
Naipal Singh|નેપાલ સિંહ
Vinod Bhatt|વિનોદ ભટ્ટ
Kalyan Bidhan Sinha|કલ્યાણ બિધન સિંહા
Janardan Singh Sigriwal|જનાર્દન સિંહ સિગ્રીવાલ
Azmeera Seetaram Naik|અજ઼મીરા સીતારામ નાયક
Fatepara Devajibhai Govindbhai|દેવજીભાઈ ગોવિંદભાઈ ફતેપારા
Kamakhya Prasad Tasa|કામાખ્યા પ્રસાદ તાસા
Krishan Pal|કૃષ્ણ પાલ
Pandula Ravindra Babu|પંદુલ રવિન્દ્ર બાબૂ
Ram Kumar Sharma|રામ કુમાર શર્મા
Ramesh Chander|રમેશ ચન્દર
Renuka Sinha|રેણુકા સિન્હા
Sunil Kumar Mandal|સુનીલ કુમાર મંડલ
Thota Narasimham|તોટા નરસિમ્હન
Ajay Kumar Mishra|અજય કુમાર
Ashok Kumar Doharey|અશોક કુમાર દોહરે
Bhagwanth Khuba|ભગવંત ખુબા
Hari Om Pandey|હરિઓમ પાણ્ડેય
Krishna Pratap|કૃષ્ણ પ્રતાપ
Mahendra Nath Pandey|મહેન્દ્ર નાથ પાણ્ડેય
Sakshi Maharaj|સ્વામી સચ્ચિદાનંદ હરિ સાક્ષી
B B Patil|બી૰બી૰ પાટિલ
Sadashiv Lokhande|સદાશિવ લોખંડે
Maganti Venkateswara Rao|માગણ્ટિ વેંકટેશ્વર રાવ
Sathyabama V|વી૰ સત્યભામા
Gopalakrishnan Chinnaraj|સી૰ ગોપાલકૃષ્ણન
Muddahanumegowda S. P.|મુદાહાનુમેગૌડા એસ૰પી૰
T. Radhakrishnan|ટી૰ રાધાકૃષ્ણન
S. R. Vijayakumar|એસ૰આર૰ વિજયકુમાર
Devendra Singh|દેવેન્દ્ર સિંહ
Somalal Shah|સોમાલાલ શાહ
Parshwanath Upadhye|પાર્શ્વનાથ ઉપાધ્યાયે
Ganesh Mali|ગણેશ માળી
Buddhisagarsuri|બુદ્ધિસાગરસુરિ
Deepchand Gardi|દીપચંદભાઇ ગાર્ડી
Sambit Patra|સમ્બિત પાત્રા
Deba Prasad Das|દેબા પ્રસાદ દાસ
Pushpa Bhuyan|પુષ્પા ભુયાન
Daku|ડાકુ
Rajkumar Achouba Singh|રાજકુમાર અચૌબા સિંહ
Radhika Madan|રાધિકા મદન
Vishvesh Parmar|વિશ્વેશ પરમાર
Yashwant Mehta|યશવન્ત મહેતા
|જેસલ જાડેજા
Arushi Nishank|આરૂશી નિશાંક
|પુજા ઠાકુર
Noziya Karomatullo|નોઝીયા કરોમેતુલ્લો
Gambhir Singh Mura|ગંભીર સિંહ મુરા
H. N. Golibar|એચ એન ગોલીબાર
Dinker Belle Rai|દિન્કર બેલે રાય
Suhana Khan|સુહાના ખાન
Ayesha Dutt|આયેશા દત્ત
Uttambhai Patel|ઉત્તમભાઈ હરજીભાઈ પટેલ
Rahul Potluri|રાહુલ પોટલુરી
Jan Pawlowski|Jan Pawlowski
Priyambada Mohanty Hejmadi|પ્રિયમ્બદા મોહંતી હેજમાદી
Dhiren Mistry|ધીરેન મિસ્ત્રી
Sevakram Rajaram Desai|સેવકરામ રાજારામ દેસાઈ
Lionel Cavin|Lionel Cavin
Gurtej Singh|ગુરતેજસિંહ
Markand Bhatt|માર્કંડ ભટ્ટ
Rajesh Vankar|રાજેશ વણકર
Narayan Damodar Savarkar|નારાયણ દામોદર સાવરકર
Prithipal Chatterjee|પૃથ્વીલ ચેટર્જી
Harji Lavji Damani|હરજી લવજી દામાણી
Helen Giri|હેલેન ગિરી સ્યીમ
Santi Ghose|શાંતિ ઘોષ
Raeesh Maniar|રઈશ મનીઆર
Jean-Philippe Anstett|Jean-Philippe Anstett
Bhanuprasad Trivedi|ભાનુપ્રસાદ ત્રિવેદી
Chamundaraja|ચામુંડરાજ
Rinku|રિંકુ
Gemal|ગેમલ
Bhawana Kanth|ભાવના કંથ
Francisco Alonso Martos|Francisco Alonso Martos
Rasiklal Umedchand Parikh|રસિકલાલ ઉમેદચંદ પરીખ
Malayanil|મલયાનિલ
Gulfam|ગુલફામ
Jesús Martínez Verón|Jesús Martínez Verón
Joaquín de la Concha Alcalde|Joaquín de la Concha Alcalde
Felipe Medina Benjumea|Felipe Medina Benjumea
Harshadev Madhav|હર્ષદેવ માધવ
Mithuben Petit|મીઠુબેન પેટીટ
Jadavaji Keshavji Modi|જાદવજી કેશવજી મોદી
Utpal Bhayani|ઉત્પલ ભાયાણી
Anny Divya|અન્ની દિવ્યા
Ramachander Dhobi|રામ ચંદર
Jyoti Prakash Nirala|જ્યોતિ પ્રકાશ નિરાલા
Mukund Parikh|મુકુંદ પરીખ
Dhira Chaliha|ધીર ચલિહા
Krishnalal Mohanlal Jhaveri|કૃષ્ણલાલ મોહનલાલ ઝવેરી
Konstantina Sintzaniki|Konstantina Syntzanaki
Motibhai Narsinhbhai Amin|મોતીભાઈ નરસિંહભાઈ અમીન
Akshay Desai|અક્ષય દેસાઈ
Dipak Bardolikar|દીપક બારડોલીકર
Pallavi Mohapatra|પલ્લવી મહાપત્ર
Joravarsinh Jadav|જોરાવરસિંહ જાદવ
Shankarlal Shastri|શંકરલાલ શાસ્ત્રી
Daksha Pattani|દક્ષા પટ્ટણી
Mahendra Munjapara|મહેન્દ્રા મુંજપરા
Vijaysinh Chavda|વિજયસિંહ ચાવડા
Jas Ram Singh|યશ રામ સિંઘ
Chunilal Shah|ચુનીલાલ શાહ
|અંબાઈદાસ જીવાભાઈ અમીન
Jethalal Joshi|જેઠાલાલ જોષી
Shyamal Munshi|શ્યામલ મુનશી
|જયંતિલાલ ભાનુશાળી
Jalan Matari|જલન માતરી
|વિજય નહેરા
Saket Gokhale|સાકેત ગોખલે
Amit Bhadana|અમિત ભડાના
Ramlal Chunilal Modi|રામલાલ ચુનીલાલ મોદી
Kshemu Divetia|ક્ષેમુ દિવેટિયા
Gjergj Zefi|Gjergj Zefi
Linus Kvist|Linus Kvist
Erki Laanemäe|Erki Laanemäe
Ingram Cuff|Ingram Cuff
Nikita Stenkovoy|Nikita Stenkovoy
Maria Ögn Gudmundsdottir|Maria Ögn Gudmundsdottir
Cornelia Cyrus|Cornelia Cyrus
Ioulia Eremeeva|Ioulia Eremeeva
Julia Bradley|Julia Bradley
Simona Wagnerova|Simona Wagnerova
Sara Savino|Sara Savino
Ramesh R. Dave|રમેશ ર. દવે
Florian Auer|Florian Auer
Emīls Cipulis|Emīls Cipulis
Ambalal Bulakhiram Jani|અંબાલાલ બુલાખીરામ જાની
Kantilal Pandya|કાન્તિલાલ પંડ્યા
Dalpat Padhiar|દલપત પઢિયાર
Ramniklal Maru|રમણિકલાલ મારુ
Marián Skupek|Marián Skupek
Labhshankar Purohit|લાભશંકર પુરોહિત
Adam Dobeš|Adam Dobeš
Mara Morell|Mara Morell
Dylan Sorensen|Dylan Sorensen
Jay Raiyarela|જય રૈયારેલા
Jonas Oehmichen|Jonas Oehmichen
Abraham Lincoln|અબ્રાહમ લિંકન
Julian Assange|જુલિયન અસાંજે
Charlie Chaplin|ચાર્લી ચૅપ્લિન
Julius Caesar|જુલિયસ સીઝર
Usain Bolt|યુસૈન બોલ્ટ
Vladimir Lenin|લેનિન
Trajan|ટ્રાજન
Neil Armstrong|નીલ આર્મસ્ટ્રૉંગ
Corbin Bleu|કોર્બીન બ્લુ
Raphael|રફાયેલ
Elizabeth I of England|ઇંગ્લેન્ડના એલિઝાબેથ પ્રથમ
Louis XVI of France|લૂઈ ૧૬મો
Nelson Mandela|નેલ્સન મંડેલા
Satyajit Ray|સત્યજીત રે
Dmitri Mendeleev|mendeleev
Aamir Khan|આમિર ખાન
John F. Kennedy|જ્‌હોન એફ કેનેડી
Tipu Sultan|ટીપુ સુલ્તાન
Pelé|પેલે
Lady Gaga|લેડી ગાગા
Donald Trump|ડોનાલ્ડ ટ્રંપ
Poornitha|પૂરણીતા
Sima Guang|સિમા ગુઆંગ
Zoroaster|જરથુષ્ટ્ર
Thalis|thales
Sylvester Stallone|સિલ્વેસ્ટર સ્ટેલોન
Sandra Bullock|સાન્દ્રા બુલોક
Ram Narayan|પંડિત રામ નારાયણ
Xuanzang|હ્યુ-એન-ત્સાંગ
Rumi|રૂમી
Hamid Karzai|હમીદ કરઝાઈ
Jimmy Carter|જિમ્મી કાર્ટર
The Undertaker|ધ અંડરટેકર
V. S. Naipaul|વી. એસ. નાયપોલ
Parveen Shakir|પરવીન શાકીર
Raima Sen|રાયમા સેન
Esha Deol|એશા દેઓલ
deadmau5|ડેડમાઉસ
Padmasree Warrior|પદ્દમશ્રી વરિયાર
Pralhad Keshav Atre|પ્રહલાદ કેશવ અત્રે
Indira Sant|ઇન્દિરા સંત
Armin van Buuren|આરમીન વન બ્યુરન
Karthika Adaikalam|કાર્તિકા અદિકલમ્
Boris Becker|બોરિસ બેકર
Anna Akhmatova|અન્ના અખ્માતોવા
Jahangir|જહાંગીર
Joe Frazier|જૉઈ ફ્રજિર
Bhimsen Joshi|ભીમસેન જોશી
Alicia Keys|અલિસિયા કીઝ
Steve Forbes|સ્ટીવ ફોર્બ્સ
Devadarshini|દેવદર્શિની
Kamalesh Sharma|કમલેશ શર્મા
Subrahmanyan Chandrasekhar|સુબ્રમણ્યન ચંદ્રશેખર
Imran Khan|ઇમરાન ખાન
Mohan Singh|જનરલ મોહન સિંહ
Hideki Yukawa|હિડેકી યુકાવા
Sarvepalli Radhakrishnan|સર્વપલ્લી રાધાકૃષ્ણન
Bipasha Basu|બિપાશા બાસુ
Nargis|નરગીસ
Robert Downey Jr.|રોબર્ટ ડાઉની, જુનિયર
Dominick Guinn|ડોમિનિક ગિની
Nagarjuna|નાગાર્જુન
Ben Kingsley|બેન કિંગ્‍સલી
Premchand|પ્રેમચંદ
Sovan Chatterjee|સોવન ચેટર્જી
Mickey Rourke|મિકી રૂરકે
Nasreddin|મુલ્લા નસરુદ્દીન
John Ruskin|જોન રસ્કિન
Verghese Kurien|વર્ગીસ કુરિયન
Rani Lakshmibai|રાણી લક્ષ્મીબાઈ
G.H. Hardy|ગૉડફ્રે હારૉલ્ડ હાર્ડિ
Kareena Kapoor|કરીના કપૂર
Mahmud of Ghazni|mhnmd gzn)
Aurobindo Ghosh|શ્રી અરવિંદ
Reggie Johnson|રેગી જોહન્સન
Arundhati Roy|અરુંધતિ રોય
Kiran Desai|કિરણ દેસાઈ
Anna Hazare|અણ્ણા હઝારે
A. C. Bhaktivedanta Swami Prabhupada|એ.સી. ભક્તિવેદાંત સ્વામી પ્રભુપાદ
Tonya Harding|ટોન્યા હાર્ડિંગ
Vasishtha|વસિષ્ઠ
Kelcie Banks|કેલ્સી બેંકો
Sushmita Sen|સુસ્મિતા સેન
Arvind Swamy|અરવિંદ સ્વામી
Kunjikkuttan Thampuran|કિંજિકટ્ટન થામપુરન
Mythili|મિથિલી
Parvathy|પાર્વતી
R. Venkataraman|વેંકટારામન આર
Vivek|વિવેક
Don Bradman|ડોનાલ્ડ બ્રેડમેન
Philip Sidney|PHILIP SIDNEY
Dev Anand|દેવ આનંદ
Travis Walker|ટ્રેવિસ વોલ્કર
Silambarasan Rajendar|સીલમબરસન રાજેન્દ્ર
Amrish Puri|અમરીશ લાલ પુરી
Abu'l-Fazl ibn Mubarak|અબુલ ફઝલ
Rahul Bose|રાહુલ બોસ
Jack McAuliffe|જેક મેકલીફ
Mikao Usui|મિકાઊ ઉસુઊ
Minissha Lamba|મિનિષા લાંબા
Kamal Haasan|કમલ હાસન
Koel Mullick|કોયલ મલ્લિક
Perizaad Zorabian|પેરીજાદ  ઝોરબીયન
Fatima Meer|ફાતિમા મીર
Karisma Kapoor|કરીશ્મા કપૂર
Padma Lakshmi|પદ્મ લક્ષ્મી
Mamata Banerjee|મમતા સોઢા
Meera|મીરાંબાઈ
Ed Koch|એડ કોચ
Shweta Tiwari|શ્વેતા તિવારી
Guru Har Krishan|ગુરુ હરકિશન
Tukaram|સંત તુકારામ
Aurangzeb|ઔરંગઝેબ
Chetana Das|ચેતના દાસ
Abhay Deol|અભય દેઓલ
Gita Dey|ગીતા દિન
Shekhar Kapur|શેખર કપૂર
S. Varalakshmi|એસ. વરલક્ષ્મી
Sunil Gavaskar|સુનીલ ગાવસ્કર
Prithviraj Kapoor|પૃથ્વીરાજ કપૂર
Danny Denzongpa|ડેની ડેન્ઝોંગ્પા
Priyanka Vadra|પ્રિયંકા વાડ્રા
Bharadwaja|ભારદ્વાજ
Valmiki|વાલ્મીકિ
Sachal Sarmast|સચલ સરમસ્ત
Hanumant Singh|હનુમંત સિંહ
Nitai Palit|નીતાઈ પાલિત
Balraj Sahni|બલરાજ સહાની
Bhupen Hazarika|ભુપેન હજારિકા
Vincent R. Impellitteri|વિન્સેન્ટ આર. ઈમ્પેલીટેરી
M. S. Swaminathan|એમ. એસ. સ્વામિનાથન
Ian Botham|ઇયાન બોથમ
Ghazala Javed|ગઝાલા જાવેદ
Sahir Ludhianvi|સાહિર લુધિયાનવી
Arbaaz Khan|અરબાઝ ખાન
Surdas|સૂરદાસ
Rang Avadhoot|રંગ અવધૂત
Vishwa Mohan Bhatt|વિશ્વ મોહન ભટ્ટ
Ramanathan Krishnan|રામાનાથન કૃષ્ણન
Trichur V. Ramachandran|ત્રિચૂર વી. રામચંદ્રન
Amrita Pritam|અમૃતા પ્રિતમ
Sanjeev Kumar|સંજીવ કુમાર
Avika Gor|અવિકા ગોર
Annupamaa|અનુપમા
Madhu Balakrishnan|મધુ બાલક્રિષ્ન
M. G. Sreekumar|એમ. જી. શ્રીકુમાર
Rimi Tomy|રિમી ટોમી
Alphons Joseph|અલફોન્સ જોસેફ
C. J. Kuttappan|સી.જે. કુત્તાપ્પન
Rainer Weiss|રેઇનર વાઇસ
Rajaraja I|raja raja cholan
Jay Vasavada|જય વસાવડા
G. N. Devy|ગણેશ નારાયણદાસ દેવી
Mahesh Bhatt|મહેશ ભટ્ટ
Aftab Shivdasani|આફતાબ શિવદાસાની
Dr. Fahmida Mirza|ફહેમીદા મિર્ઝા
Homai Vyarawalla|હોમાય વ્યારાવાલા
Seema Biswas|સીમા બિસ્વાસ
Mohinder Amarnath|મોહિન્દર અમરનાથ
Murli Manohar Joshi|મુરલી મનોહર જોશી
Sayajirao Gaekwad III|મહારાજા સયાજીરાવ ગાયકવાડ ત્રીજા
Khudiram Bose|ખુદીરામ બોઝ
Ankita Sharma|અંકિતા શર્મા
Amol Palekar|અમોલ પાલેકર
Mahipati|સંત મહિપતિ
Sanjay Manjrekar|સંજય માંજરેકર
Piloo Mody|પીલુ મોદી
Mammootty|મામૂટી
Atul Wassan|અતુલ વાસન
Anwar Agewan|અનવર આગેવાન
Alisha Chinai|આલિશા ચિનોઇ
Mayasura|મયાસુર
Namitha|નમિતા કપૂર
Bharati Krishna Tirthaji|સ્વામી ભારતી કૃષ્ણ તીર્થ
Gary Kirsten|ગૅરી કિર્સ્ટન
Mahendralal Sarkar|ડો. મહેન્દ્રલાલ સરકાર
Śabara|શબર
Sunil Valson|સુનીલ વાલ્સન
Bhakti Thapa|સરદાર ભક્તિ થાપા
Govind Ballabh Pant|ગોવિંદ વલ્લભ પંત
Kamlashankar Trivedi|કમળાશંકર ત્રિવેદી
Kaajal Oza Vaidya|કાજલ ઓઝા-વૈદ્ય
Trisha Krishnan|તૃષા કૃષ્ણન
Chhotubhai Naik|છોટુભાઇ નાયક
Jagdish Joshi|જગદીશ જોષી
Jaymall Parmar|જયમલ્લ પરમાર
Jivram Joshi|જીવરામ જોષી
Jyotindra Dave|જ્યોતીન્દ્ર દવે
|દાસ વાઘો
Dasi Jivan|દાસી જીવણ
Devanand Swami|દેવાનંદ સ્વામી
Nagindas Parekh|નગીનદાસ પારેખ
|પ્રેમ સાહેબ
Barkat Virani|બરકત વીરાણી
|ભક્તિસ્વરૂપ તીર્થ મહારાજ
|મહારાજા ભગવતસિંહજી
Bhagwatikumar Sharma|ભગવતીકુમાર શર્મા
Bharath Reddy|ભરત રેડ્ડી
Bhima I|ભીમદેવ સોલંકી
Bhupesh Adhvaryu|ભૂપેશ અધ્વર્યુ
Raol Shri Dharmakumarsinhji|મ. કુ. શ્રી ધર્મકુમારસિંહજી ગોહિલ
Maninder Singh|મનિન્દર સિંઘ
Mafat Oza|મફત ઓઝા
Muktanand Swami|મુક્તાનંદ સ્વામી
Mulshankar Bhatt|મૂળશંકર ભટ્ટ
Mohanlal Kavi|મોહનલાલ કવિ
Ranjit Patel|રણજિતરામ પટેલ
Rasiklal Parikh|રસિકલાલ પરીખ
|રામ શર્મા આચાર્ય
Ramprasad Bakshi|રામપ્રસાદ બક્ષી
Laxminarayan Vyas|લક્ષ્મીનારાયણ વ્યાસ
Vaghji Ojha|વાઘજી ઓઝા
Vadilal Dagli|વાડીલાલ ડગલી
Vishvamitra|વિશ્વામિત્ર
Shivkumar Joshi|શિવકુમાર જોશી
|શ્રી યોગેશ્વરજી
Tribhuvandas Luhar|સુન્દરમ્
Suresh Joshi|સુરેશ જોષી
|સ્વામી શ્રી સદાશિવ
Hasu Yajnik|હસુ યાજ્ઞિક
Rizwan Khan|રિઝવાન ખાન
Jadu Nath Singh|જદુનાથસિંહ
Ajit Cour|અજિત કૌર
Dilip Sardesai|દિલીપ સરદેસાઈ
Edmond Debeaumarché|એડમંડ Debeaumarché
Uma Bharti|ઉમા ભારતી
Krishna Poonia|discuss throw
Shrikant Jichkar|શ્રીકાંત જિચકાર
Raja Dahir|રાજા દાહિર
T. E. Srinivasan|ટી.ઈ.શ્રીનિવાસન
Najam Sheraz|નજમ શેઝ
Raman Lamba|રમન લાંબા
Samar Das|સમર દાસ
Subhash Mukhopadhyay|સુભાષ મુખોપાધ્યાય
Bhupendranath Datta|ભૂપેન્દ્રનાથ દત્ત
Debashree Roy|દેબશ્રી રોય
Bana Singh|બાના સિંઘ
Raghunath Manet|રઘુનાથ માનેત
Bhanumathi Ramakrishna|ભાનુમતી રામકૃષ્ણ
Viveka Babajee|વિવેકા બાબાજી
K. B. Hedgewar|કે. બી. હેડગેવાર
Jan Nisar Akhtar|જાન નિસાર અખ્તર
N. T. Rama Rao Jr.|એન ટી ટી રામા રાવ જુનિયર
Raghuvaran|રઘુવરન
Roja|રોજા
Ramachandra Guha|રામચંદ્ર ગુહા
Thamarai|થામરાય
Suresh Menon|સુરેશ મેનન
Padmapriya Janakiraman|પદ્મપ્રિયા જનકીરામન
Prathap K. Pothan|પ્રથપ કે પોથન
Venkatapathy Raju|વ્યંકટપતિ રાજુ
Harini|હરિની
S. P. B. Charan|એસ.પી.બી.ચરણ
Renuka Menon|રેણુકા મેનન
Bharathidasan|ભારતીદાસન
Pooja Umashankar|પૂજા ઉમાશંકર
Janaki Ramachandran|જાનકી રામચંદ્રન
Siddheshwari Devi|સિદ્ધેશ્વરી દેવી
Purushottam Laxman Deshpande|પુરુષોત્તમ લક્ષ્મણ દેશપાંડે
Amar Kant|અમરકાંત
Meenakshi Seshadri|મીનાક્ષી શેષાદ્રી
Samyuktha Varma|સંયુક્ત વર્મા
Ram Sharan Sharma|રામ શરણ શર્મા
S. K. Pottekkatt|પોટટેકટ્ટ એસ. કે
Ramaswamy Parameshwaran|રામાસ્વામી પરમેશ્વરન
Akhlaq Mohammed Khan|અખલાક મોહમ્મદ ખાન
Machan Varghese|મચન વર્ગીઝ
E. Ahamed|ઈ અહમદ
Kavalam Madhava Panikkar|કવલમ માધવ પાણિકર
Pritish Nandy|પ્રીતિશ નંદી
Hiren Bhattacharyya|હિરેન ભટ્ટાચાર્ય
Birendra Kumar Bhattacharya|બિરેન્દ્રકુમાર ભટ્ટાચાર્ય
Ekta Kapoor|એકતા કપૂર
Nida Fazli|નિદા ફાઝલી
Rahul Vaidya|રાહુલ વૈદ્ય
Durga Charan Mohanty|દુર્ગા ચરણ મોહંતી
Parveen Sultana|પ્રવીણ સુલતાના
Raghuvir Sahay|રઘુવીર સહાય
Kaka Hathrasi|કાકા હાથરસી
M. C. Chagla|એમ. સી. ચાગલા
Rajiv Dixit|રાજીવ દિક્ષીત
Ramdev Pir|રામદેવપીર
Amanat Ali Khan|અમાનત અલી ખાન
Durga Bhagwat|દુર્ગા ભાગવત
T. G. Kamala Devi|ટી.જી. કમલા દેવી
Makhdoom Mohiuddin|મખદૂમ મોહિઉદ્દીન
Mastani|મસ્તાની
Vidup Agrahari|વિદુપ અઘારી
Madhav Shrihari Aney|માધવ શ્રીહરિ આને
Haribhadra|આચાર્ય હરિભદ્ર
Abhijeet Sawant|અભિજિત સાવંત
James Eights|જેમ્સ એઈટ્સ
Sankar|શંકર
A. L. Raghavan|એ. એલ. રાઘવન
A. N. Murthy Rao|એ. એન. મૂર્તિરાવ
Aamna Sharif|આમના શરીફ
Aanaahad|આનાહદ
Aditi Sharma|અદિતિ શર્મા
Adolfo Figueroa-Viñas|એડોલ્ફો ફિગ્યુરોઆ-વીઆસ
Sung Jae-gi|સેઓંગ જેઇ-જીઆઇ
Ajay Ahuja|અજય આહુજા
Amala Shankar|અમલા શંકર
Amar Mitra|અમર મિત્રા
Ammtoje Mann|અમમ્ટોજે માન
Amole Gupte|અમોલ ગુપ્તે
Anaitha Nair|અનાથ નાયર
Anand Krishnamoorthi|આનંદ કૃષ્ણમૂર્તિ
Andre Delbecq|આન્દ્રે ડેલબેક
Angad Bedi|અંગદ બેદી
Anju Ghosh|અંજુ ઘોષ
Arjun Charan Sethi|અર્જુન ચરણ સેઠી
Arjun Ram Meghwal|અર્જુન રામ મેઘવાલ
Asghar Ali Engineer|અસગર અલી એન્જીનિયર
Ashok Agarwal|અશોક અગ્રવાલ
Astad Deboo|અસ્તાદ દેબુ
B. Jayant Baliga|બી જયંત બલિગા
Babubhai J. Patel|બાબુભાઈ જશભાઈ પટેલ
Bani Basu|bani basu
Barry Stevens|બેરી સ્ટીવેન્સ
Bharatsinhji Dabhi|ભરતસિંહજી ડાભી
Bhikhari Thakur|ભિખારી ઠાકુર
Bill de Blasio|બીલ દે બ્લાઝીઓ
Boora Narsaiah Goud|બુર્રા નરસય્યા
C. P. Joshi|સી.પી.જોશી
Chandrakant Pandit|ચંદ્રકાંત પંડિત
Charles Edward Stevens|ચાર્લ્સ એડવર્ડ સ્ટીવેન્સ
Charles R. Pellegrino|ચાર્લ્સ આર. પેલેગ્રિનો
Chris Mack|ક્રિસ મેક
Dan Massey|ડેન મેસી
Daniel Bernardi|ડેનિયલ બર્નાર્ડી
Darshana Jardosh|દર્શન જારદોશ
David C. Baldus|ડેવિડ સી. બાલ્ડસ
Deepak Adhikari|દેવ (દીપક અધિકારી)
Dilip Joshi|દિલીપ જોશી
Dina Pathak|દીના પાઠક
Frank Anthony|H.P.Modi representative of parsi community
Harilal Upadhyay|હરિલાલ ઉપાધ્યાય
Harish Khare|હરીશ ખરે
Ignace Tirkey|ઈગ્નસ તિર્કિ
Dilip Patel|દિલીપ પટેલ
Jeppiaar|જેપ્પિયાર
Jyoti Dhurve|જ્યોતિ ધુર્વે
Kadu Makrani|કાદુ મકરાણી
Kailash Chandra Meghwal|કૈલાશ ચંદ્ર મેઘવાલ
Kamini Kaushal|કામિની કૌશલ
Karna|કર્ણદેવ સોલંકી
Kedarnath Agarwal|કેદારનાથ અગ્રવાલ
Kiran Kumar|કિરણ કુમાર
Kirti Vardhan Singh|કીર્તિવર્ધન સિંહ
Kunal Ganjawala|કુણાલ ગાંજાવાલા
Kunwar Sarvesh Kumar Singh|કુંવર સર્વેશ કુમાર
Lakshman Madhav Katre|લક્ષ્મણ માધવ કટ્રે
Lakshman Shastri Joshi|લક્ષ્મણશાસ્ત્રી જોશી
Sarvepalli Gopal|સર્વપલ્લી ગોપાલ
M. B. Rajesh|એમ૰બી૰ રાજેશ
Madhukar Vasudev Dhond|મધુકર વાસુદેવ ધોંડ
Manubhai Mehta|મનુભાઇ મહેતા
Manubhai Shah|મનુભાઇ શાહ
Matangini Hazra|માતંગિની હઝરા
Mehboob Ali Kaiser|ચૌધરી મહબૂબ અલી કૈસર
Melanmai Ponnusamy|મેલણમઈ પોન્નુસામી
Minoti Desai|મીનોતી દેસાઈ
Mohammad Akram|મોહમ્મદ અક્રમ
Mohammad Aslam|મોહમ્મદ અસ્લામ
Mohammad Ayub Dogar|મોહમ્મદ આયુબ ડોગર
Mohammad Munaf|મોહમ્મદ મુનાફ
Mohan Chand Sharma|મોહન ચંદ શર્મા
Mokhadaji Gohil|મોખડાજી ગોહિલ
Muhammed Metha|મુહમ્મદ મેથા
Munshi Nawal Kishore|મુન્શી નવલ કિશોર
Nabaneeta Dev Sen|નવનીતા દેવસેન
Nandanar|પી. સી. ગોપાલન
Nandini Nimbkar|નંદિની નિમ્બકર
Naranbhai Kachhadia|કછાડ઼િયા નારનભાઈ ભીખાભાઈ
Narayan Singh Bhati|નારાયણસિંહ ભાટી
Naresh Kanodia|નરેશ કનોડિયા
Nasiruddin Chiragh Dehlavi|નસીરુદ્દીન ચિરાઘ દહેલવી
Nathuram Sharma|નથુરામ શર્મા
Nautamlal Bhagavanji Mehta|નૌતમલાલ ભગવાનજી મહેતા
Nileena Abraham|નિલિના અબ્રાહમ
Nongthombam Biren Singh|એન. બિરેન સિંઘ
Om Prakash Yadav|ઓમ પ્રકાશ યાદવ
Prem Singh Chandumajra|પ્રેમ સિંહ ચન્દૂમાજરા
Premchand Roychand|પ્રેમચંદ રાયચંદ
Radha Mohan Singh|રાધા મોહન સિંહ
Rajat Sharma|રજત શર્મા
Ramesh C. Deka|રમેશ સી. ડેકા
Ravishankar Raval|રવિશંકર રાવળ
Sagarika Ghatge|સાગરિકા ઘાટગે
Sarita Joshi|સરિતા જોશી
Shivaji Adhalrao Patil|અધલરાવ શિવાજી દત્તાત્રેય
Subrata Bakshi|સુબ્રત બક્શી
Sumitra Mahajan|સુમિત્રા મહાજન
Swami Anand|સ્વામી આનંદ
T. S. Kanaka|ટી.એસ.કાનાકા
Upendra Trivedi|ઉપેન્દ્ર ત્રિવેદી
Vibha Tripathi|વિભા ત્રિપાઠી
Vidyaben Shah|વિદ્યાબેન શાહ
Vijay Salaskar|વિજય સાલસકર
Vijay Rupani|વિજય રૂપાણી
Yami Gautam|યામી ગૌતમ
Zorawar Chand Bakhshi|ઝોરાવર ચંદ બક્ષી
R. Arokiaraj|આર.અરોકિયારાજ
Sangolli Rayanna|સંગોલી રાયન્ના
Paul Cheema Singh|પૌલ ચીમા સિંઘ
Indulal Yagnik|ઇન્દુલાલ યાજ્ઞિક
Nellai S. Muthu|નેલ્લાઇ એસ મુથુ
Mahebub Desai|મહેબૂબ દેસાઈ
Bapusaheb Gaekwar|બાપુસાહેબ યશવંતરાવ ગાયકવાડ
N. K. Premachandran|એન૰કે૰ પ્રેમચન્દ્રન
|પ્રભુલાલભાઇ દવે
Narayan Hemchandra|નારાયણ હેમચંદ્ર
Dasi Jivan|સર્જક:દાસી જીવણ
Mary Leela Rao|મેરી લીલા રાવ
K. Venkatalakshmma|કદુર વેંકટાલક્ષ્મમ્
Hardit Malik|હરદિત મલિક
Santosh Ahlawat|સંતોષ અહલાવત
Jai Kishan Das|જય કિશન દાસ
Ramesh Bidhuri|રમેશ બિધૂડ઼ી
Udayanraje Bhosale|ઉદયનરાજે ભોસલે
D. K. Suresh|ડી૰કે૰ સુરેશ
Pratiksha Santosh Shinde|પ્રતિક્ષા સંતોષ શિંદે
Mansinh Patel|માનસિંહ પટેલ
Sanjay Haribhau Jadhav|સંજય હરિભાઊ જાધવ
Ashwin Mahesh|અશ્વિન મહેશ
Ragini Shah|રાગિણી શાહ
Savitri Bai Phule|સાવિત્રી બાઈ ફુલે
Bhola Singh|ભોલા સિંહ
Jam Rawal|જામ રાવલ
Rameswar Teli|રામેશ્વર તેલી
Kanwar Singh Tanwar|કઁવર સિંહ તંવર
Arpita Ghosh|અર્પિતા ઘોષ
Bidyut Baran Mahato|બિદ્યુત બરન મહતો
Bijoy Chandra Barman|બિજય ચન્દ્ર બર્મન
Harinder Singh Khalsa|હરિંદર સિંહ ખાલસા
Idris Ali|ઇદરિસ અલી
Janak Ram|જનક રામ
Kothapalli Geetha|કોત્તપલ્લી ગીતા
Mamtaz Sanghamita|મમતાજ઼ સંઘમિતા
Sirajuddin Ajmal|સિરાજુદ્દીન અજમલ
Tasleem Uddin|તસ્લીમુદ્દીન
Alok Sanjar|આલોક સંજર
Manohar Untwal|મનોહર ઉંટવાલ
Manshankar Ninama|માનશંકર નિનામા
Rama Chandra Hansdah|રામ ચન્દ્ર હંસદા
Subhash Patel|સુભાષ પટેલ
Rabindra Kumar Jena|રબિન્દ્ર કુમાર જેના
V. Elumalai|વી૰ એલુમલૈ
B. Senguttuvan|બી૰ સેનગુટ્ટુવન
P Nagarajan|પી૰ નાગરાજન
A. Anwhar Raajhaa|એ૰અનવર રાજા
R. K. Bharathi Mohan|ભારતી મોહન આર૰કે૰
Nagendra Singh|નાગેન્દ્ર સિંહ
Virendra Singh|વીરેન્દ્ર સિંહ
Vinod Kumar Sonkar|વિનોદ કુમાર સોનકર
Dasrath Tirkey|દસરથ ટિર્કી
Kanu Desai|કનુ દેસાઈ
Apurvi Chandela|અપૂર્વી ચંદેલા
Rachana Parulkar|રચના પારુલકર
Sarada Charan Das|સારદા ચરણદાસ
Mohit Sharma|મોહિત શર્મા (સૈનિક)
Makar Dhwaja Darogha|મકર ધ્વાજા દરોઘા
Saswat Joshi|સાસ્વત જોશી
Gopal Prasad Dubey|ગોપાલ પ્રસાદ દુબે
Chhel Vayeda|છેલ વાયડા
Maneknath|માણેકનાથ
Lavkumar Khachar|લવકુમાર ખાચર
Sanat Mehta|સનત મહેતા
Hiranand Sastri|હીરાનંદ શાસ્ત્રી
V Kalyanam|વી. કલ્યાણમ
Kapil Mohan|કપિલ મોહન
Mohammad Mankad|મોહમ્મદ માંકડ
|પ્રાણલાલ પટેલ
Hardik Pandya|હાર્દિક પંડ્યા
Ajit Merchant|અજિત મર્ચન્ટ
|કલ્યાણરાય ન. જોષી
Yogeshwar|યોગેશ્વર
Bharata|ભરત
Dhruv Bhatt|ધ્રુવ ભટ્ટ
Madan M. Rehani|મદન એમ. રેહાની
Johann Georg Kant|જ્હોન જ્યોર્જ કેન્ટ
Bharmalji II|ભારમલજી દ્વિતીય
Mangala Narlikar|મંગલા નારલીકર
Vojtech H. Lindtner|Vojtech H. Lindtner
Pragmalji I|પ્રાગમલજી પ્રથમ
Philipp Wobeto|Philipp Wobeto
Yogesh Joshi|યોગેશ જોષી
Sonia Fisch-Muller|Sonia Fisch-Muller
Nathuram Sharma|નથુરામ શર્મા
Phoolchand Gupta|ફૂલચંદ ગુપ્તા
Hangpan Dada|હંગપન દાદા
Jignesh Mevani|જિગ્નેશ મેવાણી
Laurent Vallotton|Laurent Vallotton
Thandava Murthy Muthu|થંડવા મૂર્તિ મુથુ
Viva Harsha|વિવા હર્ષા
John Hollier|John Hollier
Sharda Mehta|શારદા મહેતા
Praful Raval|પ્રફુલ્લ રાવલ
Arjan Hasid|અર્જન હાસિદ
Dionisio García Cortázar|Dionisio García Cortázar
Máximo Cánovas del Castillo|Máximo Cánovas del Castillo
Ashokpuri Goswami|અશોકપુરી ગોસ્વામી
Ratilal 'Anil'|રતિલાલ 'અનિલ'
Vinesh Antani|વિનેશ અંતાણી
|ઓસમાણ મીર
Lilavati Joshi|લીલાવતી જોષી
Tito Dutta|ટીટો દત્તા
Nirmala Wadhwani|નિર્મલા વાધવાની
Sudhir Chandra|સુધીર ચંદ્ર
|મેરુભા ગઢવી
Nandkunvarba|નંદકુંવરબા
Khalil Dhantejvi|ખલીલ ધનતેજવી
Mary Fenton|મેરી ફેન્ટન
Sarita Gayakwad|સરિતા ગાયકવાડ
Greta Thunberg|ગ્રેટા થનબર્ગ
Qutb al-Din al-Safawi|કુતુબ અલ-દીન અલ-સફાવિ
Madhurika Pradyumn Desai|મધૂરીકા પ્રદ્યુમ્ન દેસાઈ
Geeta Parikh|ગીતા પરીખ
Sejal Kumar|સેજલ કુમાર
Jawahar Bakshi|જવાહર બક્ષી
Deepakba Desai|દીપકબા દેસાઈ
Priyabala Shah|પ્રિયબાળા શાહ
Bhushan Ramkrishan Gavai|ભૂષણ રામકૃષ્ણ ગવઈ
Rameshbhai Dhaduk|રમેશભાઈ ધડુક
Hasmukh Patel|હસમુખ પટેલ
Govind Swaminadhan|ગોવિંદ સ્વામીનાથન
Omer Šipraga|ઓમર સિપ્રગા
Razia Sheikh|રઝિયા શેખ
Vanessa Mark|Vanessa Mark
Alexander Bernardi|Alexander Bernardi
Vijaygiri Bava|વિજયગીરી બાવા
Betty Diamond|બેટી ડાયમંડ
Prabodh Parikh|પ્રબોધ પરીખ
Uttamlal Trivedi|ઉત્તમલાલ ત્રિવેદી
Bharati Shelat|ભારતી શેલત
Olivia Araujo|Olivia Araujo
Sanjay Chaudhary|સંજય ચૌધરી
Shankarlal Parikh|શંકરલાલ પરીખ
Victor Povzner|Victor Povzner
Mantas Januskevicius|Mantas Januskevicius
Bolivar Espinosa|Bolivar Espinosa
Mattija Lojen|Mattija Lojen
Jayant Meghani|જયંત મેઘાણી
Joanne Cavill|Joanne Cavill
Beata Jasińska|Beata Jasińska
Olga Mikhailoyskaia|Olga Mikhailoyskaia
Els Bauden|Els Bauden
Sabrina Arhab|Sabrina Arhab
Cecilia Bäckstedt|Cecilia Bäckstedt
Ishwarlal R. Dave|ઈશ્વરલાલ રતિલાલ દવે
Iulian Oprea|Iulian Oprea
Leon Felderer|Leon Felderer
Cezara Curmei|Cezara Curmei
Roberts Plūme|Roberts Plūme
Ashok Meghani|અશોક મેઘાણી
Erica Voss|Erica Voss
Julia Słupecka|Julia Słupecka
Eric Fantazzini|Eric Fantazzini
Arnis Bebrišs|Arnis Bebrišs
Taylor Lawrence|Taylor Lawrence
Cédric Follador|Cédric Follador
Gopaldas Jivabhai Patel|ગોપાળદાસ જીવાભાઈ પટેલ
Erik Schmidt|Erik Schmidt
William Shakespeare|વિલિયમ શેક્સપીયર
Aristotle|એરિસ્ટોટલ
Bruno Mars|બ્રુનો માર્સ
Giridharilal Kedia|ગિરધરીલાલ કેડિયા
Anton Chekhov|એન્તોન ચેખવ
Marco Polo|માર્કો પોલો
Niels Bohr|નીલ્સ બૉહર
Rabindranath Tagore|રવિન્દ્રનાથ ટાગોર
Ashoka|અશોક
Euclid|યુક્લિડ
Chanakya|ચાણક્ય
Aryabhata|આર્યભટ્ટ
Vinoba Bhave|વિનોબા ભાવે
Hu Jintao|હુ જિન્તાઓ
Shrimad Rajchandra|શ્રીમદ્ રાજચંદ્ર
Skrillex|સ્ક્રિલ્લેક્સ
Alfred Nobel|આલ્ફ્રેડ નોબેલ
Mother Teresa|મધર ટેરેસા
K. Chandrashekar Rao|કલ્વાકુંતલા ચંદ્રશેખર રાવ
Pablo Neruda|પાબ્લો નેરુદા
Rudyard Kipling|રુડયાર્ડ કિપલિંગ
Frank Sinatra|ફ્રેન્ક સિનાત્રા
Beulah Louise Henry|બ્યૂલા લૂઇસ હેનરી
Manmohan Singh|મનમોહન સિંહ
Heinrich Himmler|હિમલર હેનરિક
The Great Khali|ધ ગ્રેટ ખલી
Alex Ferguson|એલેક્સ ફર્ગ્યુસન
Kahlil Gibran|ખલીલ જિબ્રાન
Sudha Chandran|સુધા ચંદ્રન
Gajah Mada|ગજહ મદ
Raj Kapoor|રાજ કપૂર
Sarojini Vaidya|સરોજની વૈદ્ય
Ramabai Ranade|રમાબાઈ રાનડે
Jigme Khesar Namgyel Wangchuck|જિગ્મે ખેસર નામગ્યાલ વાંગચુક
Vikram Prabhu|વિક્રમ પ્રભુ
Qurratulain Hyder|કુર્અતુલ
Narahar Raghunath Phatak|નરહર રઘુનાથ ફાટક
Michael Simms|માઇકલ સિમ્સ
Narain Karthikeyan|નારાયણ કાર્તિકેયન
Karl Landsteiner|કાર્લ લેન્ડસ્ટેઇનર
Eric Schmidt|એરિક શ્મિટ
Larry Ellison|લેરી એલિસન
Sergey Brin|સેર્ગેઈ બ્રિન
Tulsi Chakraborty|તુલસી ચક્રબોરટી
King Levinsky|કિંગ લેવિન્સકી
Philip II of Macedon|મેસેડોનના ફીલીપ દ્વીતિય
Anna Kournikova|અન્ના કુર્નિકોવા
C. N. Annadurai|સી એન. અન્નાદુરે
Cheteshwar Pujara|ચેતેશ્વર પુજારા
Sain Zahoor|સૈન ઝહૂર
Zohra Sehgal|ઝોહરા સહેગલ
Ajay Devgn|અજય દેવગણ
Kajol|કાજોલ
Pat Buchanan|પેટ બ્યુકેનન
Tamannaah|તમન્નાહ ભાટિયા
Mohammed Rafi|મોહમ્મદ રફી
Louis Mountbatten|ગુજરાતી
Bindu|બિંદુ દેસાઈ ઝવેરી
Francis Xavier|ફ્રાન્સિસ ઝેવિયર
Vijay Mallya|વિજય માલ્યા
Jayant Vishnu Narlikar|જયન્ત વિષ્ણુ નાર્લીકર
Jerry Page|જેરી પેજ
Bharata Muni|ભરત મુનિ
Virat Kohli|virat kohli
George Foreman|જ્યોર્જ ફોરમેન
John David Jackson|જ્હોન ડેવિડ જેક્સન
Kenneth Gould|કેનેથ ગોલ્ડ
Cleopatra of Macedon|મેસેડોનની ક્લીઓપેટ્રા
Kate Upton|કેટ અપટોન
K.J. Noons|કે જે નૂન્સ
James Boyd|જેમ્સ બોય્ડ
Sai Baba of Shirdi|સાંઇબાબા
Sunny Leone|સન્ની લિઓન
Maurice Blocker|મૌરિસ બ્લોકર
Mayawati|માયાવતી
Sadam Ali|સદામ અલી
Indra Nooyi|ઈન્દ્રા નૂયી
Navjot Singh Sidhu|નવજોત સિધ્ધુ
Jackie Frazier-Lyde|જેકી ફ્રેઝીઅર-લિડે
Geetha|ગીતા
Prabhu Ganesan|પ્રભુ ગણેશન
Shankar Panikkar|શંકર પાણિકર
Revathi|રેવાથી
Oscar De La Hoya|ઓસ્કર ડે લા હોય
Aaron Swartz|એરન સ્વાર્ટઝ
Kanishka|કનિષ્ક
Shakti Kapoor|શક્તિ કપૂર
Suryavarman II|સૂર્યવર્મન દ્વિતીય
Abe Attell|અબે અટેલ
F.X. Toole|એફ.એક્સ. ટોલ
Fres Oquendo|ફ્રેસ ઓક્વેન્ડો
Suraj Sharma|સૂરજ શર્મા
Abraham Beame|એબ્રાહમ બીમ
Abraham K. Thampy|અબ્રાહમ કે. થેમ્પી
James Tillis|જેમ્સ ટીલિસ
Marvin Johnson|માર્વિન જોહન્સન
Beau Jack|બે જેક
Ratan Tata|રતન તાતા
Sadiq Khan|સાદિક ખાન
Dhirendra Nath Ganguly|ધીરેન્દ્ર નાથ ગાંગુલી
Barthélemy Boganda|બાર્થોલોમ્યુ બોગાન્ડા
Sooraj R. Barjatya|sooraj r barjatiya
Mehmood Ali|મહમુદ અલી
Dino Morea|દીનો મોરેયા
Dilip Kumar|દિલીપ કુમાર
Vainu Bappu|venu bapu
Anil Ambani|અનિલ અંબાણી
Sushruta|સુશ્રુત
Saya Tin|સાયા ટીન
Phani Sarma|ફની સરમા
Surinder Kaur|સુરિન્દર કૌર
Amrit Kaur|રાજકુમારી અમૃત કૌર
Lhakpa Tsamchoe|લહાકપા તસંચોએ
Jwala Gutta|જ્વાલા ગુત્તા
Daler Mehndi|દલેર મહેંદી
Aparna Popat|અપર્ણા પોપટ
Nafisa Joseph|નફીસા જોસેફ
Lal Krishna Advani|લાલકૃષ્ણ આડવાણી
Chester Carlson|ચેસ્ટર કાર્લસન
Jayam Ravi|જયમ રવિ
Vijender Singh|વિજેન્દર સિંઘ
Karthika Mathew|કાર્તિક માથેવ
V. O. Chidambaram Billai|વી. ઓ. ચિદમ્બરમ પિલ્લઈ
Dasaratha Maurya|દશરથ મૌર્ય
M. L. Vasanthakumari|એમ.એલ. વસંથકુમારી
Dilip Chitre|દિલીપ ચિત્રે
Namrata Shirodkar|નમ્રતા શિરોડકર
Asaf Ali|અસફ અલી
Jagannathan|જગન્નાથન
Mulk Raj Anand|મુલ્ક રાજ આનંદ
Devdas Gandhi|દેવદાસ ગાંધી
Steve Waugh|સ્ટીવ વોઘ
Archana Jose Kavi|અર્ચના જોસ કવિ
Neha Sharma|નેહા શર્મા
Sheikh Muhammad Abdullah|શેખ અદુલ્લા
Nisha Ganatra|નિશા ગણાત્રા
Vikramaditya|વિક્રમાદિત્ય
Kamal Nath|કમલનાથ
Sunil Gangopadhyay|સુનિલ ગંગોપાધ્યાય
Sivaji Ganesan|શિવાજી ગણેશન
Uttam Kumar|ઉત્તમ કુમાર
Satish Shah|સતીશ શાહ
Vallabhsuri|વલ્લભસૂરી
Neminatha|નેમિનાથ
Joginder Jaswant Singh|જોગિન્દર જસવંત સિંઘ
Raja Rao|રાજા રાવ
Heeba Shah|હીબા શાહ
Bhāsa|ભાસ
Vinod Khanna|વિનોદ ખન્ના
Achu Rajamani|અચૂ રાજમાની
Ranjith|રંજીથ
P. Madhuri|પી. માધુરી
S. Janaki|એસ.જાનકી
Vani Jairam|વાણી જયરામ
Rajesh Pawar|રાજેશ પવાર
Prateik Babbar|પ્રતીક પાગલ
Rajneesh Duggal|રજનીશ દુગ્ગલ
Nana Patekar|નાના પાટેકર
Tove Torvalds|ટોવે ટોરવાલ્ડ્સ
Vijay Mehra|વિજય મેહરા
William Jay Gaynor|વિલિયમ જે ગેનોર
Rati Agnihotri|રતિ અગ્નિહોત્રી
Shri Guru Ravidass|સંત રવિદાસ
Parashara|પરાશર
Srabanti Chatterjee|શ્રીબંતી ચેટર્જી
Ilaiyaraaja|ઇલીયારાજા
Gautam Gambhir|ગૌતમ ગંભીર
Uday Merchant|ઉદય મર્ચંટ
Jalaram Bapa|જલારામ બાપા
Sameer Dighe|સમીર દિઘે
Ami Vashi|અમી વશી
Radhanath Swami|રાધાનાથ સ્વામી
Upasni Maharaj|ઉપાસની મહારાજ
Merv Hughes|મર્વ હ્યુજ
Surinder Amarnath|સુરિન્દર અમરનાથ
Suresh Dalal|સુરેશ દલાલ
|આશિત દેસાઈ
Nasir Ismaili|ઈસ્માઈલી નશીરૂદ્દીન
Urvish Kothari|ઉર્વીશ કોઠારી
Syed Kirmani|સૈયદ કિરમાણી
Karsandas Manek|કરસનદાસ માણેક
Gijubhai Badheka|ગિજુભાઈ બધેકા
Chandrakant Sheth|ચંદ્રકાન્ત શેઠ
Buddhadeb Dasgupta|બુદ્ધદેવ દાસગુપ્તા
Aarya Babbar|આર્ય બબ્બર
C. N. Patel|ચીમનભાઇ પટેલ
Chetan Chauhan|ચેતન ચૌહાણ
Chhotubhai Purani|છોટુભાઈ પુરાણી
Jayant Kothari|જયંત કોઠારી
Jaishankar Bhojak|જયશંકર સુંદરી
Dilip Vengsarkar|દિલિપ વેંગસારકર
Dhansukhlal Mehta|ધનસુખલાલ મહેતા
Dhiru Parikh|ધીરુ પરીખ
|નટવરલાલ સુરતી
Nalin Raval|નલિન રાવળ
|નવનીત મદ્રાસી
Navalram Trivedi|નવલરામ ત્રિવેદી
Niranjan Varma|નિરંજન વર્મા
Nirupa Roy|નિરુપા રોય
|પ્રભાતદેવજી
|પ્રભાશંકર માસ્તર
Prahlad Parekh|પ્રહલાદ જેઠાલાલ પારેખ
|પ્રહલાદ શાસ્ત્રી
|પ્રાગજી ભગત
Priyakant Maniyar|પ્રિયકાંત મણિયાર
Carlos G. Vallés|ફાધર વાલેસ
Bhupat Vadodaria|ભૂપતભાઇ વડોદરિયા
Bhupendra Trivedi|ભૂપેન્દ્ર ત્રિવેદી
Bhogilal Sandesara|ભોગીલાલ સાંડેસરા
Shivbhadrasinhji Gohil|શિવભદ્રસિંહ ગોહિલ
Madhu Rye|મધુ રાય
Manoj Prabhakar|મનોજ પ્રભાકર
Minoo Adenwalla|મીનું એડનવાળા
|મુકેશ અમૃતલાલ આચાર્ય
Yashwant Pandya|યશવંત પંડ્યા
Yogendra Vyas|યોગેન્દ્ર વ્યાસ
Ratilal Rupawala|રતિલાલ રૂપાવાળા
Ramanlal Vasantlal Desai|રમણલાલ દેસાઈ
Ramjibhai Kadiya|રામજીભાઈ કડિયા
Vinod Adhvaryu|વિનોદ અધ્વર્યુ
|શાહ જમશેદજી
Shivlal Dhaneshwar Kavi|શિવલાલ કવિ
|શ્રી નાથજીદાદા - દાણીધાર
Shweta Bachchan Nanda|શ્વેતા નંદા
|સિતાંશુ મહેતા
Hitu Kanodia|હિતુ કનોડિયા
Adrian Barath|એડ્રીયન બરાથ
Allan Sealy|ઍલન સીલી
B.C. Nirmal|બી.સી. નિર્મલ
Eknath Solkar|એકનાથ સોલ્કર
José Luis Álvarez Álvarez|José Luis Álvarez
Nazia Hassan|નાઝિયા હસન
Somnath Chatterjee|સોમનાથ ચેટર્જી
D. R. Bendre|દત્તાત્રેય રામચંદ્ર બેન્દ્રે
Mohammad Azharuddin|મોહમ્મદ અઝહરુદ્દીન
Virender Sehwag|વિરેન્દ્ર સેહવાગ
Shaan|SHAAN
Chuni Goswami|ચુની ગોસ્વામી
Tarasankar Bandyopadhyay|તારાશંકર બંદોપાધ્યાય
Ajitanatha|અજિતનાથ
Geet Sethi|ગીત સેઠી
Krant M. L. Verma|ક્રન્ટ એમ. એલ. વર્મા
Vasundhara Das|વસુંધરા દાસ
Farokh Engineer|ફારુખ એન્જીનિયર
Ramasamy Vairamuthu|રામાસમી વૈરામુથુ
Neelamana Madhavan Nampoothiri|નીલમણા માધવન નમપુથિરી
Bhadriraju Krishnamurti|ભદ્રિરાજુ કૃષ્ણમૂર્તિ
Loose Mohan|લુસ મોહન
Udhayanidhi Stalin|ઉધયાનિધિ સ્ટાલિન
Surendranath|સુરેન્દ્રનાથ
Priya Gill|પ્રિયા ગિલ
Suresh Gopi|સુરેશ ગોપી
Subramanian Swamy|સુબ્રમણ્યમ સ્વામી
Anu Hasan|અનુ હસન
Aditi Gowitrikar|અદિતિ ગોવિત્રીકર
Anjala Zaveri|અંજલા ઝવેરી
Sivakarthikeyan|શિવકાર્તિકેયન્
Pravin Amre|પ્રવિણ આમરે
Sripriya|શ્રીપ્રિયા
Sibiraj|સિબીરાજ
Piyush Mishra|પિયુષ મિશ્રા
J. P. Chandrababu|જે.પી.ચંદ્રબાબુ
Vidyut Jamwal|વિદ્યુત જામવાલ
Ashutosh Rana|આશુતોષ રાણા
Hemant Karkare|હેમંત કરકરે
Prithviraj Sukumaran|પૃથ્વીરાજ સુકુમારન
Ghulam Ali|ગુલામ અલી
Nimmi|નિમ્મી
N. S. Madhavan|એન.એસ.માધવન
Rama Raghoba Rane|રામ રાઘોબા રાણે
I. M. Vijayan|આઈ.એમ.વિજયન
Aditya Shrivastava|આદિત્ય શ્રીવાસ્તવા
Raj Babbar|રાજ બબ્બર
Dhanya Mary Varghese|ધન્યા મેરી વાઘરસિ
Zubeen Garg|ઝુબેન ગર્ગ
Bal Gandharva|બાલ ગાંધર્વ
Swami Ramanand Tirtha|swami ramanand tirtha
Bhoja|raja bhoj
Arun Krushnaji Kamble|અરુણ કૃષ્ણજી કુંબલે
Lachit Borphukan|લચિત બોરફૂકન
Gopinath Munde|ગોપીનાથ મુંડે
Mehr Lal Soni Zia Fatehabadi|મેહર લાલ સોની ઝીયા ફતેહાબાદી
KK|કે.કે.
Uddhav Thackeray|ઉદ્ધવ ઠાકરે
Harishankar Parsai|હરિશંકર પરસાઈ
Malkit Singh|મલકીત સિંહ
Sujan Singh|સુજાન સિંહ
Aarya Ambekar|આર્ય અંબેકર
Dasaradhi|દાશરથિ
Ashok Kumar|અશોક કુમાર
Pooja Chopra|પૂજા ચોપરા
Ardolph L. Kline|આરડોલ્ફ એલ. ક્લાઈન
Shaikh Inayat Allah Kamboh|શેખ એનાયત અલ્લાહ કમ્બોહ
Richard Warren Shorthill|રિચાર્ડ વોરેન શોર્ટિલ
A. R. Krishnashastry|એ. આર. કૃષ્ણશાસ્ત્રી
Accamma Cherian|અકમ્મા ચેરિયન
Adam Steltzner|એડમ સ્ટેલ્ટ્ઝનર
Adhir Ranjan Chowdhury|અધીર રંજન ચૌધરી
Aishwarya Majmudar|ઐશ્વર્યા મજમુદાર
Akhlesh Lakhtakia|અખલેશ લખટકિયા
Alexander H. Flax|એલેક્ઝાંડર એચ. ફ્લેક્સ
Alvin Boyd Kuhn|એલ્વિન બાયડ કુહ્ન
Amit Jethwa|અમિત જેઠવા
Amit Shah|અમિત શાહ
Amit Varma|અમિત વર્મા
Amrita Patel|અમૃતા એચ. પટેલ
Anandrao Vithoba Adsul|આનંદરાવ વિઠોબા અડસુલ
Anant Geete|અનન્ત ગીતે
Ananth Kumar|અનંત કુમાર
Anthony Cerami|એન્થોની સેરામી
Anto Antony|એંટો એંટની
Anurag Thakur|અનુરાગ સિંહ ઠાકુર
Apara Mehta|અપરા મહેતા
Arif Alvi|આરીફ અલ્વી
Arnab Ranjan Goswami|અર્ણબ ગોસ્વામી
Asoka Mehta|અશોક મહેતા
Aspy Engineer|એસ્પી એન્જિનિયર
Avtar Saini|અવતાર સૈની
Bernard J. Dunn|બર્નાર્ડ જે ડન
Bhagat Singh Koshiyari|ભગત સિંહ કોશ્યારી
Bhalan|ભાલણ
Bhavana Pundlikrao Gawali|ભાવના પુંડલિકરાવ ગવલી
Biren Singh Engti|બીરેન સિંહ એંગતી
Burhanuddin Gharib|બુરહાનુદ્દીન ગરીબ
C. Raja Raja Varma|સી. રાજા રાજા વર્મા
C. V. Chandrasekhar|સી.વી.ચંદ્રશેખર
Cooverji Hormusji Bhabha|કુંવરજી હોરમૂસજી ભાભા
Craig L. Hill|ક્રેગ એલ. હિલ
D. Sreeram Kumar|ડી શ્રીરામ કુમાર
Dean Roden Chapman|ડીન રોડન ચેપમેન
Denis Rousseau|ડેનિસ રૂસો
Dhumaketu|ગૌરીશંકર ગોવર્ધનરામ જોશી
Dushyant Singh|દુષ્યંત સિંહ
Ganesh Shankar Vidyarthi|ગણેશ શંકર વિદ્યાર્થી
Ganpatsinh Vestabhai Vasava|ગણપતસિંહ વેસ્તાભાઈ વસાવા
H. S. Shivaprakash|એચ. એસ. શિવપ્રકાશ
Hari Manjhi|હરી માંઝી
Haridwar Singh|હરિદ્વાર સિંહ
Harindra Dave|હરીન્દ્ર દવે
Nabakanta Barua|નવકાન્ત બરુઆ
J. B. Moraes|જે. બી. મોરેસ
Jayadev Galla|જયદેવ ગલ્લા
John Francis Hylan|જોન ફ્રાન્સીસ હાયલન
Kambampati Nachiketa|કમ્બામપતિ નચિકેતા
Kamlesh Kumari|કમલેશ કુમારી
Karam Singh|કરમસિંહ
Kavita Kaushik|કવિતા કૌશિક
Kavita Ramdas|કવિતા રામદાસ
Kiren Rijiju|કિરેન રીજૂજુ
Lakhajirajsinhji II Bavajirajsinhji, 12th Thakore Saheb of Rajkot|lakhajiraj
Mafatlal Purohit|મફતલાલ પુરોહિત
Makhanlal Chaturvedi|માખનલાલ ચતુર્વેદી
Manik Godghate|માણિક ગોડઘાટે
Maqsood Rana|મકસૂદ રાણા
Mauli Dave|મૌલી દવે
Mirza Badi-uz-Zaman Safavi|મિર્ઝા બદી-ઉઝ-ઝમાન સફવી
Mohammad Habib|મહમદ હબીબ
Mohammad Khalil|મોહમ્મદ ખલીલ
Mohammad Sheraz|મોહમ્મદ શેરાઝ
Mool Chand Chowhan|મૂળચંદ ચૌહાણ
Mridula Sarabhai|મૃદુલા સારાભાઇ
Mukesh Bhatt|મુકેશ ભટ્ટ
N. Krishna Pillai|એન. કૃષ્ણા પિલ્લઈ
Nanabhai Bhatt|નાનાભાઈ ભટ્ટ
Nirmal Jit Singh Sekhon|નિર્મલ જીત સિંઘ સેખોં
Nita Ambani|નિતા અંબાણી
P. C. Gaddigoudar|પી૰સી૰ ગડ્ડીગૌડર
Parayamparanbil Kuttappan Biju|પી૰કે૰ બીજૂ
Parbat Patel|પરબતભાઇ પટેલ
Pilaji Rao Gaekwad|પીલાજી રાવ ગાયકવાડ
Pon Radhakrishnan|પોન રાધાકૃષ્ણન
Pradipsinh Jadeja|પ્રદિપસિંહ જાડેજા
Pramukh Swami|પ્રમુખ સ્વામી
R. C. Mehta|રમણલાલ મહેતા
Raghavendra Rau|રાઘવેન્દ્ર રાઉ
Rajendra Agrawal|રાજેંદ્ર અગ્રવાલ
Ram Kripal Yadav|રામકૃપાલ યાદવ
Sambhavana Sheth|સંભાવના શેઠ
Shiamak Davar|શ્યામક દાવર
Shubhangi Kulkarni|શુભાંગી કુલકર્ણી
Sisir Adhikari|શિશિર કુમાર અધિકારી
Subhash Mukhopadhyay|સુભાષ મુખોપાધ્યાય
Sudip Bandyopadhyay|સુદીપ બંદોપાધ્યાય
Sukhlal Sanghvi|સુખલાલ સંઘવી
Sumati Morarjee|સુમતિ મોરારજી
Suvendu Adhikari|સુવેન્દુ અધિકારી
Swapan Dasgupta|સ્વપન દાસગુપ્તા
Tanmay Bhat|તન્મય ભટ
Tarabai Modak|તારાબાઈ મોડક
Tariq Anwar|તારિક઼ અનવર
Thakkar Bapa|ઠક્કર બાપા
Vasu Trivedi|વસુબેન ત્રિવેદી
Virender Kashyap|વીરેંદ્ર કશ્યપ
Virendra Kumar Khatik|વીરેંદ્ર કુમાર
Walter Bender|વોલ્ટર બેન્ડેર
Yogendra Shukla|યોગેન્દ્ર શુક્લા
Rustam Sarang|રૂસ્તમ સારંગ
Karamchand Uttamchand Gandhi|કરમચંદ ઉત્તમચંદ ગાંધી
|ગલબાભાઈ નાનજીભાઈ પટેલ
Harsh Vardhan|હર્ષવર્ધન
Prem Mathur|પ્રેમ માથુર
Sarla Thakral|સરલા ઠકરાલ
Lalita Shastri|Lalita Shastri
Amrit Rai|અમૃત રાય
Makanji Kuber Makwana|મકાનજી કુબેર મક્વાણા
Lalbhai Dalpatbhai|લાલભાઈ દલપતભાઈ
Malhar Rao Gaekwad|મલ્હારરાવ ગાયકવાડ
Gopal Shetty|ગોપાલ શેટ્ટી
Satyapal Singh|સત્યપાલ સિંહ
Jagat Prakash Nadda|જગત પ્રકાશ નડા
Sher Singh Ghubaya|શેર સિંહ ઘુબાયા
Tiger Shroff|ટાઇગર શ્રોફ
Kala|કાલા
Yamini Reddy|યામિની રેડ્ડી
Namrata Rai|નમ્રતા રાય
Manisha Gulyani|મનીષા ગુલિયાની
Raj Kumar Saini|રાજ કુમાર
Haricharan Shaw|હરિચરણ શો
Swami Simandhara|સિમંધર
D.J. Bagyaraj|ડી.જે.ભાગ્યરજ
Bhoye Madhubhai Jeliyabhai|માધુભાઈ જેલીયાભાઈ ભોયે
Joby Mathew|જોબી મેથ્યુ
Shyam Pathak|શ્યામ પાઠક
Soumya Rai|સૌમ્યા રાય
Ram Prasad Sharma|રામ પ્રસાદ શર્મા
Savitri Thakur|સાવિત્રી ઠાકુર
Rajan Vichare|રાજન વિચારે
Mamta Sodha|મમતા સોઢા
K. P. P. Nambiar|કે પી પી નામ્બિયાર
Harinarayan Rajbhar|હરિનારાયણ રાજભર
Rajveer Singh|રાજવીર સિંહ
Ajay Nishad|અજય નિષાદ
Dharamvir Gandhi|ધર્મવીર ગાંધી
Dipsinh Shankarsinh Rathod|દીપસિંહ શંકરસિંહ રાઠોડ
Hariom Singh Rathore|હરિઓમ સિંહ રાઠૌડ઼
J. C. Diwakar Reddy|જે૰સી૰ દિવાકર રેડ્ડી
Kambhampati Hari Babu|કમ્ભમ્પાટિ હરિબાબૂ
Lakhan Lal Sahu|લખન લાલ સાહૂ
Muttamsetti Srinivasa Rao|મુત્તમસેટ્ટી શ્રીનિવાસ રાવ (અવંતિ શ્રીનિવાસ)
Sushmita Dev|સુષ્મિતા દેવ
Vasava Parbhubhai Nagarbhai|વસાવા પરભુભાઈ નાગરભાઈ
Y. S. Avinash Reddy|વાઈ૰એસ૰ અવિનાષ રેડ્ડી
Janardan Mishra|જનાર્દન મિશ્રા
Laxmi Narayan Yadav|લક્ષ્મી નારાયણ યાદવ
Raksha Khadase|રક્ષા ખડસે
Tapas Mandal|તાપસ મંડલ
Rodmal Nagar|રોડમલ નાગર
Prabhas Kumar Singh|પ્રભાસ કુમાર સિંહ
Charanjeet Singh Rori|ચરણજીત સિંહ રોડ઼ી
K. Kamaraj|ડૉ૰ કે૰ કામરાજ
K. Gopal|કે૰ ગોપાલ
Yashwant Singh|યશવંત સિંહ
Deepa Malik|દીપા મલિક
Mukund Varadarajan|મુકુંદ વરદરાજન
Harilal Dhruv|હરિલાલ ધ્રુવ
Rupashree Mohapatra|રૂપાશ્રી મહાપત્રા
Sekhar Basu|શેખર બાસુ
Hasmukh Patel|હસમુખ ચંદુભાઈ પટેલ
|હસમુખભાઈ ચમનલાલ શાહ
|પ્રભાશંકર ઓઘડભાઈ સોમપુરા
Dhvanit Thaker|ધ્વનિત ઠાકર
|અરવિંદ રાઠોડ
Roma Manek|રોમા માણેક
Shyam Yadav|શ્યામ યાદવ
Nilamber Pant|નીલમ્બર પંત
Shiv Prasad Kosta|શિવ પ્રસાદ કોસ્તા
Sreelakshmy Govardhanan|શ્રીલક્ષ્મી ગોવર્ધનન
Vikram Thakor|વિક્રમ ઠાકોર
Pratik Gandhi|પ્રતિક ગાંધી
Harkisan Mehta|હરકિસન મહેતા
Hariprasad Vyas|હરિપ્રસાદ વ્યાસ
Saarah Hameed Ahmed|સારાહ હમીદ અહેમદ
Aryan Khan|આર્યન ખાન
Abram Khan|અબ્રામ ખાન
Gouri Sankar Bandyopadhyay|ગૌરી સંકર બંદ્યોપધ્યાય
Friederike Spitzenberger|Friederike Spitzenberger
Arvind Vegda|અરવિંદ વેગડા
Sanju Vala|સંજુ નારણભાઈ વાળા
Kanhaiya Kumar|કન્હૈયા કુમાર
Gangadhar Rao|ગંગાધર રાવ
Okram Bikram Singh|ઓકરામ બિક્રમ સિંઘ
Chandan Kumar Behera|ચંદનકુમાર બેહરા
Radheshyam Sharma|રાધેશ્યામ શર્મા
Priti Sengupta|પ્રીતિ સેનગુપ્તા
C A Bhavani Devi|સી. એ. ભવાની દેવી
Aditi Ashok|અદિતિ અશોક
Amrita Jash|અમૃતા જશ
Zar Randeri|ઝાર રાંદેરી
Balashankar Kantharia|બાલાશંકર કંથારીયા
Sachin Pandit|સચિન પંડિત
Claude Vaucher|Claude Vaucher
De Dee Hame Azaadi|સાબરમતી કે સંત
Muni Udayaratna|મુનિ ઉદયરત્ન
Keshav H. Sheth|કેશવ હ. શેઠ
|લોયણ
Kamal Vora|કમલ વોરા
Bob Singleton|Bob Singleton
Mahendrasinh Parmar|મહેન્દ્રસિંહ પરમાર
Kinjal Dave|કિંજલ દવે
Minal Rohit|મિનલ રોહીત
Man Kaur|મન કૌર
Chhota Singh|છોટાસિંહ
Mohan Parmar|મોહન પરમાર
Harshida Raval|હર્ષિદા રાવળ
Vishvaraj Jadeja|વિશ્વરાજ જાડેજા
Jimit Trivedi|જિમીત ત્રિવેદી
Arishfa Khan|અરીશફા ખાન
Jagdish Patel|જગદીશ પટેલ
Sarwanand (Sarvanand) Koul Premi|સર્વાનંદ કૌલ પ્રેમી
Niklas Laxström|નિકલસ લાક્ષસ્ટ્રોમ
Bertrand Devouard|Bertrand Devouard
Aishwarya Pissay|એશ્વર્યા પિસ્સાઈ
Vishanji Chaturbhuj Thakkur|વિશનજી ચતુર્ભુજ ઠક્કુર
Dharam Bir Singh|ધરમબીર
Geeta Rabari|ગીતા રબારી
Dhavalsinh Zala|ધવલસિંહ ઝાલા
Ramesh Solanki|રમેશ સોલંકી
Gowriprasad Jhala|ગૌરીપ્રસાદ ઝાલા
Yazdi Naoshriwan Karanjia|યઝદી કરંજીયા
Narayan Joshi Karayal|નારાયણ જોષી કારાયલ
Brahmkumar Bhatt|બ્રહ્મકુમાર ભટ્ટ
Manubhai Jodhani|મનુભાઈ જોધાણી
Christian Hammers|Christian Hammers
Manoj Shah|મનોજ શાહ
Yanting Ma|યંટિંગ મા
Gert Kivistik|Gert Kivistik
Ilia Cota|Ilia Cota
Carlo Jurisevic|Carlo Jurisevic
Birkir Snaer Ingvason|Birkir Snaer Ingvason
Barbora Svrckova|Barbora Svrckova
Wendy Ducruex|Wendy Ducruex
Tatiana Droujinina|Tatiana Droujinina
Tatiana Bossak|Tatiana Bossak
Chantalle Gehrig|Chantalle Gehrig
Séverine Villance|Séverine Villance
Lada Koslikova|Lada Koslikova
Samanta Loschi|Samanta Loschi
Pandit Gajanan Ambade|પંડિત ગજાનન અંબાડે
Darnelle Moore|Darnelle Moore
Rachel Leroux|Rachel Leroux
Šárka Chmurová|Šárka Chmurová
Sarah Wimmer|Sarah Wimmer
Bahecharbhai Patel|બહેચરભાઈ પટેલ
Prakash N. Shah|પ્રકાશ ન. શાહ
Darshana Dholakia|દર્શના ધોળકિયા
Riccardo Schöpf|Riccardo Schöpf
Eduard Crăciun|Eduard Crăciun
Irina Strebel|Irina Strebel
Sara Villani|Sara Villani
Andreas Haas|Andreas Haas
Joseph Williamson|Joseph Williamson
Mika Schneider|Mika Schneider
Daniel Berlinski|Daniel Berlinski
Franz Kafka|ફ્રાન્ઝ કાફકા
Albert Einstein|આલ્બર્ટ આઇન્સ્ટાઇન
Subhas Chandra Bose|સુભાષચંદ્ર બોઝ
Vincent van Gogh|વિન્સેન્ટ વેન ગો
Jean-Jacques Rousseau|જિન-જાક રુસો
Günter Grass|ગુંટર ગ્રાસ
Leo Tolstoy|લિયો ટોલ્સટૉય
Andre Agassi|આન્દ્રે અગાસી
Asima Chatterjee|અસીમા ચેટર્જી
Winston Churchill|વિન્સ્ટન ચર્ચિલ
James Prescott Joule|જેમ્સ પ્રિસ્કોટ જૂલ
Laozi|લાઓત્સે
Abid Surti|આબિદ સુરતી
Shah Rukh Khan|શાહરૂખ ખાન
Katrina Kaif|કૅટરિના કૈફ
Steffi Graf|સ્ટેફી ગ્રાફ
Kanye West|કાન્યે વેસ્ટ
Virchand Gandhi|વીરચંદ ગાંધી
Bertrand Russell|બર્ટ્રાન્ડ રસેલ
Albert Camus|આલ્બેર કેમ્યૂ
Muhammad Ali|મહંમદ અલી
Mark Zuckerberg|માર્ક ઝુકરબર્ગ
Stephen King|સ્ટીફન કિંગ
Charles Babbage|ચાર્લ્સ બૅબેજ
Vijay Tendulkar|વિજય તેંડુલકર
Govindrao Tembe|ગોવિંદરાવ ટેમ્બે
Pranab Mukherjee|પ્રણવ મુખર્જી
Arvind Kejriwal|અરવિંદ કેજરીવાલ
Heidi Klum|હેઇદી ક્લુમ
Zuri Lawrence|ઝુરી લોરેન્સ
Aadesh Bandekar|આદેશ બાંડેકર
Jigar Moradabadi|જીગર મુરાદાબાદી
Everett Martin|એવરેટ માર્ટિન
Shah Jahan|શાહજહાં
Pandita Ramabai|પંડિતા રમાબાઈ
Rajesh Khanna|રાજેશ ખન્ના
Har Gobind Khorana|ડો. હરગોવિંદ ખુરાના
Monisha Kaltenborn|મોનિષા કાલ્ટેનબોર્ન
Nitish Kumar|નીતીશ કુમાર
Sandy Saddler|સેન્ડી સેડલર
Doug DeWitt|ડગ ડેવિટ
Henry David Thoreau|હેન્રી ડેવિડ થોરો
Rachel Weisz|રચેલ વેઇઝ
Sonia Deepti|સોનિયા દીપ્તિ
Hannah Chaplin|હન્નાહ ચેપ્લીન
Tukaram Omble|તુકારામ ઓમ્બલે
Ayesha Takia|આયેશા ટાકિયા
Priyanka Chopra|પ્રિયંકા ચોપરા
Davey Armstrong|ડેવી આર્મસ્ટ્રોંગ
Anna Nicole Smith|એના નિકોલ સ્મિથ
Shashi Tharoor|શશિ થરૂર
Bashir Badr|બશીર બદ્ર
Abul Kalam Azad|અબુલ કલામ આઝાદ
Willie Dixon|વિલી ડિકસન
Maja Einstein|મેજા આઇન્સ્ટાઇન
Jesse Eisenberg|જેસ્સી ઐસેનબર્ગ
Anggun|છબીલું
Patanjali|પતંજલી
Ivanka Trump|ઇવાંકા ટ્રંપ
Jyoti Amge|જ્યોતિ આમગે
Vaibhavi Merchant|વૈભવી મર્ચેન્ટ
Duane Bobick|ડ્યુએન બોબીક
Ivana Brlić-Mažuranić|આઈવાના બ્રલિચ માઝુરાનિચ
Laila Ali|લૈલા અલી
Priya Raman|પ્રિયા રમણ
Art Aragon|આર્ટ એરેગોન
Madan Lal Dhingra|મદનલાલ ધિંગરા
George V|જ્યોર્જ પાંચમો
Sridevi|શ્રીદેવી
Vineeth|વિનિથ
Philomina|ફિલોમિના
Karthika|કાર્તિકા
Rahman|રહમાન
Rajeevan|રાજીવન
Tommy Loughran|ટોમી લોફરન
Ahmad Magdy|કોમન
Lara Dutta|લારા દત્તા
Celina Jaitly|સેલિના જેટલી
Mukesh Ambani|મુકેશ અંબાણી
Harini Ravi|હરિની રવિ
Abbas|અબ્બાસ
Khan Abdul Ghaffar Khan|ખાન અબ્દુલ ગફાર ખાન
Guru Gobind Singh|ગુરુ ગોવિંદસિંહ
Jack Dempsey|જેક ડેમ્પ્સી
Floyd Patterson|ફ્લોઇડ પેટરસન
Abdul Rahim Khan-I-Khana|રહીમ
Dom Moraes|ડૉમ મોરેસ
Larry Donald|લેરી ડોનાલ્ડ
Jason Estrada|જેસન એસ્ટ્રેડ
Charley Burley|ચાર્લી બર્લી
Donald Curry|ડોનાલ્ડ કરી
Javed Jaffrey|જાવેદ જાફરી
Anushka Shetty|અનુષ્કા શેટ્ટી
Abrar Alvi|અબરાર અલવી
Lou Ambers|લૂ અમ્બર્સ
Shankar Dayal Sharma|શંકર દયાલ શર્મા
Ahmed Deedat|અહમદ દીદત
Bhaichung Bhutia|ભાઈચુંગ ભુટિયા
Sugar Ray Leonard|સુગર રે લિયોનાર્ડ
Cyrus Sahukar|સાઈરસ સાહુકાર
Vivek Razdan|વિવેક રાઝદાન
Bhagat Singh|ભગત સિંહ
H. D. Deve Gowda|ઍચ૰ ડી૰ દેવગૌડ઼ા
Dharmendra|ધર્મેન્દ્ર
Balkrishna Doshi|બી. વી. દોશી
Tara Devi|તારા દેવી
Jayshree Gadkar|જયશ્રી ગડકર
P. V. Sindhu|પી. વી. સિંધુ
Ami Ghia|અમી ઘીયા
Rukmini Devi Arundale|રુકમણી દેવી અરુંડેલ
Jhumpa Lahiri|ઝુમ્પા લાહિરી
Karen David|કારેન ડેવિડ
Eesha Koppikhar|ઈશા કોપીકર
Aruna Asaf Ali|અરુણા આસફ અલી
Divya Dutta|દિવ્યા દત્તા
Charles Cooley|ચાર્લ્સ કૂલે
Amit Chaudhuri|અમિત ચૌધરી
Ricky Ponting|રીકી પોન્ટીગ
Mahi Gill|માહી ગિલ
Apache Indian|અપાચે ઈન્ડિયન
Upamanyu Chatterjee|ઉપમન્યુ ચેટરજી
Vijay|વિજય
Ronaldo|રોનાલ્ડો
Sheela|શીલા
Patience Cooper|પેટિએન્સ કૂપર
Vajiralongkorn|મહા વજ્રાલંકર્ણ
Shane Warne|શેન વોર્ન
Kamala Surayya|કમલા સુરૈયા
Moushumi Bhowmik|મૌસમી ભૌવમિક
Janamejaya|જનમેજય
Turhan Hatice|તોરખાન ખદીજા સુલ્તાન
Goutam Ghose|ગૌતમ ઘોષ
Arshad Warsi|અરશદ વરસી
David Dhawan|ડેવિડ ધવન
Jayaprakash Narayan|જયપ્રકાશ નારાયણ
Gopinath Bordoloi|ગોપીનાથ બોરદોલોઈ
Ayesha Omar|આયેશા ઓમર
Honey Irani|હની ઈરાની
Badruddin Ajmal|બદરુદ્દીન અજમલ
Chandragupta I|ચંદ્રગુપ્ત પ્રથમ
Bindu De Stoppani|બિંદુ દે સ્ટોપણી
Gajanan Digambar Madgulkar|ગજાનન દિગંબર માડગુલકર
Swaminarayan|સ્વામિનારાયણ
Nils Torvalds|નિલ્સ ટોરવાલ્ડ્સ
Mrinal Sen|મૃણાલ સેન
Dnyaneshwar|જ્ઞાનેશ્વર
Phanishwar Nath 'Renu'|ફણીશ્વરનાથ રેણુ
Nanalal Dalpatram Kavi|ન્હાનાલાલ
Rahul Sharma|રાહુલ શર્મા
David Woodard|ડેવિડ વુડાર્ડ
Maithili Sharan Gupt|મૈથિલીશરણ ગુપ્ત
Naveen Patnaik|નવિન પટનાયક
Mihira Bhoja|સમ્રાટ મિહિરભોજ
Ravindra Kelekar|રવિન્દ્ર કેલકર
Anbumani Ramadoss|અંબુમણિ રામદૉસ
Gautama Maharishi|ગૌતમ
Rajinder Singh|રાજીન્દર સિંહ
Moon Moon Sen|મુનમુન સેન
Willie Kgositsile|કેઓરાપેત્સે ખોસિત્સિલે
Jafar Husayn Khan|જાફર હુસેન ખાન
Sathya Prakash|સાથિયા પ્રકાશ
Dhruva Mistry|ધ્રુવ મિસ્ત્રી
Kaviyoor Revamma|કવિયૂર રેવમ્મા
Sainoj|સૈનોજ
Shreya Ghoshal|શ્રેયા ઘોષાલ
Santhosh Pandit|સંતોષ પંડિત
Vidhu Prathap|વિધુ પ્રથાપ
Jyotsna Radhakrishnan|જ્યોત્સના રાધાક્રિશ્નન
K. J. Yesudas|કે. જે. યેસુદાસ
Jimutavahana|જીમૂતવાહન
Ramesh Mehta|રમેશ મહેતા
Robert Anderson Van Wyck|રોબર્ટ એન્ડરસન વેન વિક
Shiv Dayal Batish|શિવ દયાલ બાતીશ
Sibnarayan Ray|સિબનારયણ રે
Geeta Bali|ગીતા બાલી
Pritilata Waddedar|પ્રીતીલતા વાડ્ડેદાર
Cochin Haneefa|કોચિન હનીફા
Subhash Ghai|સુભાષ ઘાઈ
Willis Carrier|વિલિસ કેરિયર
Raja Birbal|રાજા બીરબલ
Bhaktisiddhanta Saraswati|ભક્તિસિદ્ધાંત સરસ્વતી
Parvathy Omanakuttan|પાર્વતી ઓમનાકુટ્ટન
Savitribai Phule|સાવિત્રીબાઇ ફુલે
Satya Vrat Shastri|સત્યવ્રત શાસ્ત્રી
Haradhan Bandopadhyay|હરાધન બંધોપાધ્યાય
Bhaskar Chandavarkar|ભાસ્કર ચંદાવરકર
Makkhali Gosala|મક્કાલી ગોસાલ
Atharvan|અથર્વ ઋષિ
Mandira Bedi|મંદિરા બેદી
Akhaiyo|અખૈયો
Ajay Yadav|અજય યાદવ
Anantrai Raval|અનંતરાય મણિશંકર રાવળ
Krishna Das Kaviraj|કૃષ્ણદાસ કવિરાજ
Moushumi Chatterjee|મૌસમી ચેટર્જી
Sameera Reddy|સમીરા રેડ્ડી
Teji Bachchan|તેજી બચ્ચન
Shivlal Yadav|શિવલાલ યાદવ
Keshubhai Patel|કેશુભાઇ પટેલ
Yashwant Sinha|યશવંત સિન્હા
Vinod Kambli|વિનોદ કાંબલી
Adil Mansuri|આદિલ મન્સુરી
Dalpatram|દલપતરામ
N. K. Pandya|ઉશનસ્
Kamlashankar Pandya|કમળાશંકર પંડ્યા
Kalpana Divan|કલ્પના દિવાન
Kishore Jadav|કિશોર જાદવ
Keshavram Kashiram Shastri|કે.કા.શાસ્ત્રી
K Lal|કે.લાલ
Ardeshar Khabardar|અરદેશર ખબરદાર
Gargi Vachaknavi|ગાર્ગી
Gokuldas Dwarkadas Raichura|ગોકુલદાસ રાયચુરા
Veena Malik|વીણા મલિક
P. A. Sangma|પી૰ એ૰ સંગમા
Robin Uthappa|રોબિન ઉથપ્પા
Jayant Khatri|જયંત ખત્રી
Jayanti Dalal|જયંતિ દલાલ
Niranjan Rajyaguru|નિરંજન રાજ્યગુરુ
Ram Manohar Lohia|ડો. રામમનોહર લોહિયા
|ત્રિકમ સાહેબ
Dayanand Swami|દયાનંદ સ્વામી
Dula Bhaya Kag|દુલા કાગ
Dhirubhai Thaker|ધીરુભાઈ ઠાકર
Narhari Parikh|નરહરિ પરીખ
Nathalal Dave|નાથાલાલ દવે
|નારાયણ રાજગોર
Shaktidan Mahidan Langvadara|શક્તિદાન મહીદાન લાંગાવદરા
Nishkulanand Swami|નિષ્કુળાનંદ સ્વામી
|પંકજ જોષી
Punit Maharaj|પુનિત મહારાજ
Prajaram Raval|પ્રજારામ રાવળ
Prabodh Pandit|પ્રબોધ પંડિત
Bakul Tripathi|બકુલ ત્રિપાઠી
|ભક્તિબલ્લભ તીર્થ ગોસ્વામી મહારાજ
Bhan Saheb|ભાણ સાહેબ
Makarand Dave|મકરંદ દવે
Mekan Dada|મેકણ દાદા
Yashwant Kadikar|યશવંત કડીકર
Ramesh M. Shukla|રમેશચંદ્ર શુક્લ
Raskhan|રસખાન
Lalji Kanpariya|લાલજી કાનપરિયા
|લીરબાઈ
Vishwanath Bhatt|વિશ્વનાથ ભટ્ટ
Saroj Pathak|સરોજ પાઠક
|હંસરામ પહેલવાન
Harpal Zala|હરપાલ ઝાલા
Hasmukh Shah|હસમુખલાલ શાહ
Haji Mohammed Allarakha Shivji|હાજી મોહમ્મદ અલારખા શિવજી
Himmatlal Anjariya|હિંમતલાલ અંજારિયા
Kamaliya|કમલિયા
Alka Saraogi|અલકા સરાગવી
John Purroy Mitchel|જોન પ્યુરોય મિચેલ
Kader Khan|કાદર ખાન
Lalit Modi|લલિત મોદી
Dheeran Chinnamalai|ધીરન ચિન્નામલઈ
Kadambini Ganguly|કાદમ્બિની ગાંગુલી
Salil Chowdhury|સલિલ ચૌધરી
Rohan Gavaskar|રોહન ગાવસ્કર
Rahul Dev Burman|આર. ડી. બર્મન
Amiya Chakravarty|અમીય ચક્રવર્તી
Puneeth Rajkumar|પુનિથ રાજકુમાર
Poomani|પૂમણિ
Sir Richard Temple, 1st Baronet|રીચર્ડ ટમ્પલ
Sushilkumar Shinde|સુશીલ કુમાર શિંદે
Swami Ramdas|ramdas
Girish Karnad|ગિરીશ કર્નાડ
Jaswant Singh|જસવંત સિંહ
Dhondo Keshav Karve|ધોન્ડો કેશવ કર્વે
A. K. Ramanujan|એ. કે. રામાનુજન
Arun Lal|અરુણ લાલ
Datta Gaekwad|દત્તા ગાયકવાડ
Tinu Yohannan|ટીનુ યોહનન
Kancha Ilaiah|કાંચા ઇલૈયા
Ottaplakkal Neelakandan Velu Kurup|ઓ. એન. વી. કુરુપ
Akilan|પી. વી. અકિલાનંદમ
Suman|સુમન
Sowcar Janaki|સોકર જાનકી
Amala Akkineni|અમાલા અક્કીનેની
Neiphiu Rio|નેફિયૂ રિયો
Nakul|નકુલ
Narain|નારાયણ
Prashanth|પ્રશાંત
Sukshinder Shinda|સુકશીંદેર શીંદા
Usha Uthup|ઉષા ઊઠુપ
Tanushree Dutta|તનુશ્રી દત્તા
Ranjith|રંજીત
Balwantrai Mehta|બળવંતરાય મહેતા
M. Govinda Pai|એમ.ગોવિંદા પાઇ
Omkarnath Thakur|પંડિત ઓમકારનાથ ઠાકુર
Asha Parekh|આશા પારેખ
Nanda|નંદા
Balamani Amma|બલામાની અમ્મા
Yoginder Sikand|યોગિન્દર સિકંદ
Rehman Rahi|રહેમાન રાહી
Sitakant Mahapatra|સીતાકાંત મહાપત્ર
Kunwar Singh|કુંવર સિંહ
Kamleshwar|કમલેશ્વર
Bhai Vir Singh|ભાઈ વીરસિંહ
Mohan Rakesh|મોહન રાકેશ
Arvind Gupta|અરવિન્દ ગુપ્તા
Miss Pooja|મિસ પૂજા
Kuldeep Manak|કુલદીપ માનક
Bakht Khan|બખ્ત ખાન
Samaldas Gandhi|શામળદાસ ગાંધી
Kailash Vajpeyi|કૈલાસ વાજપેયી
Bhimsen Thapa|ભીમસેન થાપા
Chekitana|ચેકિતાન
Joy Goswami|જય ગોસ્વામી
Louis Banks|લૂઇસ બેન્ક્સ
Kavita Seth|કવિતા શેઠ
Charles Chaplin Sr.|ચાર્લ્સ ચેપ્લીન, સીનીયર
Sudhanshu Pandey|સુધાંશુ પાંડે
Graham Schweig|ગ્રેહામ સ્વેઇગ
Aanchal Munjal|આંચલ મુંજલ
Aarani Satyanarayana|આરાણી સત્યનારાયણ
Abhishek Banerjee|અભિષેક બનર્જી
Ajeet Bajaj|અજિત બજાજ
Akhtar-Ul-Iman|અખ્તર-ઉલ-ઈમાન
Amit Tandon|અમિત ટંડન
Ammu Swaminathan|અમ્મુ સ્વામીનાથન
Amrinder Gill|અમરિન્દર ગિલ
Ananya Chatterjee|અનન્યા ચેટરજી
Andrew K. Golden|એન્ડ્રુ કે ગોલ્ડન
Angana Bose|અંગના બોઝ
Anita Kanwal|અનિતા કંવલ
Anjali Lavania|અંજલિ લાવાણીયા
Anjan Dutt|અંજન દત્ત
Anupriya Patel|અનુપ્રિયા પટેલ
Anurita Rai|અનુરીતા રાય
Ashok Kamte|અશોક કામ્ટે
Ayesha Jalal|આયેશા જલાલ
B. Vithal Shetty|બી.વિઠ્ઠલ શેટ્ટી
Baijayant Panda|જય પાંડા
Balu Sankaran|બ્લુ શંકરન
Bhanu Pratap Singh Verma|ભાનુ પ્રતાપ સિંહ વર્મા
Bhoj Raj|bhoj raj
Binny Sharma|બિન્ની શર્મા
Bodil Schmidt-Nielsen|બોડિલ સ્મિટ-નીલસન
Brené Brown|બ્રેને બ્રાઉન
Carlos Ortiz Longo|કાર્લોસ ઓર્ટીઝ લોન્ગો
Chandrakant Khaire|ચન્દ્રકાન્ત ખરે
Chandrashekhar|chandrashekhar
Jeroo Billimoria|જેરૂ બીલીમોરા
Chitra Visweswaran|ચિત્રા વિશ્વાસ્વરન
Choudhury Mohan Jatua|ચૌધરી મોહન જટુયા
Chris Cimino|ક્રિસ સિમિનો
Clyde Martin|ક્લાઇડ માર્ટિન
D. Mark Hegsted|ડી. માર્ક હેગસ્ટેડ
Damon Wilson|ડેમન વિલ્સન
Daniel A Farber|ડેનિયલ એ ફાર્બર
Daniel P. Friedman|ડેનિયલ પી. ફ્રીડમેન
Darshan Jariwala|દર્શન જરીવાલા
David L. Kirp|ડેવિડ એલ. કિર્પ
Dhyani Dave|ધ્યાની દવે
Dimple Yadav|ડિમ્પલ યાદવ
Disha Vakani|દિશા વાકાણી
Durgawati Devi|દુર્ગાવતી દેવી
Faiza Seth|ફૈઝા શેઠ
Gauhar Raza|ગૌહાર રાઝા
Ghanshyambhai C. Oza|ઘનશ્યામભાઈ ઓઝા
H. R. Vishwasa|એચ. આર. વિશ્વાસ
Hirubhai M. Patel|હીરુભાઇ એમ.  પટેલ
Harischandra Devram Chavan|હરિશ્ચંદ્ર દેવરામ ચવ્હાણ
Jayanta Mahapatra|જયન્ત મહાપાત્ર
Hridaynath Mangeshkar|હૃદયનાથ મંગેશકર
Indira Parthasarathy|ઇન્દિરા પાર્થસારથી
Jagdambika Pal|જગદમ્બિકા પાલ
Jainendra Kumar|જૈનેન્દ્ર કુમાર
Jayaben Desai|જયાબેન દેસાઈ
Joseph V. McKee|જોસફ વી. મેકકી
K. S. Narasimhaswamy|કે. એસ. નરસિંહસ્વામી
Ka. Naa. Subramanyam|કા. ના. સુબ્રમણ્યમ
Kapur Singh Ghuman|કપુરસિંહ ઘુમ્મન
Karishma Modi|કરિશ્મા મોદી
Ki. Va. Jagannathan|કે. વી. જગન્નાથન
Kirit Somaiya|કિરીટ સોમૈયા
Krishna Pal Singh|કૃષ્ણા પાલ સિંઘ
Kulwant Singh Virk|કુલવંતસિંહ વિર્ક
Lajja Goswami|લજ્જા ગોસ્વામી
Pratibha Satpathy|પ્રતિભા શતપથી
M. M. Kalburgi|એમ. એમ. કુલબર્ગી
M.P. Veerendra Kumar|એમ. પી. વિરેન્દ્રકુમાર
M. V. Seetharamiah|એમ. વી. સિતારમૈયા
Madhurantakam Rajaram|મધુરાંતકમ રાજારામ
Mahesh Kumar Kanodia|મહેશ કનોડિયા
Mallikarjun Kharge|મલ્લિકાર્જુન ખડ઼ગે
Manoj Tiwari|મનોજ તિવારી
Masood Iqbal|મસુદ ઇકબાલ
Mausam Noor|મૌસમ નૂર
Syed Masud Hasan Rizvi|સયદ મસૂદ હસન રિજવી
Mir Mohtesham Ali Khan|મીર મોહતેશમ અલી ખાન
Mohammad Hanif|મોહમ્મદ હનીફ
Mohammed Salim|મોહમ્મદ સલીમ
Mona Best|મોના બેસ્ટ
Mumtaz Ahmed Khan|મુમતાઝ અહેમદ ખાન
Murali Mohan|મુરલી મોહન
Muzaffar Hussain Baig|મુજફ્ફર હુસૈન બેગ
Nrusingprasad Kalidas Bhatt|નૃસિંહપ્રસાદ કાળિદાસ ભટ્ટ
Naseem Shafaie|નસીમ શફાઈ
Natubhai Gomanbhai Patel|નાટુભાઈ ગોમનભાઈ પટેલ
Nirmala Sitaraman|નિર્મલા સીતારામન
P. K. Venugopalan Nambiar|પી.કે. વેણુગોપાલન નંબિયાર
P. Karunakaran|પી૰ કરુણાકરણ
Padmapani Acharya|પદ્મપાણી આચાર્ય
Pandurang Sadashiv Khankhoje|પંડુરંગ સદાશિવ ખાનખોજે
Poornima Arvind Pakvasa|પૂર્ણિમાબેન પકવાસા
Pritam Das|Pritam Das
Purnima Banerjee|પૂર્ણિમા બેનર્જી
R. Dhruvanarayana|આર૰ ધ્રુવનારાયણરાવ
Ra Navghan I|રા' નવઘણ પ્રથમ
Rajendrasinhji Jadeja|રાજેન્દ્રસિંહજી જાડેજા
Rajit Kapur|રજિત કપુર
Ramkumar Ganesan|રામકુમાર ગણેશન
Ranchhodlal Chhotalal|રણછોડલાલ છોટાલાલ
Rani Rampal|રાની રામપાલ
Ranjit Singh Dyal|રણજીત સિંઘ દયાલ
Rao Inderjit Singh|રાવ ઇંદ્રજીત સિંહ
Ravneet Singh|રવનીત સિંહ બિટ્ટૂ
Rica Takashima|રિકા તાકાશીમા
Ruma|રુમા
S. R. Rana|સરદારસિંહ રાણા
Santosh Gangwar|સંતોષ ગંગવાર
Santosh Yadav|સંતોષ યાદવ
Saugata Roy|સૌગત રૉય
Shahabuddin Rathod|શાહબુદ્દીન રાઠોડ
Shyama Charan Gupta|શ્યામા ચરણ ગુપ્તા
Sugata Bose|સુગત બોસ
T. K. Sreepada Rao|ટી.કે.શ્રીપદા રાવ
T. N. Manoharan|ટી. એન. મનોહરન
Taarak Mehta|તારક મહેતા
Tanvi Vyas|તન્વી વ્યાસ
Tapas Paul|તાપસ પાલ
Trevor Beattie|Trevor Beattie
Trevor Keelor|ટ્રેવર કિલોર
Ved Prakash Kamboj|વેદપ્રકાશ કમ્બોજ
Venu Srinivasan|વેણુ શ્રીનિવાસન
Vijay Kumar Singh|વી કે સિંહ
W. Norman Brown|વિલિયમ નોર્મન બ્રાઉન
W Selvamurthy|ડબલ્યુ સેલ્વમૂર્તિ
Regina Martelli|spine
Vithalbhai Patel|વિઠ્ઠલભાઈ પટેલ
Takaaki Kajita|તકાકિ કાજિતા
Layal Abboud|લાયલ એબ્બોઉડ
Archana Sharma|અર્ચના શર્મા
M. I. Shanavas|એમ૰આઈ૰ શાનવાસ
Godavari Parulekar|ગોદાવરી પરુલેકર
Neha Kakkar|નેહા કક્કર
Prakash Babanna Hukkeri|પ્રકાશ હુક્કેરી
Asha Mathur|આશા માથુર
Pravesh Verma|પ્રવેશ વર્મા
Ambalal Purani|અંબુભાઈ પુરાણી
Nimrat Kaur|નિમરત કૌર
Pratap Simha|પ્રતાપ સિમ્હા
Madhavi Mudgal|માધવી મુદ્ગલ
Bernard van Cutsem|બર્નાડ વાન કુત્સેમ
Amina Desai|અમીના દેસાઈ
Lakhmi Chand|લક્ષ્મીચંદ
Trilochan Singh Brar|ત્રિલોચનસિંહ બ્રાર
Ram Tahal Choudhary|રામ ટહલ ચૌધરી
Anil Shirole|અનિલ શિરોલે
Prakash Ambedkar|પ્રકાશ આંબેડકર
R. K. Singh|રાજ કુમાર સિંહ
Prasun Banerjee|પ્રસૂન બનર્જી
Mansukhbhai Vasava|મનસુખભાઈ વાસવ
Shaktisinh Gohil|શક્તિસિંહ ગોહિલ
Ragini Trivedi|રાગીણી ત્રિવેદી
Prateeksha Kashi|प्रचेता काशी
Bala Devi Chandrasekar|બાલા દેવી ચંદ્રશેખર
Ashwini Kumar Choubey|અશ્વિની કુમાર ચૌબે
Satish Chandra Dubey|સતીશ ચન્દ્ર દુબે
Jancy James|જેન્સી જેમ્સ
Nityanand Rai|નિત્યાનંદ રાય
Krishna Raj|કૃષ્ણા રાજ
Ram Swaroop Sharma|રામ સ્વરૂપ શર્મા
Vinayak Raut|વિનાયક રાઉત
Ajay Tamta|અજય ટમ્ટા
Vikram Usendi|વિક્રમ ઉસેંડી
Veena Devi|વીણા દેવી
Natasja Nobels|Natasja Nobels
Ajjamada B. Devaiah|ઐયામદ દેવૈઆ
Ram Nath Kovind|રામ નાથ કોવિંદ
Sheikh Hamza Makhdoom|હમઝા મખદૂમ
Aparupa Poddar|અપરૂપા પોદાર
Banshilal Mahto|બંશીલાલ મહતો
Jasvantsinh Sumanbhai Bhabhor|જસવંતસિંહ સુમનભાઈ ભાભોર
Santokh Singh Chaudhary|સંતોખ સિંહ ચૌધરી
Sunil Kumar Singh|સુનીલ કુમાર સિંહ
Tariq Hameed Karra|તારિક઼ હમીદ કર્રા
Akshay Yadav|અક્ષય યાદવ
Chhotelal|છોટેલાલ
Chintamani Malviya|ચિંતામણિ માલવીય
Mukesh Rajput|મુકેશ રાજપૂત
Heena Gavit|હિના ગાવિત
Ladu Kishore Swain|લાદૂ કિશોર સ્વાઇન
Sanjeev Balyan|સંજીવ કુમાર બાલયાન
Jeyasingh Thiyagaraj Natterjee|જે૰ જયસિંહ થિયાગરાજ નત્તેર્જી
Rita Tarai|રીતા તરાઈ
Sakuntala Laguri|શકુંતલા લાગુરી
Bela Bose|બેલા બોઝ
Gajendrasingh Shekhawat|ગજેન્દ્ર સિંહ શેખાવત
Vasanthi M|એમ૰ વસંતી
Arunmozhithevan A|અરુનમોજ઼િતેવન એ૰
Udhayakumar M|ઉદય કુમાર એમ૰
B. V. Nayak|બી૰વી૰ નાયક
K. R. P. Prabakaran|કે૰આર૰પી૰ પ્રભાકરન
Gauri Jog|ગૌરી જોગ
Shreyasi Singh|શ્રેયાસી સિંઘ
Sita Sahu|સીતા સહુ
Elam Endira Devi|ઇલમ એન્ડિરા દેવી
Bholanath Divetia|ભોળાનાથ દિવેટિયા
Abhishek Jain|અભિષેક જૈન
Shweta Chaudhry|શ્વેતા ચૌધરી
Mehar Singh|મેહરસિંહ
Mia Khalifa|મિઆ ખલીફા
Chandrashekhar Vijay|ચંદ્રશેખર વિજય
Kavungal Chathunni Panicker|કવંગલ ચથુની પેનીકર
Rajni Bala|રજનીબાળા
Kshetrimayum Ongbi Thouranisabi Devi|ક્ષત્રિયમ ઓગ્મ્બે થૌરાણીસાબી દેવી
Vinod Bhatia|વિનોદ કુમાર ભાટિયા
Jayasimha Siddharaja|સિદ્ધરાજ જયસિંહ
Gatubhai Gopilal Dhru|ગટુભાઈ ગોપીલાલ ધ્રુ
Rishi Sunak|ઋષિ સુનક
Y. V. Subba Reddy|વાઈ૰એસ૰ સુબ્બા રેડ્ડી
Nidhi Bhanushali|નિધિ ભાનુશાલી
Nrusingha Charan Panda|નૃસિંહ ચરણ પાંડા
Diwaliben Bhil|દિવાળીબેન ભીલ
Sarala Devi|સરલા દેવી
Swami Sachchidanand|સ્વામી સચ્ચિદાનંદ
Jinal Pandya|જિનલ પંડ્યા
Mohan Goswami|મોહન ગોસ્વામી
I. Bhooshana Rao|આઇ. ભૂષણ રાવ
Darshan Raval|દર્શન રાવલ
Ismail Valera|ઈસ્માઈલ વાલેરા
Hedwig Freiberg Koch|હેડવિગ કોચ
Rajesh Vyas|રાજેશ વ્યાસ
Saurabh Shah|સૌરભ શાહ
Damodar Savarkar|દામોદર સાવરકર
Honey Chhaya|હની છાયા
Mularaja|મૂળરાજ સોલંકી
Ashok Chavda|અશોક ચાવડા
Vivek Kane|વિવેક કાણે
Veenu Paliwal|વીનુ પાલીવાલ
Hardwar Goswami|હરદ્વાર ગોસ્વામી
Vinod Joshi|વિનોદ જોશી
Arpita Khan|અર્પિતા ખાન
Suniti Choudhury|સુનિતી ચૌધરી
Asharam Dalichand Shah|આશારામ દલીચંદ શાહ
|જોગીદાસ ખુમાણ
Rohit Sardana|રોહિત સરદાના
Baba Prithvirajendar Singh Bedi|બાબા પૃથ્વીરાજેન્દ્રસિંહ બેદી
Narayan Vishanji Thakkur|નારાયણ વિશનજી ઠક્કુર
Vallabharaja|વલ્લભરાજ
Bansilal Verma|બંસીલાલ વર્મા
Tribhuvanapala|ત્રિભુવનપાળ
Ratnasundarsuri|રત્નસુંદરસૂરિ
Mularaja II|મૂળરાજ દ્વિતિય
Bachu Achyutharamaiah|બચુ અચ્યુતારમૈયા
Miguel López González|Miguel López González
Pankaj Naram|ડૉ.પંકજ નરમ
Rodrigo Medina Benjumea|Rodrigo Medina Benjumea
Alfonso Toro Buiza|Alfonso Toro Buiza
José Jiménez Jimena|José Jiménez Jimena
Madhusmita Patnaik|મધુસ્મિતા પટનાયક
Janki Bodiwala|જાનકી બોડીવાળા
Yoseph Macwan|યોસેફ મેકવાન
Giacomo Tocci|Giacomo Tocci
Maganlal Joshi|મગનલાલ જોષી
Jaluma|જાલુમાં
Chapaklal Zaveri|ચંપકલાલ ઝવેરી
Alpesh Thakor|અલ્પેશ ઠાકોર
Paresh Dhanani|પરેશ ધાનાણી
|વિનોદભાઈ રમેશભાઈ નાયક
Putlibai Karamchand Gandhi|પુતળીબાઈ કરમચંદ ગાંધી
Vijayabakunvarba|વિજયાબાકુંવરબા
Jaya Mehta|જયા મહેતા
Neeta Ramaiya|નીતા રામૈયા
Narayanprasaddasji Swami|નારાયણપ્રસાદદાસજી સ્વામી
Indrajit Das|ઇન્દ્રજીત દાસ
Ghanshyam Desai|ઘનશ્યામ દેસાઈ
Bhogindra Divetia|ભોગીન્દ્ર દીવેટીયા
Prem Raj P.|પ્રેમ રાજ પૂ
|અમૃતલાલ પઢિયાર
Dhvani Bhanushali|ધ્વની ભાનુશાળી
Mohana Singh Jitarwal|મોહનાસિંહ જીતારવાલ
Shardaben Patel|શારદાબેન પટેલ
Vishanji Chaturbhuj Thakkur|વિશનજી ચતુર્ભુજ ઠક્કુર
Fabienne Lupo Magnaudet|Fabienne Lupo Magnaudet
Pingalshi Brahmanand Gadhvi|પિંગળશી બ્રહ્માનંદ ગઢવી
Dev Swarup|દેવ સ્વરૂપ
Natubhai Thakkar|સર્જક:નટુભાઈ ઠક્કર
Kelly Vedovelli|Kelly Vedovelli
Mihir Bhuta|મિહિર ભુતા
Yanina Kuskova|Yanina Kuskova
Greta Karasiovaite|Greta Karasiovaite
Joseph Samudio|Joseph Samudio
Dimitrios Christakos|Dimitrios Christakos
Muhammad Shahmir Aiman Abdul Halim|Muhammad Shahmir Aiman Abdul Halim
Sakchai Phodingam|Sakchai Phodingam
Karina Louise Sørensen|Karina Louise Sørensen
Mira Peeters|Mira Peeters
Cybil Di Guistini|Cybil Di Guistini
Anna-Sophia Czilwik|Anna-Sophia Czilwik
Myriam Desrosiers|Myriam Desrosiers
Adéla Vlnova|Adéla Vlnova
Monika Richterova|Monika Richterova
Nicholas Timmings|Nicholas Timmings
Ruth Demeijer|Ruth Demeijer
Chantal Polansky|Chantal Polansky
Liliano Leenknegi|Liliano Leenknegi
Kim Van Gastel|Kim Van Gastel
Nicole Peitzmeier|Nicole Peitzmeier
Jonathan Eric Gustafson|Jonathan Eric Gustafson
Dominik Hufschmid|Dominik Hufschmid
Lorenz Hollenbach|Lorenz Hollenbach
Matthias Grahé|Matthias Grahé
Bruno Schiemann|Bruno Schiemann
Justin Jacob|Justin Jacob
Rasiklal Narsinhdas Parikh|રસિકલાલ નરસિંહદાસ પરીખ
Tribhuvan vyas|ત્રિભુવન વ્યાસ
François Hollande|ફ્રાન્કોઇસ ઓલાંદે
Wolfgang Amadeus Mozart|મોઝાર્ટ
Isaac Newton|આઇઝેક ન્યુટન
Charles Darwin|ચાર્લ્સ ડાર્વિન
Roger Federer|રોજર ફેડરર
Tom Hanks|ટોમ હેંક્સ્
David Guetta|ડેવિડ ગેટ્ટા
Mahavira|મહાવીર સ્વામી
Sachin Tendulkar|સચિન તેંડુલકર
Amitabh Bachchan|અમિતાભ બચ્ચન
Fidel Castro|ફિડલ કાસ્ટ્રો
Kanji Swami|કાનજી સ્વામી
Muammar Gaddafi|મુઅમ્મર ગદ્દાફી
Adele|Adele
Brihadratha Maurya|બૃહદ્રથ મૌર્ય
Jagatjit Singh|જગતજિત સિંઘ
Muhammad bin Qasim|મહંમદ બિન કાસિમ
Justin Bieber|જસ્ટિન બીબર
Agatha Christie|અગાથા ક્રિસ્ટી
Ho Chi Minh|હો ચી મિન્હ
Andrea Bowen|એન્ડ્રીઆ બોવેન
Charles, Prince of Wales|પ્રિન્સ ચાર્લ્સ
Richard Dawkins|રીચાર્ડ ડાકિન્સ
Prem Das Rai|પ્રેમ દાસ રાઈ
Amjad Khan|અમજદ ખાન
Warren Buffett|વોરન બફેટ
M. Night Shyamalan|એમ. નાઈટ શ્યામલન
Sunita Williams|સુનીતા વિલિયમ્સ
Otto Hahn|otto hahn
Suravaram Sudhakar Reddy|સુવરામ સુધાકર રેડ્ડી
C. V. Raman|સી. વી. રામન
Shanta Meena Bhaskar|શાંતા મીના ભાસ્કર
G. A. Kulkarni|જી. એ. કુલકર્ણી
Max Schmeling|મેક્સ સચમેલીંગ
James Chadwick|જેમ્સ ચૅડવિક
Susan Boyle|સુસાન બોયલ
Eddie Hopson|એડી હોપ્સન
Harold Gomes|હેરોલ્ડ ગોમ્સ
Jesse James Leija|જેસી જેમ્સ લૈજા
George Michael|જ્યોર્જ માઇકલ
Lee Kuan Yew|લી ક્વાન યૂ
Amartya Sen|અમર્ત્ય સેન
Zab Judah|ઝબ જુડાહ
Manobala|મનોબલા
Zakir Hussain|ઝાકીર હુસૈન
Saadat Hasan Manto|સઆદત હસન મન્ટો
Reena Roy|રીના રોય
Vidya Balan|વિદ્યા બાલન
Ezra Pound|એઝરા પાઉન્ડ
Farah Khan|ફરાહ ખાન
Kate Hudson|કેટ હડસન
Mani Ratnam|મણિરત્નમ
Chen-ning Yang|યંગ ચેન નીંગ
Zeenat Aman|ઝીનત અમાન
Rocky Marciano|રોકી માર્કિયાનો
Premendra Mitra|પ્રેમેન્દ્ર મિત્ર
Jimmy Walker|જીમ્મી વોકર
Bhāskara II|ભાસ્કરાચાર્ય
Ismail I|ઈસ્માઇલ પહેલા
Sean Combs|શોન કોમ્બ્સ
George Gurdjieff|ગુર્જીય્ફ
Zora Folley|ઝોરા ફોલી
Olympias|ઓલીમ્પીઅસ
Xanthippe|ઝેંથીપી
Y. Gee. Mahendra|વાય જી. મહેન્દ્ર
Kalpana Chawla|કલ્પના ચાવલા
Sarojini Naidu|સરોજિની નાયડુ
Saif Ali Khan|સૈફ અલી ખાન
Devan|દેવાન
Rabia of Basri|રાબિયા બસરી
Rishi Kapoor|ઋષિ કપૂર
Mallika Sherawat|મલ્લિકા શેરાવત
Diana Hayden|ડાયાના હેડેન
Satyen Kappu|સત્યેન કપ્પુ
Bhavana|ભાવના
George Herbert Mead|જ્યોર્જ હર્બર્ટ મીડ
Kabir|સંત કબીર
Mahesh Bhupathi|મહેશ ભૂપતિ
V. V. Giri|વરાહગીરી વેંકટગીરી
John Abraham|જોન અબ્રાહમ
Gopal Krishna Gokhale|ગોપાલ કૃષ્ણ ગોખલે
Bindusara|બિન્દુસાર
Jack Johnson|જેક જોનસન
James J. Braddock|જેમ્સ જે બ્રાડોક
Gulzarilal Nanda|ગુલઝારીલાલ નંદા
Abhinav Bindra|અભિનવ બિંદ્રા
DaVarryl Williamson|ડાવરિલ વિલિયમસન
Kiran Nagarkar|કિરણ નગરકર
Harold Johnson|હેરોલ્ડ જોહન્સન
Vyasa|વ્યાસ
R. K. Narayan|આર. કે. નારાયણ
Pramathesh Barua|પ્રમાથેશ બરુઆ
Ram Mohan Roy|રાજા રામ મોહનરાય
Neelam Sanjiva Reddy|નીલમ સંજીવ રેડ્ડી
Ajith Kumar|અજીથ કુમાર
Bert Cooper|બર્ટ કૂપર
Sunil Dutt|સુનિલ દત્ત
Bismillah Khan|બિસ્મિલ્લાહ ખાન
Marco Casagrande|માર્કો કાસાગ્રાન્ડ
Mehdi Hassan|મહેદી હસન
Laila Mehdin|લૈલા મેહદીન
Persis Khambatta|પર્સીસ ખંભાતા
Parysatis II|પેરાસાટીસ II
Yusuf Dadoo|યુસુફ દાદૂ
Leela Chitnis|લીલા ચીટસીન
M. S. Subbulakshmi|એમ. એસ. સુબ્બુલક્ષ્મી
Razia Sultana|રઝીયા સુલ્તાન
Kavita Krishnamurthy|કવિતા કૃષ્ણમૂર્તિ
Jim Corbett|જીમ કોર્બેટ
Gulzar|ગુલઝાર
Dhirubhai Ambani|ધીરુભાઈ અંબાણી
Sneha Ullal|સ્નેહા ઉલ્લલ
Bhairon Singh Shekhawat|ભૈરોં સિંઘ શેખાવત
Naseeruddin Shah|નસીરુદ્દીન શાહ
Geeta Dutt|ગીતા દત્ત
MS Dhoni|મહેન્દ્ર સિંહ ધોની
Andrew Carnegie|એન્ડ્રુ કાર્નેગી
Mahalakshmi Iyer|મહાલક્ષ્મી ઐયર
Saul Bass|સાઉલ બાસ
Shobha Gurtu|શોભા ગુર્તું
Angiras|અંગિરસ
Chandralekha|ચંદ્રલેખા (નૃત્યાંગના)
Chittaranjan Das|ચિત્તરંજનદાસ
Kapila|કપિલ
Anu Malik|અનુ મલિક
John Lindsay|જોન લીન્ડસે
Subhashree Ganguly|સુભાશ્રી ગાંગુલી
Tisca Chopra|ટિસ્કા ચોપડા
Sohrab Modi|સોહરાબ મોદી
Chandra Shekhar Azad|ચંદ્રશેખર આઝાદ
Yeghishe Charents|યેઘીશે ચારેન્ત્સ
Jaggi Vasudev|જગ્ગી વાસુદેવ
Baldev Raj Chopra|બળદેવ રાજ ચોપરા
Aditya Dev|આદિત્ય દેવ
Todar Mal|ટોડરમલ
Sohail Khan|સોહેલ ખાન
Halle Berry|હેલ બેરી
Yashpal|યશપાલ
Viola Paulitz|Viola Müller-Paulitz
Fatma Begum|ફાતિમા બેગમ
Ghiyath al-Din Tughluq|ગયાસુદ્દીન તઘલખ
Allan Border|એલન બોર્ડર
Vilayat Khan|ઉસ્તાદ વિલાયતખાં
Himesh Reshammiya|હિમેશ રેશમિયા
Krishna Das|ક્રિષ્ના દાસ
Ramanuja|રામાનુજાચાર્ય
Deepika Kumari|દીપિકા કુમારી
Sohrab Hossain|સોહરાબ હુસેન
Bapsi Sidhwa|બાપ્સી સિધવા
Tyagaraja|ત્યાગરાજ
Padma Sachdev|પદ્મા સચદેવ
S. P. Balasubrahmanyam|એસ. પી. બાલાસુબ્રમણ્યમ
Hariharan|હરિહરન
Jayachandran|જયચંદ્રન
A. P. Komala|એ.પી. કોમલાં
Kamsa|કંસ
Vishnuvardhan|વિષ્ણુવર્ધન
Varsha Bhosle|વર્ષા ભોંસલે
Sukhwinder Singh|સુખવિન્દર સિંહ
Vikram|વિક્રમ
Zaheer Khan|ઝહીર ખાન
Abida Parveen|આબીદા પરવીન
Sonu Sood|સોનુ સૂદ
N. T. Rama Rao|એન ટી રામા રાવ
Alokranjan Dasgupta|આલોકંજન દાસગુપ્ત
David Frawley|વામદેવ શાસ્ત્રી
Madan Mohan Malaviya|મદન મોહન માલવીયા
Dayaram|દયારામ
Shivaram Rajguru|રાજગુરુ
Saba Karim|સબા કરીમ
Zaheer Abbas|ઝહીર અબ્બાસ
Lokanatha Swami|લોકનાથ સ્વામી મહારાજ
Ahilyabai Holkar|અહિલ્યાબાઈ હોળકર
Avinash Vyas|અવિનાશ વ્યાસ
Vikash Maharaj|વિકાસ મહારાજ
Chandrashekarendra Saraswati|ચંદ્રશેખરેન્દ્ર સરસ્વતી
Hazari Prasad Dwivedi|આચાર્ય હજારી પ્રસાદ દ્વિવેદી
Vijay Merchant|વિજય મર્ચંટ
Karsan Ghavri|કરસન ઘાવરી
Birju Maharaj|બિરજુ મહારાજ
Utpal Dutt|ઉત્પલ દત્ત
|આર્યશૂર
Shubha Mudgal|શુભા મુદ્ગલ
Madakari Nayaka|મડકરી નાયક
Ishwar Petlikar|ઇશ્વર પેટલીકર
Bhakti Vikasha Swami|ભક્તિ વિકાસ સ્વામી
Umar Ughratdar|ઉમર ઉઘરાતદાર
Karsanbhai Patel|કરસનભાઇ પટેલ
Kanaji Thakor|કાનાજી ઠાકોર
Krishnakant Kadkia|કૃષ્ણકાન્ત કડકિયા
Gangasati|ગંગાસતી
Gulabdas Broker|ગુલાબદાસ બ્રોકર
Mulayam Singh Yadav|મુલાયમ સિંહ યાદવ
Nayanthara|નયનતારા
Chunilal Madia|ચુનીલાલ મડિયા
Javagal Srinath|જવગલ શ્રીનાથ
Ranjitsinhji|જામ રણજી
Jhaverchand Meghani|ઝવેરચંદ મેઘાણી
|ડૉ. રમણીકલાલ દોશી
Jivraj Narayan Mehta|ડો. જીવરાજ નારાયણ મહેતા
Digant Oza|દિગન્ત ઓઝા
Dinkar Joshi|દિનકર જોશી
Dhiruben Patel|ધીરુબેન પટેલ
Nandkumar Pathak|નંદકુમાર પાઠક
Narayan Divecha|નારાયણ દીવેચા
Panna Naik|પન્ના નાયક
Prahalad Chunnilal Vaidya|પી. સી. વૈદ્ય
Prof. Kasturi Laxmi Nrusiham|પ્રો. કસ્તૂરી લક્ષ્મી નૃસિંહમ
Balmukund Dave|બાલમુકુન્દ દવે
B. S. Chandrasekhar|ભાગવત ચંદ્રશેખર
Bhikhudan Gadhavi|ભીખુદાન ગઢવી
Madhusudan Parekh|મધુસૂદન પારેખ
Manhar Modi|મનહર મોદી
Manubhai Trivedi|મનુભાઇ ત્રિવેદી
Mahipatram Nilkanth|મહીપતરામ નીલકંઠ
Madhav Ramanuj|માધવ રામાનુજ
|મુનિ જિનવિજ્યજી
Rajnikant Vanmalidas Trivedi|રજનીકાંત વનમાળીદાસ ત્રિવેદી
Ravi Upadhyay|રવિ ઉપાધ્યાય
Lovji Nusserwanjee Wadia|લવજી વાડિયા
Vaziruddin Alvi|વઝીરુદ્દીન અલવી
|શામળદાસ
Sundarji Betai|સુંદરજી બેટાઇ
Subroto Banerjee|સુબ્રતો બેનરજી
Himanshi Shelat|હિમાંશી શેલત
Hiralal Tribhuvandas Parekh|હીરાલાલ પારેખ
Upendranath Ashk|ઉપેન્દ્રનાથ અશ્ક
Abhijeet Bhattacharya|અભિજિત ભટ્ટાચાર્ય
Anil Kumble|અનિલ કુમ્બલે
Balivada Kantha Rao|બલિવડ કાન્તા રાવ
Sundara Ramaswamy|સુંદર રામાસ્વામી
Jatindra Nath Das|યતીન્દ્રનાથ દાસ
Ramdhari Singh Dinkar|રામધારી સિંહ 'દિનકર'
David Boon|ડેવિડ બુન
Edasseri Govindan Nair|ઈદસ્સેરી ગોવિંદન નાયર
Girija Devi|ગિરિજા દેવી
Jayakanthan|જયકાન્તન
Ken Fyfe|કેન ફાઇફ
Usha Mangeshkar|ઉષા મંગેશકર
Muddassar Aziz|મુદ્દસર અઝીઝ
Sandeep Unnikrishnan|સંદીપ ઉન્નીક્રિષ્નન
Kamaladevi Chattopadhyay|કમલાદેવી ચટ્ટોપાધ્યાય
Syed Mustafa Siraj|સૈયદ મુસ્તફા સિરાજ
Falguni Roy|ફાલ્ગુની રોય
Nataraja Ramakrishna|નટરાજા રામકૃષ્ણ
Rajnath Singh|રાજનાથ સિંહ
Mallika Sarabhai Shah|મલ્લિકા સારાભાઈ શાહ
Ravi Shastri|રવિ શાસ્ત્રી
Sam Pitroda|સત્યનારાયણ ગંગારામ પિત્રોડા
Bombay Jayashri|બોમ્બે જયશ્રી
Priyamani|પ્રિયામણિ
Vishnu Sakharam Khandekar|વિષ્ણુ સખારામ ખાંડેકર
Rohit Sharma|રોહિત શર્મા
Sudha Murthy|સુધા મૂર્તિ
Kamalinee Mukherjee|કમલીની મુખર્જી
Samantha Akkineni|સામંથા અક્કીનેની
Brijesh Patel|બ્રિજેશ પટેલ
Robin Singh|રોબિનસિંઘ
Andrea Jeremiah|એન્ડ્રીયા જેરિયામ
Cheran|ચેરન
Nagma|નગમા
Bhadrabahu|આચાર્ય ભદ્રબાહુ
Dinesh Trivedi|દિનેશ ત્રિવેદી
Biju Patnaik|બીજુ પટનાયક
S. Venkatesan|એસ. વેંકટેશન
Nitya Chaitanya Yati|નિત્ય ચૈતન્ય યતિ
Napoleon|નેપોલિયન
Bhavatharini|ભવથરીની
K. Bhagyaraj|કે ભાગ્યરાજ
Vivek Vaswani|વિવેક વાસવાની
Adhyayan Suman|અધ્યયન સુમન
Ashmit Patel|અસ્મિત પટેલ
Anand Bhate|આનંદ ભાટે
C. Narayana Reddy|સી નારાયણા રેડ્ડી
Protima Bedi|પ્રોતિમા બેદી
Manoj Kumar Pandey|મનોજ કુમાર પાંડે
V. K. Gokak|વી.કે.ગોકક
Arun Jaitley|અરુણ જેટલી
Maṇḍana Miśra|મંદના મિસરા
Pandurang Mahadev Bapat|પાંડુરંગ મહાદેવ બાપટ
Batukeshwar Dutt|બટુકેશ્વર દત્ત
Hirabai Barodekar|હીરાબાઈ બારોદેકર
Bhisham Sahni|ભીષ્મ સાહની
Raghav Sachar|રાઘવ સચાર
N. G. Chandavarkar|નારાયણ ગણેશ ચંદાવરકર
Amarinder Singh|અમરિંદર સિંહ
Pritam Chakraborty|પ્રીતમ ચક્રવર્તી
Govardhanram Tripathi|ગોવર્ધનરામ ત્રિપાઠી
Kishan Maharaj|કિશન મહારાજ
Rayapati Sambasiva Rao|રાયપાટિ સાંબશિવ રાવ
Ram Sarup Ankhi|રામ સરૂપ અણ્ખી
Digvijaysinhji Ranjitsinhji|દિગ્વિજયસિંહજી જાડેજા
Sandeep Acharya|સંદિપ આચાર્ય
Hema Sardesai|હેમા સરદેસાઈ
A. Nayyar|એ. નૈયર
A. R. Reihana|એ. આર. રેહાના
A. Sampath|એ૰ સમ્પત્ત
Aadesh Shrivastava|આદેશ શ્રીવાસ્તવ
Abhay Bhushan|અભય ભૂષણ
Adil Hussain|આદિલ હુસૈન
Yogi Adityanath|યોગી આદિત્યનાથ
Adriaen Honich|Adriaen Honich
Albert Ekka|આલ્બર્ટ એક્કા
Alfred S. Yue|આલ્ફ્રેડ એસ. યુ
Amit Trivedi|અમિત ત્રિવેદી
Amitabh Bhattacharjee|અમિતાભ ભટ્ટાચારજી
Ammannur Rajaneesh Chakyar|અમ્માનુર રજનીશ ચાક્યર
Amri Hernández-Pellerano|અમરી હર્નાન્ડેઝ-પેલેરેનો
Amrut Ghayal|અમૃત ઘાયલ
Anand|આનંદ
Anandaraj|આનંદરાજ
Anandiben Patel|આનંદીબેન પટેલ
Andrew Goldstein|એન્ડ્ર્યુ ગોલ્ડસ્ટેઇન
Angel Gaud Gonzalez|એન્જલ ગૌડ ગોન્ઝાલેઝ
Anil Dhawan|અનિલ ધવન
Anita Guha|અનિતા ગુહા
Anita Kanwar|અનિતા કંવર
Arijit Singh|અરિજીત સિંઘ
Janaki Ammal|જાનકી અમ્મલ
Arthur Frederick Ostrander|આર્થર ફ્રેડરિક stસ્ટ્રાન્ડર
Arunima Kumar|અરૂણીમા કુમાર
Barindra Kumar Ghosh|બારિન્દ્રકુમાર ઘોષ
Bhagatji Maharaj|ભગતજી મહારાજ
Bhagwant Maan|ભગવંત માન
Bhumman Shah|ભુમ્મન શાહ
Bhupen Khakhar|ભૂપેન ખખ્ખર
Bina Das|બીના દાસ
Bob McMath|બોબ મેકમેથ
Bradley Alpert|બ્રેડલી અલ્પર્ટ
Brij Bhushan Sharan Singh|બ્રિજ ભૂષન કારણ સિંહ
Brij Krishna Chandiwala|બ્રિજ કૃષ્ણ ચાંદીવાલા
Carl E. Taylor|કાર્લ ઇ. ટેલર
Charles Bazerman|ચાર્લ્સ બેઝર્મન
Charles Speziale|ચાર્લ્સ સ્પીઝિયલ
Chester Kahapea|ચેસ્ટર કહપિયા
Christopher Rose|ક્રિસ્ટોફર રોઝ
Clarence Madison Dally|ક્લેરેન્સ મેડિસન ડેલી
Dadasaheb Torne|દાદાસાહેબ તોરણે
Dalpat Singh Paraste|દલપત સિંહ પરસ્તે
Gopaldas Ambaidas Desai|ગોપાળદાસ અંબઈદાસ દેસાઈ
Jagannatha Varma|જગન્નાથ વર્મા
Deenanath Mangeshkar|દીનાનાથ મંગેશકર
Deepak Pandya|દીપક પંડ્યા
Delores M. Etter|ડેલોરેસ એમ. ઇટ્ટે
Dharmendra Yadav|ધર્મેન્દ્ર યાદવ
Dharmesh Yelande|ધર્મેશ યેલાંદે
Dileep Singh Bhuria|દિલીપ સિંહ ભૂરિયા
Dona Ganguly|ડોના ગાંગુલી
E. T. Mohammed Basheer|ઇ૰ટી૰ મુહમ્મદ બશીર
Esha Kansara|એશા કંસારા
Stateira II|સ્ટટેરા
Gajanan Kirtikar|ગજાનન કીર્તિકર
Ganesh Singh|ગણેશ સિંહ
Gautam Adani|ગૌતમ અદાણી
Stanley Coren|સ્ટેન્લી કોરેન
Gunvant Shah|ગુણવંત શાહ
Gurbachan Singh Salaria|ગુરબચ્ચન સિંહ સલારીઆ
Tushar Gandhi|તુષાર ગાંધી
Nilakantha Das|નિલકંઠ દાસ
Hoshiar Singh|હોશિયાર સિંહ
Koppula Hemadri|કોપપુલા હેમાદ્રી
Shruti Pathak|શ્રુતિ પાઠક
Jay Prakash Narayan Yadav|જય પ્રકાશ નારાયણ યાદવ
Jayamant Mishra|જયમંત મિશ્ર
Jerry Pinto|જેરી પિન્ટો
Jual Oram|જુએલ ઉરાંવ
Jvālāmukhi|જ્વાલામુખી
Jyotsna Patel|જ્યોત્સના પટેલ
K. D. Thirunavukkarasu|કે. ડી. થીરુનાવક્કારાસુ
K. H. Muniyappa|કે. એચ. મુનિયપ્પા
Kadiyam Srihari|કડિયમ શ્રીહરી
Karamshi Jethabhai Somaiya|કરમશી જેઠાભાઈ સોમૈયા
Kovi. Manisekaran|કોવિ. મણિશેખરન
Ku. Alagirisami|જી. અલગીરીસામી
Kumarpal Desai|કુમારપાળ દેસાઈ
Kuttikrishna Marar|કુટ્ટીકૃષ્ણ મરાર
Lakshmi Thiripurasundari|લક્ષ્મી ત્રિપુરસુંદરી
Lalji Tandon|લાલજી ટંડન
Lalubhai Patel|લાલૂભાઈ પટેલ
Laxman Mane|લક્ષ્મણ માને
Lil Bahadur Chettri|લીલ બહાદુર છેત્રી
Nana Fadnavis|નાના ફડણવીસ
Liton Das|લિટન દાસ
M. K. Menon|એમ. કે. મેનન
Madhav Singh Solanki|માધવસિંહ સોલંકી
Madhu Purnima Kishwar|મધુ કિશ્વર
Manav Gohil|માનવ ગોહીલ
Manilal Dwivedi|મણિલાલ દ્વિવેદી
Mansoor Akhtar|મંસૂર અખ્તર
Shamsur Rahman Faruqi|શમ્સુર રહેમાન ફારુકી
Meena Khadikar|મીના ખાડિકર
Mehar Chand Bhaskar|મહેરચંદ ભાસ્કર
Minoo Masani|મીનૂ મસાની
Mohammad Farooq|મોહમ્મદ ફારૂક
Mohammad Javed|મોહમ્મદ જાવેદ
Munawwar Rana|મુનવ્વર રાણા
N. P. Mohammed|એન. પી. મોહમ્મદ
Naiyer Masud|નૈયર મસુદ
Nand Kishore Acharya|નંદકિશોર આચાર્ય
Narla Venkateswara Rao|નાર્લા વેંકટેશ્વર રાવ
Natwarsinhji Bhavsinhji|નટવરસિંહજી ભાવસિંહજી
Nihalchand Chauhan|નિહાલચન્દ ચૌહાન
Nrisingha Prasad Bhaduri|નૃસિંહ પ્રસાદ ભાદુડી
P. Jadeja|પૃથ્વીરાજસિંહજી જાડેજા
Premanand Bhatt|પ્રેમાનંદ
Pujya Mota|પૂ. મોટા
Rajat Dholakia|રજત ધોળકિયા
Rajiv Satav|રાજીવ શંકરરાવ સાતવ
Ranchordas Pagi|રણછોડદાસ પગી
Ranjan Gogoi|રંજન ગોગોઈ
Ranjeet Ranjan|રંજીત રંજન
Ratna Pathak|રત્ના પાઠક
Rosemary Conley|રોઝમેરી કોન્લી
Shaitan Singh|સૈતાન સિંઘ
Shamal Bhatt|શામળ ભટ્ટ
Shankar Chaudhary|શંકરભાઈ ચૌધરી
Shankarlal Banker|શંકરલાલ બેંકર
Siddharth Randeria|સિદ્ધાર્થ રાંદેરીયા
Sultan Ahmed|સુલ્તાન અહમદ
Surjit Paatar|સુરજીત પાતર
Teejan Bai|તીજનબાઈ
Vijayalaya Chola|વિજયાલય ચોલ
Binod Bihari Chowdhury|બિનોદ બિહારી ચૌધરી
Jannat Mahid|જન્નત
Anicia Proba|Anicia Proba
Shantilal Jamnadas Mehta|શાંતિલાલ જમનાદાસ મહેતા
Shahaji|શાહજી
G. M. Siddeswara|જી૰એમ૰ સિદ્ધેશ્વર
Surya Narayan Vyas|સૂર્યનારાયણ વ્યાસ
François Fug|fug
K. C. Venugopal|કે૰સી૰ વેણુગોપાલ
Rajendra Bhatia|GANIT SHASTRI
K.P. Bhaskar|કે.પી.ભાસ્કર
Maharani Chimnabai|મહારાણી ચિન્મનાબાઇ
Mohanlal Saksena|મોહનલાલ સક્સેના
Pankaj Charan Das|પંકજ ચરણ દાસ
Achuta Manasa|અચુત મનસા
Nand Kumar Singh Chauhan|નન્દ કુમાર સિંહ ચૌહાન
Dinesh Kashyap|દિનેશ કશ્યપ
Deven Bhojani|દેવેન ભોજાણી
Sonthi Venkata Ramamurthy|સોન્તી વેંકટ રામામૂર્તિ
Uday Pratap Singh|ઉદય પ્રતાપ સિંહ
Sukhbir Singh Jaunapuria|સુખબીર સિંહ જૌનપુરિયા
Murugashankari Leo|મુરુગાશંકરી લીઓ
Revanta Sarabhai|રેવંતા સારાભાઈ
Anju Bala|અંજૂ બાલા
Riti Pathak|રીતિ પાઠક
Virendra Kumar Choudhary|વીરેન્દ્ર કુમાર ચૌધરી
Subhreet Kaur Ghumman|સુભ્રીત કૌર ઘુમ્મન
Jam Sahib|જામ સાહેબ
Anshul Verma|અંશુલ વર્મા
Choudhary Babulal|બાબૂલાલ
Dushyant Chautala|દુષ્યંત ચૌટાલા
Gokaraju Ganga Raju|ગોકરાજૂ ગંગા રાજૂ
C. S. Puttaraju|સી૰એસ૰ પુત્તારાજૂ
Jayant Sinha|જયંત સિન્હા
Kamalbhan Singh Marabi|કમલભાન સિંહ મરાવી
Kesineni Srinivas|કેશિનેનિ શ્રીનિવાસ
Balabhadra Majhi|બલભદ્ર માઝી
Rama Kishore Singh|રામ કિશોર સિંહ
Ranjit Singh Brahmpura|રણજીત સિંહ
Ravindra Kumar Ray|રવિન્દ્ર કુમાર રાય
Saumitra Khan|સૌમિત્ર ખાન
Tamradhwaj Sahu|તામ્રધ્વજ સાહૂ
Varaprasad Rao Velagapalli|વરપ્રસાદ રાવ વેલગપલ્લિ
B N Chandrappa|બી૰એન૰ ચન્દ્રપ્પા
Bhagirath Prasad|ભાગીરથ પ્રસાદ
Keshav Prasad Maurya|કેશવ પ્રસાદ મૌર્ય
Lallu Singh|લલ્લૂ સિંહ
Ram Charitra Nishad|રામ ચરિત્ર નિષાદ
Sharad Bansode|શરદ બનસોડે
Sankar Prasad Datta|શંકર પ્રસાદ દત્તા
G. Hari|હરિ જી૰
Shrirang Barne|શ્રીરંગ બરને
P.R. Senthilnathan|પીઆર સેંથિલનાથાન
Mahendran C|સી૰ મહેન્દ્રન
Selvakumara Chinnayan S|સેલ્વાકુમારા ચિન્નયન એસ૰
Kalyan Banerjee|કલ્યાણ બનર્જી
J. Jayavardhan|જે૰ જયવર્ધન
K. Prasad Babu|કે પ્રસાદ બાબુ
Chandubhai Deshmukh|ચંદુભાઈ દેશમુખ
Anil Kumar Tyagi|અનિલકુમાર ત્યાગી
Naomi Osaka|નાઓમી ઓસાકા
Dheera Bhagat|ધીરા પ્રતાપ બારોટ
Kishansinh Chavda|કિશનસિંહ ચાવડા
Harivallabh Bhayani|હરિવલ્લભ ભાયાણી
Vinod Patney|વિનોદ પટની
Durga Charan Panigrahi|દુર્ગા ચરણ પાણિગ્રહી
Anshuman Rath|અંશુમન રથ
Kanan Gill|કાનન ગિલ
Tapan Misra|તપન મિશ્રા
Yadvendrasinhji|યાદવેન્દ્રસિંહજી જાડેજા
Jürg Stäubli|Jürg Stäubli
Anna Hopkins|Anna Hopkins
|હરજી ભાટી
Shankar Abaji Bhise|શંકર અબાજી ભિસે
Dilip Dholakia|દિલિપ ધોળકિયા
Surya Deva Ramchandra Rao|એસ.આર.રાવ
|ચીનુભઈ પટવા
Sadhu Singh|સાધુ સિંહ
Kanu Bhagdev|કનુ ભગદેવ
Nabhi|નાભિરાજ
|રાગીણી
Soumya Swaminathan|સૌમ્યા સ્વામિનાથન
G. Satheesh Reddy|જી.સતીશ રેડ્ડી
Ketan Panchal|કેતન પંચાલ
Dharmendrasinh Jadeja|ધર્મેન્દ્ર જાડેજા
Monil Patel|મોનીલ પટેલ
Padmarani|પદ્મારાણી
Sakshi Dhoni|સાક્ષી ધોની
Harshad Trivedi|હર્ષદ ત્રિવેદી
Subbarama Swaminathan|સુબ્બારામા સ્વામીનાથન
Bindu Bhatt|બિંદુ ભટ્ટ
Jhano Hansdah|ઝાનો હંસદાહ
Lalubha Jadeja|લાલુભા જાડેજા
Alvira Khan Agnihotri|અલ્વીરા ખાન અગ્નિહોત્રી
Esha Dadawala|એષા દાદાવાળા
Ankit Trivedi|અંકિત ત્રિવેદી
Suman Shah|સુમન શાહ
Pravin Pandya|પ્રવીણ પંડ્યા
Saumya Joshi|સૌમ્ય જોશી
Pushpalata Das|પુષ્પલતા દાસ
Varun Singh Bhati|વરૂણસિંહ ભાટી
Marudevi|મરુદેવી
Keshavrao Sonawane|કેશવરાવ સોનવણે
Alain de Chambrier|Alain de Chambrier
Vrajlal Shastri|વ્રજલાલ કાલિદાસ શાસ્ત્રી
Rahul Guhathakurta|રાહુલ ગુહથકુરતા
Mahant Swami Maharaj|મહંત સ્વામી મહારાજ
Rakesh Upadhyay|રાકેશ ઉપાધ્યાય
Dipna Patel|દિપ્ના પટેલ
Keshavlal Bhatt|કેશવલાલ ભટ્ટ
Durlabharaja|દુર્લભરાજ
Bhima II|ભીમદેવ દ્વિતીય
Shrikant Shah|શ્રીકાંત શાહ
Tarini Desai|તારિણી દેસાઈ
Eusebio Calonge Francés|Eusebio Calonge Francés
Joaquín Pla Laporta|Joaquín Pla Laporta
Indrajeet Mitra|ઈંદ્રજિત મિત્રા
Raam Mori|રામ મોરી
Dileep Jhaveri|દિલીપ ઝવેરી
Steven Pruitt|સ્ટીવન પ્રુઇટ
Varun Kumar|વરુણ કુમાર
Abish Mathew|અબીશ માથે
Jeejeebhoy Piroshaw Bomanjee Jeejeebhoy|જીજીભોય પિરોશો બોમનજી
Prajakta Koli|પ્રાજક્તા કોલી
Anjali Khandwalla|અંજલિ ખાંડવાળા
Kenneth Sebastian|કેની સેબાસ્ટિયન
Janmashankar Buch|જન્મશંકર મહાશંકર બૂચ
Ramchandra Patel|રામચંદ્ર પટેલ
Sharifa Kasambhai Vijaliwala|શરીફા વીજળીવાળા
Jacopo Orsini|Jacopo Orsini
|નટવરલાલ વીમાવાળા
Sarojini Mehta|સરોજીની મહેતા
Amitabh Madia|અમિતાભ મડિયા
Sheila Darshan|શૈલા દર્શન
Janak Dave|જનક દવે
Gokuldas Tejpal|ગોકુલદાસ તેજપાલ
Victor-Charles-Émile Dain|Victor-Charles-Émile Dain
Rambha Gandhi|રંભા ગાંધી
|ભોગીન્દ્ર દિવેટીયા
Ilene Marckx|Ilene Marckx
Jyoti Kapur Das|જ્યોતિ કપુર દાસ
Aayushi Dholakia|આયુષી ધોળકિયા
Ansuya Trivedi|અનસૂયા ત્રિવેદી
Anupriya Lakra|અનુપ્રિયા લકરા
Devaj V|દેવજ વિ
Mohanlal Chunilal Dhami|મોહનલાલ ચુનીલાલ ધામી
A. H. Jami|એ. એચ. જામી
Lianne Witkin|Lianne Witkin
Teodor Rusev|Teodor Rusev
Khodidas Parmar|ખોડીદાસ પરમાર
Rokas Kmieliauskas|Rokas Kmieliauskas
Marc Oliver Pritzen|Marc Oliver Pritzen
Tsveta Nesheva|Tsveta Nesheva
Doreen Weise|Doreen Weise
Nele Van Den Bossche|Nele Van Den Bossche
Sandra Degueldre|Sandra Degueldre
Claudia Marietta|Claudia Marietta
Karry Ellen Hellmuth|Karry Ellen Hellmuth
Patricia Hempel|Patricia Hempel
Ann Roegiers|Ann Roegiers
Saskia Van Duuren|Saskia Van Duuren
Marieke Haverdings|Marieke Haverdings
Luisiana Pegoraro|Luisiana Pegoraro
Erika Schertl|Erika Schertl
Deira Mari|Deira Mari
Nadia Zuccherelli|Nadia Zuccherelli
Silvia Zoller|Silvia Zoller
Elfie Kunz|Elfie Kunz
Karin Avenant|Karin Avenant
Ljudmilla Corneo|Ljudmilla Corneo
Cornelia Dreher|Cornelia Dreher
Manhar Raskapur|મનહર રસકપુર
Dadudan Gadhvi|દાદુદાન ગઢવી
Durgashankar Shastri|દુર્ગાશંકર શાસ્ત્રી
Mārtiņš Bots|Mārtiņš Bots
Dahyabhai Dholashaj|ડાહ્યાભાઈ ધોળશાજી
Detelina Marinova|Detelina Marinova
Dawn Richardson Wilson|Dawn Richardson Wilson
Mike Evelyn|Mike Evelyn
Jashvant Thaker|જશવંત ઠાકર
Kenny Weyh|Kenny Weyh
Joyce Echaquan|Joyce Echaquan
Jimmy Wales|જિમ્મી વેલ્સ
Larry Sanger|લેરી સેંગર
Adolf Hitler|એડોલ્ફ હિટલર
Michael Bloomberg|માઈકલ બ્લુમબર્ગ
Leonardo da Vinci|લિઓનાર્ડો દ વિન્ચી
Mahatma Gandhi|મહાત્મા ગાંધી
Bruce Springsteen|બ્રુસ સ્પ્રિન્ગસ્ટીન
M. C. Escher|એમ. સી. એસ્ચર
Huang Xianfan|હુઆંગ ઝીયાન-ફાન
Rembrandt|રૅમ્બ્રાં હાર્મેન્ઝૂન વાન રીન
Che Guevara|ચે ગૂવેરા
Alan Turing|ઍલન ટ્યુરિંગ
Vasco da Gama|વાસ્કો દ ગામા
Martin Luther King Jr.|માર્ટિન લ્યૂથર કિંગ
Alexander the Great|સિકંદર
Timur|તૈમુરલંઘ
Thomas Alva Edison|થૉમસ ઍડિસન
Nikola Tesla|નિકોલા ટેસ્લા
Gautama Buddha|ગૌતમ બુદ્ધ
Vallabhbhai Patel|સરદાર વલ્લભભાઈ પટેલ
Rahul Gandhi|રાહુલ ગાંધી
Dadabhai Naoroji|દાદાભાઈ નવરોજી
Pythagoras|પાયથાગોરસ
David Beckham|ડેવિડ બેકહામ
George Soros|જયોર્જ સોરોસ
Esther David|એસ્થર ડેવિડ
B. Y. Raghavendra|બી. વાય. રાઘવેન્દ્ર
Madhubala|મધુબાલા
Waris Ahluwalia|વારિસ આહલુવાલિયા
Asha Bhosle|આશા ભોંસલે
Bertolt Brecht|બર્ટોલ્ટ બ્રેખ્ત
Heath Ledger|હિથ લેજર
Lobsang Sangay|લોબસંગ સંગે
Frank Lampard|ફ્રેન્ક લેમ્પાર્ડ
Viswanathan Anand|વિશ્વનાથ આનંદ
Antara Mali|અંતરા માલી
Shyam Benegal|શ્યામ બેનેગલ
K. R. Meera|કે. આર. મીરા
S. M. Krishna|એસ. એમ. કૃષ્ણ
Kurt Goldstein|કર્ટ ગોલ્ડસ્ટીન
Akshaya|અક્ષયા
Mileva Marić|માલેવા મેરીક
Ruth Pfau|રૂથ ફાઉ
A. R. Rahman|એ. આર. રહેમાન
Niels Henrik Abel|નીલ્સ હેન્રીક અબૅલ
William Hazlitt|વિલિયમ હેઝલિટ
M. G. Ramachandran|કરુણાનિધિ
Hugh Jackman|હ્યુજ જેકમેન
Sangita|સંગીતા
Haruki Murakami|હારુકી મુરાકામી
Janani Iyer|જનની અય્યર
Nutan Bahl|નૂતન
Buddhadeb Bose|બુદ્ધદેવ બોઝ
Deepika Padukone|દીપિકા પાદુકોણ
Angelo Dundee|એન્જેલો ડંડી
Roxana|રુખસાના
Jack Palance|જેક પેલાન્સ
Rajendra Prasad|રાજેન્દ્ર પ્રસાદ
Brian Lara|બ્રાયન લારા
Brahmagupta|બ્રહ્મગુપ્ત
Alexandros IV of Macedon|મેસેડોનના એલેકઝાંડર IV
Rajendra Chola I|રાજેન્દ્ર ચોલ પ્રથમ
John Boyd Dunlop|જોન બોય્ડ ડનલોપ
Akshay Kumar|અક્ષય કુમાર
Robert Noyce|રોબર્ટ નોર્ટન નોયસી
Asaf Avidan|અસાફ અવીડાન
Anita Desai|અનિતા દેસાઈ
Shilpa Shetty|શિલ્પા શેટ્ટી
Rohini|રોહિણી
Shriya Saran|શ્રિયા સરન
Amrita Rao|અમૃતા રાવ
Karl Pearson|Karl Pearson
Fiorello H. La Guardia|ફીઓરેલ્લો એચ. લા ગાર્ડિયા
Nathuram Godse|નથુરામ ગોડસે
Imran Khan|ઇમરાન ખાન
Chiranjeevi|ચિરંજીવી
Evander Holyfield|એવેન્ડર હોલીફિલ્ડ
Jyotirao Phule|જ્યોતિબા ફુલે
Abdur Rashid Kardar|અબ્દુલ રશીદ કરદાર
Shahid Kapoor|શાહિદ કપૂર
Booker T. Washington|બુકર ટી.વોશિંગ્ટન
Rakesh Sharma|રાકેશ શર્મા
Michael Nunn|માઇકલ નન
Raja Ravi Varma|રાજા રવિ વર્મા
Zail Singh|ગ્યાની ઝૈલસીંઘ
Annada Shankar Ray|અન્નદાશંકર રૅ
C. Rajagopalachari|સી. રાજગોપાલાચારી
D. K. Pattammal|ડી. કે. પટ્ટમાંલ
Fatima Jinnah|ફાતિમા ઝીણા
Aparna Sen|અપર્ણા સેન
Meira Kumar|મીરા કુમાર
J. R. D. Tata|જે. આર. ડી. ટાટા
Tansen|તાનસેન
Kishore Kumar|કિશોર કુમાર
Alan Shearer|એલન શીયરર
Rani Mukherjee|રાની મુખર્જી
Humayun|હુમાયુ
Nalinidhar Bhattacharya|નલિનીધર ભટ્ટાચાર્ય
Kailashpati Mishra|કૈલાશપતિ મિશ્રા
Garikapati Varalakshmi|ગરિકપતિ વરલક્ષ્મી
Savitri Jindal|સાવિત્રી જિંદાલ
Srividya|શ્રીવિદ્યા
Khwaja Abdullah Ansari|ખ્વાજા અબ્દુલ્લા અન્સારી
Uday Chopra|ઉદય ચોપરા
Priti Patel|પ્રીતિ પટેલ
Aruna Lama|અરુણા લામા
Palden Thondup Namgyal|પાલ્દેન થોન્દુપ નામગ્યાલ
Uma Mohan|ઉમા મોહન
Naushad|નૌશાદ અલી
Sindhu Menon|સિંધુ મેનન
Gangubai Hangal|ગંગુબાઇ હંગલ
Riteish Deshmukh|રિતેશ દેશમુખ
Riya Sen|રિયા સેન
Kumārila Bhaṭṭa|કુમારિલ ભટ્ટ
Uday Prakash|ઉદય પ્રકાશ
B. S. Yeddyurappa|બી૰ એસ૰ યેદિયુરપ્પા
Dattatreya|દત્તાત્રેય
Chaitanya Mahaprabhu|ચૈતન્ય મહાપ્રભુ
Dr. Zakir Naik|ઝાકિર નાઇક
Azam Khan|આઝમ ખાન
Nirad C. Chaudhuri|નિરદ સી. ચૌધરી
Purushottam Das Tandon|પુરુષોત્તમદાસ ટંડન
Courtney Walsh|કર્ટની વોલ્સ
D. V. Sadananda Gowda|ડી૰ વી૰ સદાનંદ ગૌડ઼ા
Jaishankar Prasad|જયશંકર પ્રસાદ
Sakyong Mipham|સક્યોંગ મીફામ
Nissim Ezekiel|નિસ્સીમ ઇઝેકિલ
Sunil Mittal|સુનિલ ભારતી મિત્તલ
Jeev Milkha Singh|જીવ મિલખા સિંઘ
Ruskin Bond|રસ્કિન બૉન્ડ
Mani Madhava Chakyar|માણી માધવ ચાક્યાર
Lala Lajpat Rai|લાલા લાજપતરાય
Daniel Selvaraj|ડૅનિયલ સેલ્વરાજ
Bharath Gopi|ભરથ ગોપી
Satadhanvan|શતાવધાન
Mubarak|મુબારક
Suchitra Krishnamoorthi|સુચિત્રા કૃષ્ણમૂર્તિ
Lillete Dubey|લિલેટ ડૂબે
Muhammad of Ghor|મહંમદ ઘોરી
Sergey Nikolayevich Lazarev|સેર્ગેઈ નિકોલાઇવિચ લઝારેવ
Shyamji Krishna Varma|શ્યામજી કૃષ્ણ વર્મા
U. N. Dhebar|ઉચ્છંગરાય નવલશંકર ઢેબર
Nikhil Mathew|નિખિલ માથેવ
Kamla Beniwal|ડૉ.કમલા બેનિવાલ
Nirmal Verma|નિર્મલ વર્મા
Shanta Kumar|શાંતા કુમાર
B. Arundhathi|બી.અરુન્ધત્તિ
Gayatri Asokan|ગાયત્રી અશોકન
A. M. Rajah|એ. એમ. રાજહ
Roshini|રોશીની
Chinmayi Sripada|ચિન્મયી શ્રીપાડા
Malgadi Subha|માલગાડી સુભા
Swarnalatha|સ્વર્ણાલથા
L. R. Eswari|એલ.આર. એસ્વારી
G. Venugopal|જી. વેણુગોપાલ
Vineeth Sreenivasan|વિનિથ શ્રીનિવાસમ
Vijay Yesudas|વિજય યેસુદાસ
Kishori Amonkar|કિશોરી આમોનકર
R. A. Ramamani|આર.એ. રામમાંની
Mamoni Raisom Goswami|ઈન્દિરા ગોસ્વામી
Sujit Kumar|સુજીત કુમાર
Akrit Jaswal|આક્રિત જસવાલ
Tawrat|તૌરાત
T. A. S. Mani|ટી.એ.એસ. મણિ
Nasir ud din Mahmud|giyasuddin tughlau
Shrutakarma|શ્રુતકીર્તિ
Tina Desai|ટીના દેસાઈ
Rattanbai Jinnah|મરિયમ ઝીણા
Sangram Singh I|રાણા સાંગા
Namdev|નામદેવ
Pannalal Ghosh|પં. પન્નાલાલ ઘોષ
Kumar Pallana|કુમાર પલ્લાના
Yo Yo Honey Singh|યો યો હની સિંગ
Randhir Kapoor|રણધીર કપૂર
Suhasi Goradia Dhami|સુહાસી ધામી
Tina Ambani|ટીના મુનિમ
Ambareesh|અંબરીશ
Kanaiyalal Maneklal Munshi|કનૈયાલાલ મુનશી
|અક્કલ સાહેબ
Agrasena|અગ્રસેન
Amarsinh Chaudhary|અમરસિંહ ચૌધરી
Amrit Keshav Nayak|અમૃત કેશવ નાયક
Jayapataka Swami|જયપતાકા સ્વામી
Sunita Narain|સુનિતા નારાયણ
Ashok Dave|અશોક દવે
Sunidhi Chauhan|સુનિધિ ચૌહાણ
Pratap Singh I|મહારાણા પ્રતાપ
Rajendra Keshavlal Shah|રાજેન્દ્ર કેશવલાલ શાહ
Indeevar|ઇન્દીવર
Tim Zoehrer|ટિમ ઝોહરર
Kiran More|કિરણ મોરે
Anand Bakshi|આનંદ બક્ષી
Pankaj Udhas|પંકજ ઉધાસ
Sachin Dev Burman|એસ.ડી. બર્મન
Vikram Batra|વિક્રમ બત્રા
Rahul Bajaj|રાહુલ બજાજ
K. Shankar Pillai|કે. શંકર પિલ્લાઈ
Mariam uz-Zamani|મરિયમ ઉજ઼-જ઼માની
Tillakaratne Dilshan|તિલકરત્ને દિલશાન
Mayurasharma|મયુરવર્મા
Ruswa Majhalumi|ઇમામુદ્દીન મુર્તુઝાખાન બાબી
Chitra Singh|ચિત્રા સિંઘ
Shreyas Talpade|શ્રેયાંસ તળપડે
Tusshar Kapoor|તુષાર કપૂર
Kirti Azad|કિર્તિ આઝાદ
Varun Gandhi|વરુણ ગાંધી
|ખીમ સાહેબ
Gundappa Viswanath|ગુંડપ્પા વિશ્વનાથ
Gunatitanand Swami|ગુણાતીતાનંદ સ્વામી
Chandravadan Mehta|ચંદ્રવદન મહેતા
Vaikom Muhammad Basheer|વૈકોમ મુહમ્મદ બશીર
Chandshi Vittaladas Oriya|ચાંપશી ઉદેશી
P. K. Sethi|પ્રમોદ કરણ સેઠી
Chimanlal Trivedi|ચીમનલાલ ત્રિવેદી
Chetan Sharma|ચેતન શર્મા
Jayant Pathak|જયંત પાઠક
Dahyabhai Derasari|ડાહ્યાભાઇ દેરાસરી
Trijata|ત્રિજટા (રામાયણ)
Digish Mehta|દિગીશ મહેતા
Devayat Pandit|દેવાયત પંડિત
Dhanvant Oza|ધનવંત ઓઝા
Nagindas Marfatiya|નગીનદાસ મારફતિયા
|નથુરામ
Nityanand Swami|નિત્યાનંદ સ્વામી
Nirmish Thaker|નિર્મિશ ઠાકર
Pranlal Kharsani|પી. ખરસાણી
Babalbhai Mehta|બબલભાઈ મહેતા
|ભીમ સાહેબ
Bhrugurai Anjaria|ભૃગુરાય અંજારિયા
Manubhai Pancholi|મનુભાઈ પંચોળી
Mareez|મરીઝ
Mahesh Choksi|મહેશ ચોક્સી
Mukundray Pattani|મુકુન્દરાય પટ્ટણી
Moraridas Hariyani|મોરારીદાસ હરીયાણી
Mohanlal Desai|મોહનલાલ દેસાઈ
|યશવંત શુક્લ
Ramanlal Soni|રમણલાલ સોની
|રવિ સાહેબ
Roopshankar Oza|રૂપશંકર ઓઝા
Venibhai Purohit|વેણીભાઈ પુરોહિત
|શ્રી ભાણદેવ
Sairam Dave|સાંઇરામ દવે
Harnish Jani|હરનીશ જાની
Hasmukh Pathak|હસમુખ પાઠક
Kaushiki Chakrabarty|કૌશિકી ચક્રવર્તી
Anandi Gopal Joshi|આનંદી ગોપાલ જોષી
Anita Nair|અનિતા નાયર
Babita|બબીતા
Bidhan Chandra Roy|બિધાન ચંદ્ર રોય
Salim Ali|સલીમ અલી
G. Sankara Kurup|ગોવિંદ શંકર કુરુપ
Jibanananda Das|જીવનાનંદ દાસ
Prabhas|પ્રભાસ
Iqbal Bahu|ઇકબાલ બહુ
Irfan Habib|ઈરફાન હબીબ
Isaac Rousseau|આઇઝેક રુસો
Suresh Wadkar|સુરેશ વાડકર
Asaduddin Owaisi|અસદુદીન ઓવૈસી
Ashok Gehlot|અશોક ગેહલોત
Gopalkrishna Gandhi|ગોપાલકૃષ્ણ ગાંધી
Muzaffar Ahmed|મુઝફ્ફર અહેમદ
Kalpana Datta|કલ્પના દત્ત
Kuvempu|કુવેમ્પુ
Bishnu Dey|વિષ્ણુ દે
Kumarapala|કુમારપાળ
Kailash Satyarthi|કૈલાશ સત્યાર્થી
Roy Gilchrist|રોય ગિલક્રિસ્ટ
Sidharth Malhotra|સિદ્ધાર્થ મલ્હોત્રા
Mamta Kulkarni|મમતા કુલકર્ણી
Veerappa Moily|એમ૰ વીરપ્પા મોઇલી
Dinesh Karthik|દિનેશ કાર્તિક
Bishan Singh Bedi|બિશનસિંઘ બેદી
Leela Naidu|લીલા નાયડુ
Lala Amarnath|લાલા અમરનાથ
Shakeela|શકીલા
Bhanupriya|ભાનુપ્રિયા
Vinoo Mankad|વિનુ માંકડ
Amala Paul|અમલા પોલ
Gulabrai Ramchand|ગુલાબરાય રામચંદ
Ulloor S. Parameswara Iyer|અલ્લૂર એસ પરમેશ્વરા yerયર
Vasudev Balwant Phadke|વાસુદેવ બળવંત ફડકે
Arshad Ayub|અરશદ અય્યુબ
Leela Samson|લીલા સેમસન
Prapanchan|પ્રપંચન
Archana|અર્ચના
M. T. Vasudevan Nair|એમ. ટી. વાસુદેવન નાયર
Karthik Siva kumar|કાર્તિ
Vijayakanth|વિજયકાંત
Nusli Wadia|નસ્લી વાડિયા
Arjun Sarja|અર્જુન સરજા
Bhagyashree Patwardhan|ભાગ્યશ્રી પટવર્ધન
Rachana Narayanankutty|રચના નારાયણકુટ્ટી
Kavi Pradeep|કવિ પ્રદીપ
Somnath Sharma|સોમ નાથ શર્મા
Begum Akhtar|બેગમ અખ્તર
Asrani|અસરાની
Shweta Menon|શ્વેતા મેનન
Tarabai|તારાબાઈ
Sarika|સારિકા
Sharada|શ્રદ્ધા
Abhirami|અભિરામી
Navya Nair|નવ્યા નાયર
Divya Unni|દિવ્યા ઉન્ની
Mullappally Ramachandran|મુલ્લાપલ્લી રામચંદ્રન
Riyaz Khan|રિયાઝ ખાન
Masti Venkatesha Iyengar|મસ્તી વેંકટેશ અય્યંગાર
Sangeeta Bijlani|સંગીતા બિજલાની
Ila Arun|ઈલા અરુણ
Viswanatha Satyanarayana|વિશ્વનાથ સત્યનારાયણ
Kusumagraj|કુસુમાગ્રાજ
Piru Singh|પીરૂ સિંઘ
Mrinalini Sarabhai|મૃણાલિની સારાભાઇ
Chandrashekhara Kambara|ચંદ્રશેખર કંબાર
Talat Mahmood|તલાટ મહમૂદ
Padmini Kolhapure|પદ્મિની કોલ્હાપુરી
Anil Mehta|અનિલ મહેતા
Mohnish Bahl|મોહનીશ બહલ
Shiv Kumar Batalvi|શિવકુમાર બટાલવી
B. C. Khanduri|ભુવન ચન્દ્ર ખણ્ડૂરી
Mika Singh|મીકા સિંહ
Kalpana Lajmi|કલ્પના લાજમી
Prashant Tamang|પ્રશાંત તમાંગ
Sulakshana Pandit|સુલક્ષણા પંડિત
Govind Chandra Pande|ગોવિંદચંદ્ર પાંડે
Ali Zafar|અલી ઝફર
Vibhuti Narain Rai|વિભૂતિ નારાયણ રાય
Vishnu Prabhakar|વિષ્ણુ પ્રભાકર
Shamshad Begum|શમશાદ બેગમ
Robin Bhatt|રોબીન ભટ્ટ
Katie Stevens|Katie Stevens
Kanva|કણ્વ
Bhartruhari Mahtab|ભર્તુહરી મહતાબ
Musharaff Moulamia Khan|મુશર્રફ મૌલા મિયા ખાન
A. S. Gnanasambandan|એ. એસ. જ્ઞાનસંબંધન
Aadhavan Sundaram|આધવન સુંદરમ
Aanchal Kumar|આંચલ કુમાર
Aarthi|આરતી
Abu Ishaq Shami|અબૂ ઇસ્હાક ચિશ્તી
Adriaen Cornelisz Beeldemaker|Adriaen Cornelisz Beeldemaker
Ahana Deol|અહાના દેઓલ
Aldas Janaiah|અલદાસ જાનાયાં
Alfred Lee Loomis|આલ્ફ્રેડ લી લૂમિસ
Alfred Tyrone Cooke|આલ્ફ્રેડ ટાયરોન કૂક
Ambikagiri Raichoudhury|અંબિકાગીરી રાયચૌધરી
Amit Dolawat|અમિત દોલાવત
Amit Sadh|અમિત સાધ
Amit Sial|અમિત સિયાલ
Amita Nangia|અમિતા નંગીયા
Amruta Khanvilkar|અમૃતા ખાનવિલકર
Anamika Saha|અનામિકા સાહા
Ananth Punyamurthula|અનંત પુણ્યમૂર્તુલા
Anil Potti|અનિલ પોટ્ટી
Anil Yadav|અનિલ યાદવ
Anjali Kulkarni|અંજલિ કુલકર્ણી
Anjali Sudhakar|અંજલિ સુધાકર
Anju Aravind|અંજુ અરવિંદ
Anthony Cortese|એન્થોની કોર્ટીસ
Ardeshir Tarapore|અરદેશીર તારાપોર
Arul Chinnaiyan|અરુલ ચિનાઇયાન
Arun Khetarpal|અરૂણ ખેતરપાલ
Atul Kumar|અતુલ કુમાર
B. G. Horniman|બી. જી. હોર્નિમન
Babu Suthar|બાબુ સુથાર
Babubhai P. Vaidya|બાબુભાઇ પી. વૈદ્ય
Badruddin Tyabji|બદરુદ્દીન તૈયબજી
Baldev Singh|Baldev singh
Berry Sarbadhikari|બેરી સરબધિકારી
Bhavya Gandhi|ભવ્ય ગાંધી
Bijoya Chakravarty|વિજય ચક્રવર્તી
Brahmanand Swami|બ્રહ્માનંદ સ્વામી
Brockway McMillan|બ્રોકવે મેકમિલેન
C. G. Devashar|સી જી. દેવશર
Catherine Bertini|કેથરિન બર્ટીની
Chandraswami|chandraswami
Chandu Lal Sahu|ચંદૂલાલ સાહૂ
Charles Bailyn|ચાર્લ્સ બેઇલીન
David M. Brienza|ડેવિડ એમ. બ્રિએન્ઝા
Debora Shuger|ડેબોરા શુગર
Denis La Fontaine|ડેનિસ લા ફોન્ટાઈન
Dilip Parikh|દિલીપ પરીખ
Dilipkumar Mansukhlal Gandhi|દિલીપકુમાર મનસુખલાલ ગાંધી
Fardunjee Marzban|ફરદુનજી મર્ઝબાન
George B. McClellan, Jr.|જ્યોર્જ બી. મેકક્લેલ્ન, જુનીયર
Ghanashyam Nayak|ઘનશ્યામ નાયક
Haku Shah|હકુ શાહ
Hansraj Gangaram Ahir|હંસરાવ ગંગારામ અહીર
Harbhajan Singh|હરભજન સિંહ
Harish Chaudhary|હરીશ ચૌધરી
Hiren Gohain|હિરેન ગોહાઇન
Jagdu Shah|જગડુશા
Jogendra Nath Mandal|jogendra nath mandle
John Wilson|જ્હોન વિલ્સન
K. V. Thomas|કે૰વી૰ થૉમસ
Kakoli Ghosh Dastidar|કલ્કલી ઘોષ
Kalraj Mishra|કલરાજ મિશ્રા
Kanjibhai Patel|કાનજીભાઇ મગનભાઇ પટેલ
Kapil Sharma|કપિલ શર્મા
Ketki Dave|કેતકી દવે
Ki. Rajanarayanan|કિ. રાજનારાયણન
Konakalla Narayana Rao|કે૰ નારાયણ રાવ
Kumarsen Samarth|કુમારસેન સમર્થ
Kundurti Anjaneyulu|કુંદુર્તિ આંજનેયુલુ
Laishram Jyotin Singh|લઈશરામ જ્યોતિન સિંઘ
Laxman Sivaramakrishnan|લક્ષ્મણ શિવરામક્રિષ્ણન
Leela Roy|લીલા રોય
Mahim Bora|મહિમ બરા
Mamang Dai|મમંગ દાઈ
Mangesh Padgaonkar|મંગેશ પાડગાંવકર
Manibhai Desai|મણીભાઈ ભીમભાઈ દેસાઈ
Manohar Shyam Joshi|મનોહર શ્યામ જોશી
Masood Anwar|મસૂદ અનવર
Mazhar Hussain|મઝહર હુસેન
Mehta|મહેતા
Mekapati Rajamohan Reddy|એમ૰ રાજામોહન રેડ્ડી
Mohammad Akram|મોહમ્મદ અક્રમ
Mohammad Saeed|મોહમ્મદ સઈદ
Mohammad Salman|મોહમ્મદ સલમાન
Mohammad Talha|મોહમ્મદ તલ્હા
Mohan Singh|મોહનસિંહ
Moti Lal Saqi|મોતીલાલ સાકી
Mridula Garg|મૃદુલા ગર્ગ
Muzafar II|મુઝફ્ફરશાહ બીજો
N. K. Mahajan|એન.કે. મહાજન
Na. Parthasarathy|ના. પાર્થસારથી
Nalin Kumar Kateel|નલિન કુમાર કટીલ
Narsinhrao Divetia|નરસિંહરાવ દિવેટિયા
Neela Padmanabhan|નીલ પદ્મનાભન
Nityanand Kanungo|નિત્યાનંદ કાનુગો
P. K. Sreemathy|પી૰કે૰ શ્રીમતી
Panna Dai|પન્ના ધાઈ
Prahlad Singh Patel|પ્રહલાદ સિંહ પટેલ
Pratap Chandra Lal|પ્રતાપચંદ્ર લાલ
Preetika Rao|પ્રતિકા રાવ
Pucadyil Ittoop John|પુકાડૈલ ઇત્તોપ જ્‌હોન
Pushpdan Shambhudan Gadhavi|પુષ્પદાન શંભુદાન ગઢવી
RJ Balaji|આર.જે.બાલાજી
Ra Graharipu|રા' ગ્રહરિપુ
Rajendrasinh Ghanshyamsinh Rana|રાજેન્દ્રસિંહ ઘનશ્યામસિંહ રાણા
Ramen Deka|રામેન ડેકા
Ramesh Chandra Majumdar|રમેશચંદ્ર મજમુદાર
Ranchhodbhai Udayaram Dave|રણછોડભાઈ દવે
Rani Karnavati|rani karnavati
Ravindra Kumar Pandey|રવિન્દ્ર કુમાર પાણ્ડેય
Ravji Patel|રાવજી પટેલ
Rekha Godbole|રેખા ગોડબોલે
S. P. Y. Reddy|એસ૰પી૰વાઈ૰ રેડ્ડી
Sandhya Roy|સંધ્યા રૉય
Santokben Jadeja|santokben jadeja
Shobha Karandlaje|શોભા કારનદલાજે
Suresh Angadi|અંગદિ સુરેશ ચન્નાબસપ્પા
Theodore Hope|થિઓડોર હોપ
Vasant Desai|વસંત દેસાઈ
Vinod Kinariwala|વિનોદ કિનારીવાલા
Vinod Kumar Boianapalli|વિનોદ કુમાર બોયનાપલ્લી
Vishnu Pandya|વિષ્ણુ પંડ્યા
Maharani Yesubai|યેસુબાઈ
Zabiuddin Ansari|અબુ હમઝા
Sandhu Singh Gurbir|સંધુસિંહ ગુરબીર
Kedarnath Singh|કેદારનાથ સિંઘ
Bhau Daji|ભાઉ દાજી
Magnus Manske|મેગ્નસ મેન્સકે
Jugatram Dave|જુગતરામ દવે
Rohini Bhate|રોહીની ભાટે
Bhavina Hasmukhbhai Patel|ભાવિના હસમુખભાઈ પટેલ
Preetam Das|સર્જક:પ્રીતમ
Jinvijay|જિનવિજયજી
Medha Yodh|મેધા યોધ
Man Mohan Sinha|મન મોહન સિંહા
Vibhut Shah|વિભૂત શાહ
Rattan Lal Kataria|રતન લાલ કટારિયા
Navdeep Asija|નવદીપ એસિજા
Haribhai Parthibhai Chaudhary|હરિભાઈ ચૌધરી
Chhedi Paswan|છેદી પાસવાન
Ashley Lobo|એશલી લોબો
Raghav Juyal|રાઘવ જુયાલ
Udai Mazumdar|ઉદય મજમુદાર
Jyotiraditya Scindia|જ્યોતિરાદિત્ય સિંધિયા
Gaurav Gogoi|ગૌરવ ગોગોઈ
Neha Tanwar|નેહા તન્વર
Mohanlal Pandya|મોહનલાલ પંડ્યા
Ashwini Kumar Chopra|અશ્વિની કુમાર
Sudhangshu Singh Deo|સુધાંગશુ સિંહ દેવ
Bodh Singh Bhagat|બોધ સિંહ ભગત
Subhash Bhamre|સુભાષ રામરાવ ભામરે
Chirag Paswan|ચિરાગ પાસવાન
Harish Meena|હરીશચન્દ્ર મીણા
Anoop Mishra|અનૂપ મિશ્રા
Priyanka Singh Rawat|પ્રિયંકા સિંહ રાવત
Giriraj Singh|ગિરિરાજ સિંહ
Vinodbhai Chavda|વિનોદ ચાવડ઼ા
Vishnu Dayal Ram|વિષ્ણુ દયાલ રામ
Roopa Unnikrishnan|રૂપા ઉન્નીકૃષ્ણન
Vibhandak Rishi|વિભંડક
Arvind Sawant|અરવિંદ સાવંત
Devusinh Jesingbhai Chauhan|દેવસિંહ ચૌહાન
P. V. Midhun Reddy|પી૰વી૰ મિધુન રેડ્ડી
Santosh Kumar|સંતોષ કુમાર
Vijay Sampla|વિજય સાંપલા
Nagendra Kumar Pradhan|નાગેન્દ્ર કુમાર પ્રધાન
Bharat Singh|ભરત સિંહ
Harish Dwivedi|હરીશ દ્વિવેદી
Dharmendra Kashyap|ધર્મેન્દ્ર કશ્યપ
Kaushal Kishore|કૌશલ કિશોર
P P Choudhary|પી૰પી૰ ચૌધરી
Hemant Godse|હેમન્ત ગોડસે
Sumedhanand Saraswati|સુમેધાનન્દ સરસ્વતી
R.Parthipan|આર૰ પાર્થીપન
Maragatham K|મરગતમ કે૰
Jashodaben Narendrabhai Modi|જશોદાબેન મોદી
Thomas Velley|Thomas Velley
Satyapal Singh Saini|સત્યપાલ સિંહ
Arun Kumar|અરુણ કુમાર
Harivansh Singh|કુઁવર હરિવંશ સિંહ
Shrenik Kasturbhai Lalbhai|શ્રેણીક કસ્તુરભાઈ લાલભાઈ
Jitu Rai|જીતુ રાય
Sucheta Bhide Chapekar|સુચેતા ભીડે ચાપેકર
Kalamandalam Sivan Namboodiri|કલામંડલમ્ શિવાન નંબુદિરી
Howard Gobioff|હોવાર્ડ ગોબિઓફ
Atul Verma|અતુલ વર્મા
Akshat Singh|અક્ષતસિંહ
Sujjan Singh|સુજ્જન સિંહ
Ranvirsinhji|રણવીરસિંહજી જાડેજા
Chunilal Vaidya|ચુનીલાલ વૈદ્ય
Ghelubhai Nayak|ઘેલુભાઇ નાયક
Neeraj Kumar Singh|નીરજ કુમાર સિંઘ
Indumati Babuji Patankar|ઈન્દુમતી બાબુજી પાટણકર
Sharad Thaker|ડૉ. શરદ ઠાકર
Nakar|કવિ નાકર
Perin Captain|પેરિન કેપ્ટન
Rama Mehta|રમા મેહતા
Arvind Pandya|અરવિંદ પંડ્યા
|તન્મય વેકરિયા
Mayur Wakani|મયુર વાકાણી
Maniben Kara|મણિબેન કારા
Vihang A. Naik|વિહંગ એ. નાઈક
Muktesh Kumar|મુક્તેશકુમાર
Gautam Shah|ગૌતમ શાહ
Tanya Madhwani|તાન્યા માધવાણી
Rajesh Chandrasekar|રાજેશ ચંદ્રસેકર
Nandshankar Mehta|નંદશંકર મહેતા
Kiransinh Chauhan|કિરણસિંહ ચૌહાણ
Godji I|ગોડજી પ્રથમ
Khengara|રા ખેંગાર દ્વિતિય
Rashid Meer|રશીદ મીર
Isha Ambani|ઇશા અંબાણી
Sushila Charak Singh Khan|સુશીલા ચરક
Udayan Thakker|ઉદયન ઠક્કર
Kavat|રા' કંવાટ
Nayan Desai|નયન દેસાઈ
Harish Meenashru|હરીશ મીનાશ્રુ
Shivani Kataria|શિવાની કટારિયા
Mariyappan Thangavelu|મરિયપ્પન થાંગાવેલુ
Jitu Vaghani|જીતુ વાઘાણી
Rita Kothari|રીટા કોઠારી
Nazir Dekhaiya|નાઝિર દેખૈયા
Chhotalal Kalidas Travadi|છોટાલાલ કાળીદાસ ત્રાવડી
Kavita Nehemiah|કવિતા નહેમાયાહ
Ila Arab Mehta|ઈલા આરબ મહેતા
Ajayapala|અજયપાળ
Pablo Pintado|Pablo Pintado
Malhar Thakar|મલ્હાર ઠાકર
Jacques Rousseau|જાક રૂસો
Nadir Alvarez|Nadir Alvarez
Frank Hauenschild|Frank Hauenschild
Kanchanrai Girajashankar Desai|કંચનરાય ગીરજાશંકર દેસાઈ
Suhas Biswas|સુહાસ બિસ્વાસ
Sati Loyan|લોયણ
Swati Nanda|સ્વાતી નંદા
Mukul Choksi|મુકુલ ચોક્સી
Viru Purohit|વીરુ પુરોહિત
Bapulal Nayak|બાપુલાલ નાયક
Pinglshi Patabhai Narela|પિંગળશી પાતાભાઈ નરેલા
Gangabai Yagnik|ગંગાબાઈ યાજ્ઞિક
Kaneez Surka|કનીઝ સુરકા
Vijay Shastri|વિજય શાસ્ત્રી
Vipin Parikh|વિપિન પરીખ
Sylvia Hoffman|Sylvia Hoffman
Durgaram Mehta|દુર્ગારામ મહેતાજી
|તેજપાળ
Indira Nair|ઈન્દિરા નાયર
Manibhai Jashbhai|મણિભાઈ જશભાઈ
CarryMinati|અજેય નાગર
Jimmy Nanda|જીમી નંદા
Liam Christie|Liam Christie
Keaan Van Venrooij|Keaan Van Venrooij
Cristina Michelle Mata Pitti|Cristina Michelle Mata Pitti
Nikola Levkov|Nikola Levkov
Virag Buzsaki|Virag Buzsaki
Jennifer Manefield|Jennifer Manefield
Caroline Payot-Podevin|Caroline Payot-Podevin
Rhonda Quick|Rhonda Quick
Letizia Giardinelli|Letizia Giardinelli
Valentina Poli|Valentina Poli
Maya Escolar|Maya Escolar
Simone Trafelet|Simone Trafelet
Tara Mulder|Tara Mulder
Cindy Bauwens|Cindy Bauwens
Gitana Gruodyte|Gitana Gruodyte
Ruth Ellway|Ruth Ellway
Moira Tarraran|Moira Tarraran
Carolyn Maxwell|Carolyn Maxwell
Juri Gatt|Juri Gatt
Ionuț Șișcanu|Ionuț Șișcanu
Natalia Jamróz|Natalia Jamróz
Sebastian Mitterer|Sebastian Mitterer
Gira Sarabhai|ગિરા સારાભાઈ
Hasit Buch|હસિત બૂચ
Phil Harres|Phil Harres
Jannis Maul|Jannis Maul
Barack Obama|બરાક ઓબામા
Napoleon|નેપોલિયન બોનાપાર્ટ
Louis Pasteur|લૂઈ પાશ્ચર
Joseph Stalin|સ્ટાલિન
Jawaharlal Nehru|જવાહરલાલ નેહરુ
Arnold Schwarzenegger|આર્નોલ્ડ શ્વાર્ઝેનેગર
Michael Jackson|માઇકલ જેકસન
Miley Cyrus|માઇલી સાઇરસ
Confucius|કન્ફ્યુશિયસ
Larry Page|લૅરી પેજ
Mustafa Kemal Atatürk|કમાલ મુસ્તફા અતાતુર્ક
Bill Gates|બિલ ગેટ્સ
Mark Twain|માર્ક ટ્વેઇન
Joseph Fourier|જોસેફ ફૂરિયર
Noam Chomsky|નોઆમ ચોમ્સ્કી
Immanuel Kant|ઇમેન્યુએલ કેન્ટ
Adam Smith|આદમ સ્મિથ
Tiger Woods|ટાઇગર વુડ્સ
Al-Biruni|અલ બિરૂની
Freddie Mercury|ફ્રેડી મર્ક્યુરી
Abraham Maslow|અબ્રાહમ મેસ્લો
Raja Ramanna|રાજા રમન્ના
Abdus Salam|અબ્દુસ સલામ
Rituparno Ghosh|રિતુપર્ણો ઘોષ
Linus Torvalds|લિનસ ટોરવાલ્ડ્સ
Benazir Bhutto|બેનઝિર ભુટ્ટો
Robert Pattinson|રોબર્ટ પેટિસન
Isaiah Mustafa|ઇસૈયાહ મુસ્તફા
Anuradha Paudwal|અનુરાધા પૌડવાલ
Abel Tasman|અબેલ તાસ્માન
Gauri Khan|ગૌરી ખાન
N. Santhanam|એન.સંતનામ
Aishwarya Rai|ઐશ્વર્યા રાય
Liaqat Hayat|લિયાકત હયાત
J. J. Thomson|જે જે થોમસન
Pratibha Patil|પ્રતિભા પાટીલ
Bobby Deol|બોબી દેઓલ
Patrick Conley|પેટ્રિક કૉન્લી
Rambhadracharya|જગદ્‌ગુરુ રામભદ્રાચાર્ય
Vishwas Patil|વિશ્વાસ પાટીલ
Kedar Joshi|કેદાર જોશી
Anand Yadav|આનંદ યાદવ
Geeta Sane|ગીતા સાને
Vijaya Rajadhyaksha|વિજ્યા રાજાધ્યક્ષ
Prachi Desai|પ્રાચી દેસાઈ
Wolfgang Pauli|વુલ્ફગૅંગ પાઉલી
Samuel Morse|સેમ્યુઅલ મોર્સ
Firaq Gorakhpuri|ફિરાક ગોરખપુરી
Srinivasa Ramanujan|શ્રીનિવાસ રામાનુજન
Bob Hope|બોબ હોપ
Ravi Shankar|રવિ શંકર
Carlos Hernández|કાર્લોસ હર્નાન્ડિઝ
Vanessa Hudgens|વેનેસા હજિન્સ
Mike Anchondo|માઇક એન્કોન્ડો
Amrita Sher-Gil|અમૃતા શેરગિલ
Manna Dey|મન્ના ડે
Juhi Chawla|જુહી ચાવલા
Sonia Gandhi|સોનિયા ગાંધી
Sumitranandan Pant|સુમિત્રાનંદન પંત
Adi Shankara|આદિ શંકરાચાર્ય
Ramdas Gandhi|રામદાસ ગાંધી
Julian Schwinger|જુલિયન શ્વાઇન્ગર
Abhishek Bachchan|અભિષેક બચ્ચન
Panini|અષ્ટાધ્યાયી
Lakshmi Mittal|લક્ષ્મી મિત્તલ
Tor Hamer|ટોર હેમર
Rudy Giuliani|રૂડી ગીયુલીયાની
Morarji Desai|મોરારજી દેસાઈ
Raynell Williams|રેનેલ વિલિયમ્સ
Danny Trejo|ડેની ટ્રેજો
Dayananda Saraswati|મહર્ષિ દયાનંદ
Vandana Shiva|વંદના શિવા
Hugh Masekela|હ્યુ માસેકેલા
Bob Montgomery|બોબ મોન્ટગોમરી
Radhika|રાધિકા
Ashokan|અશોકન
Kaveri|કાવેરી
Madhu|મધુ
Indrajith Sukumaran|ઇન્દ્રજીથ સુકુમારન
Imelda Marcos|ઇમેલ્ડા માર્કોસ
Ramdev|બાબા રામદેવ
Ramana Maharshi|રમણ મહર્ષિ
Nusrat Fateh Ali Khan|નુસરત ફતેહ અલી ખાન
Bal Gangadhar Tilak|લોકમાન્ય ટિળક
Anant Nag|અનંત નાગ
Salman Khurshid|સલમાન ખુર્શીદ
Sonny Liston|સોની લિસ્ટન
Anil Kapoor|અનિલ કપૂર
Sachin Pilot|સચિન પાયલોટ
Elon Musk|એલોન મસ્ક
Ike Williams|ઇકે વિલિયમ્સ
Derrick Jefferson|ડેરીક જેફરસન
Victor McLaglen|વિક્ટર મેક્લેગન
Joe Brown|જોઈ બ્રાઉન
Ranjit Singh Sandhu|રણજીતસિંહ
Tim Austin|ટિમ ઓસ્ટીન
Alan Paton|એલન પેટોન
Vikram Seth|વિક્રમ શેઠ
Sake Dean Mahomed|શેખ દીન મોહમ્મદ
U. G. Krishnamurti|યુ.જી.કૃષ્ણમુર્તિ
Jaya Bachchan|જ્યા ભાદુરી બચ્ચન
Lakshmi Sahgal|લક્ષ્મી સહેગલ
David Dinkins|ડેવિડ ડીંકીન્સ
Parveen Babi|પરવીન બાબી
Karan Johar|કરણ જોહર
Kim Sharma|કિમ શર્મા
Harry Brearley|હેરી બ્રેર્લી
Rahul Dravid|રાહુલ દ્રવિડ
Kumaraswami Kamaraj|કે. કામરાજ
Simi Garewal|સિમી ગરેવાલ
Babul Supriyo|બાબુલ સુપ્રિયો
Kapil Dev|કપિલ દેવ
Sourav Ganguly|સૌરવ ગાંગુલી
Sanjay Leela Bhansali|સંજય લીલા ભણશાળી
Trilok Gurtu|ત્રિલોક ગુર્તું
Siddharth Anand|સિદ્ધાર્થ આનંદ
Ernst Stojaspal|Ernst Stojaspal
Arthur Conley|આર્થર કોન્લી
Zeng Liansong|ઝેન્ગ લિઆનસોન્ગ
William Wilson|વિલિયમ વિલ્સન(તરણશાસ્ત્રી)
Babur|બાબર
Boman Irani|બોમન ઈરાની
Varāhamihira|વરાહમિહિર
K. Sachhidanandan|કે. સચ્ચિદાનંદન
Vasudeva|વસુદેવ
Mahadev Govind Ranade|મહાદેવ ગોવિંદ રાનડે
Fei Xiaotong|ફઇ ઝીઓ-તોગ
Mansoor Ali Khan Pataudi|મંસૂર અલી ખાન પટૌડી
Tatya Tope|તાત્યા ટોપે
Gorakhnath|ગોરખનાથ
Matamela Cyril Ramaphosa|સિરિલ રામાફોસા
Umashankar Joshi|ઉમાશંકર જોશી
Dorabji Tata|સર દોરાબજી તાતા
Ela Gandhi|ઈલા ગાંધી
Sharman Joshi|શર્મન જોશી
Kalki Krishnamurthy|કલ્કિ કૄષ્ણમૂર્તિ
Prakash Padukone|પ્રકાશ પદુકોણ
Sushma Swaraj|સુષ્મા સ્વરાજ
Sujatha Mohan|સુજાતા મોહન
Manjari Babu|માંજારી બાબુ
Unni Menon|ઉન્ની મેનોન
Pradip Somasundaran|પ્રદીપ સોમસુંદરન
Chaitra H. G.|ચૈત્રા એચ. જી.
Kozhikode Abdul Kader|કોઝહીકોડે અબ્દુલ kader
Prashanta Nanda|પ્રશાંત નંદા
Qawwal Bahauddin Khan|કવ્વાલ બહાઉદ્દીન ખાન
Bhabendra Nath Saikia|ભવેન્દ્રનાથ સૈકિયા
Durvasa|દુર્વાસા
Sachchidananda Vatsyayan|સચ્ચિદાનંદ હીરાનંદ વાત્સ્યાયન
Udham Singh|ઉધમસિંહ
Eknath|એકનાથ
Nicole Faria|નિકોલ ફરિયા
Chandrakant Bakshi|ચંદ્રકાંત બક્ષી
Zerifa Wahid|ઝરીફા વાહિદ
Gul Panag|ગુલ પનાગ
Ankita Lokhande|અંકિતા લોખંડે
Akha Bhagat|અખા ભગત
Salil Ankola|સલીલ અંકોલા
Sanjeev Sharma|સંજીવ શર્મા
Anil Kakodkar|અનિલ કાકોડકર
Abdulgani Dahiwala|અબ્દુલગની દહીંવાલા
Gopala Krishna Goswami|ગોપાલ કૃષ્ણ ગોસ્વામી
Ahmed Shah I|અહમદશાહ
Niranjan Bhagat|નિરંજન ભગત
Narmadashankar Dave|નર્મદ
Kaka Kalelkar|કાકાસાહેબ કાલેલકર
Nityananda|નિત્યાનંદ પ્રભુ
Nawal Kishore Sharma|નવલકિશોર શર્મા
Ramakant Desai|રમાકાન્ત દેસાઈ
Prafulla Chaki|પ્રફુલ્લ ચાકી
Ram Prasad Bismil|રામ પ્રસાદ બિસ્મિલ
Sarv Mittra Sikri|સર્વમિત્ર સિકરી
Varsha Adalja|વર્ષા અડાલજા
Indulal Gandhi|ઈન્દુલાલ ગાંધી
Usha Upadhyay|ઉષા ઉપાધ્યાય
Kishorlal Mashruwala|કિશોરલાલ મશરૂવાળા
Keshavlal Dhruv|કેશવલાલ ધ્રુવ
Romila Thapar|રોમિલા થાપર
Harris Jayaraj|હેરિસ જયરાજ
Jaimini|જૈમિનિ
Daksha Vyas|દક્ષા વ્યાસ
Dilip Ranpura|દિલીપ રાણપુરા
Sajid Khan|સાજીદ ખાન
Nikhil Nanda|નિખિલ નંદા
Pitambar Patel|પીતાંબર પટેલ
Pradyumn Kanchanrai Desai|પ્રદ્યુમ્ન કંચનરાય દેસાઈ
Eva Dave|ઈવા ડેવ
Pramodkumar Patel|પ્રમોદકુમાર પટેલ
Balwantray Thakore|બળવંતરાય ઠાકોર
Biren Kothari|બીરેન કોઠારી
Damodar Botadkar|દામોદર બોટાદકર
Bharatsinh Solanki|ભરતસિંહ માધવસિંહ સોલંકી
|ભાનુપ્રસાદ પંડ્યા
Bholabhai Patel|ભોળાભાઈ પટેલ
|મણિરાજ બારોટ
Madan Lal|મદનલાલ શર્મા
Maharaja Sayajirao Gaekwad First|મહારાજા સયાજીરાવ ગાયકવાડ પ્રથમ
Raghuveer Chaudhari|રઘુવીર ચૌધરી
|રતુભાઇ અદાણી
Ramanlal Joshi|રમણલાલ જોષી
Ramnik Aralwala|રમણિક અરાલવાળા
Ramesh Parekh|રમેશ પારેખ
Ravishankar Vyas|રવિશંકર વ્યાસ
Ramnarayan V. Pathak|રામનારાયણ પાઠક
Vishnuprasad Trivedi|વિષ્ણુપ્રસાદ ત્રિવેદી
Shashin Ojha|શશિન્ ઓઝા
|શામળાબાપા
|શ્રી કૃષ્ણવલ્લભાચાર્ય સ્વામી
Snehlata|સ્નેહલતા
Harikrishna Pathak|હરિકૃષ્ણ પાઠક
Harishchandra Bhatt|હરિશ્ચન્દ્ર ભટ્ટ
Hasmukh Baradi|હસમુખ બારાડી
Jayiram Samal|જયરામ સમાલ
Harish Patel|હરીશ પટેલ
Cotah Ramaswami|કોતાહ રામાસ્વામી
Farida Parveen|ફરીદા પરવીન
Farid-ud-din Ganj Shakar|ફરીદુદ્દીન ગંજશકર
Vyankatesh Madgulkar|વ્યંકટેશ માડગૂલકર
Ashapoorna Devi|આશાપૂર્ણા દેવી
Atin Bandyopadhyay|અતીન બંદોપાધ્યાય
Kunwar Narayan|કુંવર નારાયણ
Juan de Arespacochaga|Juan de Arespacochaga
Arun Manilal Gandhi|અરુણ મણિલાલ ગાંધી
Sundar Pichai|સુંદર પિચાઈ
Kannadasan|કણ્ણદાસન
Ajit Agarkar|અજીત આગરકર
K. Balachander|કે બાલચંદ્ર
Hemant Kanitkar|હેમંત કાનિટકર
Surinder Khanna|સુરિન્દર ખન્ના
Rajdeep Sardesai|રાજદીપ સરદેસાઈ
Ramesh Pokhriyal|રમેશ પોખરિયાલ
Delhi Ganesh|દિલ્હી ગણેશ
Richa Gangopadhyay|રિચા ગંગોપાધ્યાય
Yugendran|યુગેન્દ્રન
Sunaina|સુનૈના
Saikumar|સૈકુમાર
Pasupuleti Kannamba|પાસપુલેતિ કન્નમ્બા
Malavika|માલાવિકા
Gopika|ગોપિકા
M. K. Muthu|એમ.કે.મૂથુ
Vishal|વિશાલ
Neetu Chandra|નીતુ ચંદ્રા
P. Vasu|પી વાસુ
K. Shivaram Karanth|કે.શિવરામ કરંથ
Government of Andhra Pradesh|તેલંગાણા સરકાર
K. V. Subbanna|કે. વી. સુબણ્ણા
Madhoo|મધુ
Verrier Elwin|વેરિયર એલ્વિન
Praful Patel|પ્રફુલ પટેલ
Karthika Nair|કાર્તિકા નાયર
Lucky Ali|લકી અલી
Shatrughan Sinha|શત્રુઘ્ન સિન્હા
Jayamalini|જયમાલિની
Pia Bajpiee|પિયા બાજપાઇ
T. V. Chandran|ટી.વી.ચંદ્રન
Adoor Bhavani|અદૂર ભવાની
Yogendra Singh Yadav|યોગેન્દ્ર સિંહ યાદવ
Ashish Vidyarthi|આશિષ વિદ્યાર્થી
Ranvir Shorey|રણવીર શોરેય
Zarina Wahab|ઝરીના વહાબ
Kariya Munda|કરિયા મુંડા
Varavara Rao|વરવર રાવ
Dalip Kaur Tiwana|દલિપ કૌર ટિવાણા
Suraiya|સુરૈયા
Shibu Soren|શિબૂ સોરેન
Bhalchandra Nemade|ભાલચંદ્ર નેમાડે
Deendayal Upadhyaya|દીનદયાલ ઉપાધ્યાય
Ganesh Vasudev Mavalankar|ગણેશ વાસુદેવ માવળંકર
Sudhir Phadke|સુધીર ફડકે
Gulshan Kumar Mehta|ગુલશનકુમાર મહેતા
Manoj Das|મનોજ દાસ
B. Gopalam|બી. ગોપાલમ
Himani Kapoor|હિમાની કપૂર
Elīza Tīruma|Elīza Tīruma
V.R. Raghava Krishna|વી.આર. રાઘવ કૃષ્ણ
Anna Mani|અન્ના મણિ
A. Michael Noll|એ. માઇકલ નોલ
A. Srinivasa Raghavan|એ. શ્રીનિવાસન રાઘવન
Anand Goradia|આનંદ ગોરડિયા
Aarathi|આરતી
Abdul Hamid|અબ્દુલ હમીદ
Abhiraj Rajendra Mishra|અભિરાજ રાજેન્દ્ર મિશ્ર
Abu Hasem Khan Choudhury|અબૂ હસેમ ખાન ચૌધરી
Alladi Krishnaswamy Iyer|alladi krishnaswamy iyer
Amrita Puri|અમૃતા પુરી
Anas Rashid|અનસ રશીદ
Anirudh Dave|અનિરુદ્ધ દવે
Anita Ratnam|અનિતા રત્નમ
Anjali Abrol|અંજલિ અબરોય
Anjali Devi|અંજલિ દેવી
Anjana Bhowmick|અંજના ભૌમિક
Anupam Hazra|અનુપમ હાજ઼રા
Joycelyn Elders|જોયસલીન એલ્ડર્સ
Arthur Kantrowitz|આર્થર કેન્ટ્રોવિટ્ઝ
Arun Murugesan|અરુણ મુરુગેસન
Ashok Bhatt|અશોક ભટ્ટ
B. Radhakrishnan|બી.રાધાકૃષ્ણન
Bandaru Dattatreya|બણ્ડારૂ દત્તારેય
Bob Twiggs|બોબ ટ્વિગ્સ
Preeti Desai|પ્રીતિ દેસાઇ
C.N. Jayadevan|સી૰એન૰ જયદેવન
Carlos Albizu Miranda|કાર્લોસ અલ્બીઝુ મિરાન્ડા
Charles A. Holloway|ચાર્લ્સ એ. હોલોવે
Charles J. Bates|ચાર્લ્સ જે બેટ્સ
Chimanbhai Patel|ચીમનભાઈ પટેલ
Chuni Lal|ચુની લાલ
Constantine A. Balanis|કોન્સ્ટેન્ટાઇન એ. બાલાનિસ
Conway B. Leovy|કોનવે બી. લેવી
Cyrus Bryant|સાયરસ બ્રાયન્ટ
Dada Khachar|દાદા ખાચર
Dandamudi Rajagopal|દાંડામુડી રાજગોપાલ
Daniel Dickey|ડેનિયલ ડિકી
Daniel Hillel|ડેનિયલ હિલે
Darryl S. Inaba|ડેરીલ એસ ઇનાબા
David E. Sweet|ડેવિડ ઇ સ્વીટ
Denzil Keelor|ડેન્ઝિલ કીલોર
Dilras Banu Begum|દિલરાસ બાનો બેગમ
Disco Shanti|ડિસ્કો શાંતિ
Faggan Singh Kulaste|ફગ્ગન સિંહ કુલસ્તે
Gopalanand Swami|ગોપાળાનંદ સ્વામી
Gutha Sukender Reddy|જી૰એસ૰ રેડ્ડી
Hansa Jivraj Mehta|હંસા જીવરાજ મહેતા
Hiravijaya|હીરવિજયસૂરી
I. C. Chacko|આઈ. સી. ચાકો
Muhammad Mahabat Khan III|મોહમ્મદ મહાબતખાન બાબી
Indradyumna|ઇન્દ્રદ્યુમ્ન
J. V. S. Taylor|જે. વી. એસ. ટેલર
Jaswant Singh Neki|જસવંતસિંહ નેકી
Jhina Hikaka|ઝિના હિકાકા
Jijabai|જીજાબાઇ
Shankersinh Vaghela|શંકરસિંહ વાઘેલા
K. P. Kesava Menon|કે. પી. કેશવ મેનન
Kartikeya Sarabhai|કાર્તિકેય સારાભાઈ
Kasturbhai Lalbhai|કસ્તુરભાઇ લાલભાઇ
Keki N. Daruwalla|કેકી એન. દારુવાલા
Krishna Kanta Handique|કૃષ્ણકાન્ત હાંદિકી
Krishnaswamy Sundarji|krishnaswamy sundaruji
Kumar|કુમાર
Kumudini Lakhia|કુમુદિની લાખિયા
Karsandas Mulji|કરસનદાસ મૂળજી
Lalithambika Antharjanam|લલિતામ્બિકા અન્તર્જનમ
M. Leelavathy|એમ. લીલાવતી
Madhavi Vuppalapati|માધવી વઉપલપતિ
Madhusudan Amilal Dhaky|મધુસૂદન ઢાંકી
Malathi Rao|માલતી રાવ
Maniben Patel|મણિબેન પટેલ
Manjit Singh|મનજીતસિંહ
Manoj Sinha|મનોજ સિન્હા
Mansoor Rana|મન્સૂર રાણા
Manzoor Elahi|મંઝૂર ઇલાહી
Matthew Pothen Thekaekara|મેથ્યુ પોથેન થેએકaraકારા
Mehbooba Mufti|મહબૂબા મુફ઼્તી
Mehdi Nawaz Jung|મહેંદી નવાઝ જંગ
Mohammad Asif|મોહમ્મદ અસિફ
Mohammad Asrarul Haque|મુહમ્મદ અસરારુલ હક઼
Mohammad Ilyas|મોહમ્મદ ઇલ્યાસ
Mohammad Naeem|મોહમ્મદ નઇમ
Mohammad Naeem|મોહમ્મદ નઇમ
Mohammed Asdullah|મોહમ્મદ અસદુલ્લાહ
Mukti Mohan|મુક્તિ મોહન
Nabarun Bhattacharya|નવારુણ ભટ્ટાચાર્ય
Nalini Bala Devi|નલિનીબાલા દેવી
Nanji Kalidas Mehta|નાનજીભાઈ કાલિદાસ મહેતા
Naramalli Sivaprasad|નારામલ્લિ શિવપ્રસાદ
Narendra Deva|નરેન્દ્ર દેવ
Navya Natarajan|navya
Nikesh Arora|નિકેશ અરોરા
Ninong Ering|નિનોંગ ઈરિંગ
Nishikant Dubey|નિશિકાંત દુબે
Om Birla|ઓમ બિડ઼લા
P. R. Sundaram|પી૰આર૰ સુન્દરમ
Pankaj Choudhary|પંકજ
Pinaki Misra|પિનાકી મિશ્ર
Prahlad Tipanya|પ્રહલાદ સિંહ ટીપણીયા (ભજનીક)
Pralhad Joshi|પ્રહ્લાદ જોશી
Pramod Kale|પ્રમોદ કાલે
Prasanna Kumar Patasani|પ્રસન્ન કુમાર પટસાની
Premchand Degra|પ્રેમચંદ ડોગરા
R. K. Kamboj|આર.કે.કમ્બોજ
Rajesh Verma|રાજેશ વર્મા
Rakesh Singh|રાકેશ સિંહ
Ram Chandra Paswan|રામચન્દ્ર પાસવાન
Ramesh Chandappa Jigajinagi|રમેશ ચંદપ્પા જિગાજિનગી
Raosaheb Dadarao Danve|રાવસાહેબ દાદારાવ દાનવે
Salim Khan|સલીમ ખાન
Sambhu Nath De|સંભુ નાથ દે
Sanjay Jaiswal|સંજય જયસવાલ
Sanjeeva Kumar Singh|સંજીવકુમાર સિંઘ
Sarbananda Sonowal|સર્બાનન્દા સોનવાલ
Satabdi Roy|શતાબ્દી રૉય
Shastriji Maharaj|શાસ્ત્રીજી મહારાજ
Shivkumar Chanabasappa Udasi|શિવકુમાર ચનાબાસપ્પા ઉદાસી
Shripad Yasso Naik|શ્રીપદ યેસ્સો નાયક
Suresh Mehta|સુરેશભાઈ મહેતા
Swaroop Sampat|સ્વરૂપ સંપત
Takhtsinhji Gohil|તખ્તસિંહજી ગોહિલ
Tushar Amarsinh Chaudhary|તુષાર અમરસિંહ ચૌધરી
V. Sundaram|વી.સુંદારામ
Vijaysingh Mohite-Patil|વિજયસિંહ મોહિતે પાટિલ
Vitthal Radadiya|વિટ્ઠલભાઈ રાદરિયા
Devi Singh|દેવીસિંહ
Kamal Narain Singh|કમલ નરૈન સિંહ
Manoj Joshi|મનોજ જોશી
Manoj Khanderia|મનોજ ખંડેરિયા
Vijay Yadav|વિજય યાદવ
Medha Khole|મેધા ખોલે
Kundanika Kapadia|કુન્દનિકા કાપડિયા
Raghuram|રઘુરામ
Vallabh Bhatt|વલ્લભ ભટ્ટ
Sultana|સુલ્તાના
Pedrito Martinez|Pedrito Martínez
Mala Rajya Laxmi Shah|માલા રાજ્યલક્ષ્મી શાહ
Ramji H. Kamani|રામજી એચ. કમાણી
Chenganoor Raman Pillai|ચેંગનુંર રામન પિલ્લા
Hukum Singh|હુકુમ સિંહ
Methil Devika|મેથિલ દેવિકા
Ramsinh Rathwa|રામસિંહભાઈ રાઠવા
Harsimrat Kaur Badal|હરસિમરત કૌર બાદલ
Sushil Kumar Singh|સુશીલ કુમાર સિંહ
Sonali Majumdar|સોનાલી મજુમદાર
Kamlesh Paswan|કમલેશ પાસવાન
N. C. Paul|એન સી સી પોલ
Janvi Chheda|જાન્હવી છેડા
Imaad Shah|ઇમ્માદ શાહ
Avneet Kaur|અવનીત કૌર
Sunil Gaikwad|સુનીલ ગાયકવાડ઼
M.Y.S. Prasad|એમ.વાય.એસ. પ્રસાદ
M.C. Davar|એમ. સી. દાવર
Rekha Verma|રેખા
Jugal Kishore Sharma|જુગલ કિશોર શર્મા
Bharatendra Singh|ભારતેન્દુ સિંહ
Neelam Sonkar|નીલમ સોનકર
Rahul Shewale|રાહુલ શેવાલે
Abhishek Singh|અભિષેક સિંહ
Malyadri Sriram|માલ્યાદ્રી શ્રીરામ
Manoj Rajoria|મનોજ રાજોરિયા
Ponguleti Srinivas Reddy|પોંગુલેટી શ્રીનિવાસ રેડ્ડી
Shailesh Kumar|શૈલેશ કુમાર (ભુલો મંડલ)
Uma Saren|ઉમા સરીન
Vijay Kumar Hansdak|વિજય કુમાર હંસદક
Arjunlal Meena|અર્જુન લાલ મીણા
Bhairon Prasad Mishra|ભૈરોં પ્રસાદ મિશ્ર
Chhotu Ram Chaudhary|સી૰આર૰ ચૌધરી
Jitendra Chaudhury|જિતેંદ્ર ચૌધરી
Karadi Sanganna Amarappa|કરાડી સંગન્ના અમરપ્પા
Mriganko Mahato|મૃગંક મહતો
Pratima Mondal|પ્રતિમા મંડલ
Rajesh Diwakar|રાજેશ કુમાર દિવાકર
Satish Kumar Gautam|સતીશ કુમાર ગૌતમ
Sudhir Gupta|સુધીર ગુપ્તા
Kulamani Samal|કુલમણિ સમલ
Mohammed Faizal P. P.|પી૰પી૰ મોહમ્મદ ફૈજ઼લ
R. Vanaroja|આર૰ વનરોજા
Ashok Kumar K|અશોક કુમાર કે૰
Chandrakasi M|ચન્દ્રકસી એમ૰
R. P. Marutharajaa|આર૰પી૰ મરુતરાજા
T. G. Venkatesh Babu|વેંકટેશ બાબૂ ટી૰જી૰
Om Prakash Kohli|ઓમપ્રકાશ કોહલી
Boby Techi|બોબી તેચી
Muldas|મૂળદાસ
Anandghan|આનંદધન
Smita Nair Jain|સ્મિતા નાયર જૈન
Ngangom Bala Devi|નંગંગોમબાલા દેવી
Shital Mahajan|શીતલ મહાજન
Hasmukh Adhia|હસમુખ અઢિયા
B. K. Gadhvi|બી. કે. ગઢવી
Kiran Segal|કિરણ સેગલ
Sudhakar Sahu|સુધાકર સાહુ
Reuben David|રૂબિન ડેવિડ
Balvant Parekh|બળવંત પારેખ
Indumati Chimanlal Sheth|ઇન્દુમતી ચીમનલાલ શેઠ
Ishita Dutta|ઇશિતા દત્તા
Rafeeq Mangalassery|રફીક મંગલાસ્સેરી
Hansaben Mehta|હંસાબેન મહેતા
Govindbhai Patel|ગોવિંદભાઈ પટેલ
Sen Keshav|સેન કેશવ
Alauddin Sabir Kaliyari|અલાઉદ્દીન અલી અહમદ સાબિર કલ્યરી
Avani Modi|અવની મોદી
Nikola Tvrtković|Nikola Tvrtković
Supriya Jatav|સુપ્રિયા જાટવ
Anil Chavda|અનિલ ચાવડા
Amrit Singh|અમૃતસિંહ
Anisha Padukone|અનિશા પદુકોણ
Mohanlal Lallubhai Dantwala|મોહનલાલ લલ્લુભાઇ દાંતવાલા
José María Mendoza Ussía|José María Mendoza Ussía
Harsh Brahmbhatt|હર્ષ બ્રહ્મભટ્ટ
ChariTarth Unagar|ચરિતાર્થ ઉનાગર
Ramesh Tendulkar|રમેશ તેંડુલકર
K. Srinivas|કે શ્રીનિવાસ
Peter Schuchert|Peter Schuchert
Prithvi Singh Azad|પૃથ્વિસિંહ આઝાદ
Shridhar Vyas|શ્રીધર વ્યાસ
Neerav Patel|નીરવ પટેલ
Anmol Ambani|અનમોલ અંબાણી
Avani Chaturvedi|અવની ચતુર્વેદી ક
Raj Anadkat|રાજ અનડકટ
José López Zanón|José López Zanón
Scherezade Shroff Talwar|શેરેઝેડે શ્રોફ તલવાર
Juan de Haro Piñar|Juan de Haro Piñar
Harbans Lal|હરબન્સ લાલ
Bhuvan Bam|ભુવન બામ
Taran Svami|સંત તારણ
Giovanni Battista Tocci|Giovanni Battista Tocci
Gargi Raina|ગાર્ગી રૈના
Gaston Lecreux|Gaston Lecreux
Urmi Desai|ઊર્મિ દેસાઈ
Ravindra Parekh|રવિન્દ્ર પારેખ
Simranjit Kaur|સિમરનજીત કૌર
|ભક્તિબા દેસાઈ
Vastupala|વસ્તુપાળ
Vinayak Mehta|વિનાયક મહેતા
Vivek Verma|વિવેક વર્મા
Hariprasad Shastri|હરિપ્રસાદ શાસ્ત્રી
Arvind Barot|અરવિંદ બારોટ
Taskeen Fatima Basha|તસ્કીન ફાતિમા બાશા
Pranjal Bhatt|પ્રાંજલ ભટ્ટ
Deepika Narayan Bhardwaj|દિપીકા નારાયણ ભારદ્વાજ
Mahipatsinh Chavda|મહિપતસિંહ ચાવડા
Makrand Mehta|મકરંદ મહેતા
Geni Thakor|ગેની ઠાકોર
Nirav Shah|નીરવ શાહ
Luciano Méndez|Luciano Méndez
Alekss Krasts|Alekss Krasts
Panagiotis Christopoulos-Cheller|Panagiotis Christopoulos-Cheller
Anastasios Kourmpetis|Anastasios Kourmpetis
Neftali Martinez|Neftali Martinez
Shankar Painter|શંકર પેઇન્ટર
Julie Hutsebaut|Julie Hutsebaut
Marina Khodchenkova|Marina Khodchenkova
Clarissa Breuer|Clarissa Breuer
Alena Popadova|Alena Popadova
Caroline Orens|Caroline Orens
Elisa Neri|Elisa Neri
Negringa Raudonite|Negringa Raudonite
Laurence Restoin|Laurence Restoin
Deborah Geentjens|Deborah Geentjens
Delphine Deschamps|Delphine Deschamps
Marie Kolarikova|Marie Kolarikova
Natascha Klewitz|Natascha Klewitz
Jozef Hušla|Jozef Hušla
T. N. Dave|ટી. એન. દવે
Krists Lindenblats|Krists Lindenblats
Jung Hyun-woo|Jung Hyun-woo
Dominic Meinel|Dominic Meinel
