Narendra Modi|نَریندرٖ مودی
Indira Gandhi|اِندِرا گانٛدھي
Muhammad|محمد صلی اللہ علیہ و آلہ و سلم
Salman Rashid Khan|سلمان خان
Ali Khamenei|سید علی خامنائی
Zulfiqar Ali Bhutto|ذوالفقار علی بھٹو
Nawaz Sharif|نواز شریف
Bhimrao Ramji Ambedkar|बाबासाहेब अंबेडकर
Madhuri Dixit|مادھوری ڈکشٹ
Atal Bihari Vajpayee|अटल बिहारी वाजपेई
Lal Bahadur Shastri|लाल बहादुर शास्त्री
Kshemendra|شیمینٛدر
Amin Kamil|اَمیٖن کامِل
Shameem Dev Azad|شَميم ديو آزاد
Villy Aellen|Villy Aellen
Manuel Martínez Chumillas|Manuel Martínez Chumillas
Ángel Cadarso del Pueyo|Ángel Cadarso del Pueyo
Orso Orsini|Orso Orsini
Fanny Vaucher|Fanny Vaucher
Kate Sayer|Kate Sayer
Anna Kulikova|Anna Kulikova
Jean-Pierre Lloyd|Jean-Pierre Lloyd
Areke Hassink|Areke Hassink
Paula Fedirchuk|Paula Fedirchuk
Claudia Migliorini|Claudia Migliorini
Sylvia Debboudt|Sylvia Debboudt
Miranda De Permentier|Miranda De Permentier
Aurélie Anaise|Aurélie Anaise
Gulnara Fatkullina|Gulnara Fatkullina
Sheng Hsin Chiu|Sheng Hsin Chiu
Anna Skalniak|Anna Skalniak
Mirza Nikolajev|Mirza Nikolajev
Elīna Ieva Vītola|Elīna Ieva Vītola
Paulina Cywinska|Paulina Cywinska
Kyle Murray|Kyle Murray
Eleonora Gasparrini|Eleonora Gasparrini
Noemi Lucrezia Eremita|Noemi Lucrezia Eremita
Eline Van Rooijen|Eline Van Rooijen
Linda Poelstra-RInglever|Linda Poelstra-RInglever
Océane Tessier|Océane Tessier
Marina Kulikova|Marina Kulikova
Andreja Godec|Andreja Godec
Noa Jansen|Noa Jansen
Victoria Bandera|Victoria Bandera
Anne De Pablo|Anne De Pablo
Carla Pruñonosa|Carla Pruñonosa
Ania Horcajada|Ania Horcajada
Elena Cuenca|Elena Cuenca
Stefan Kiefer|Stefan Kiefer
Akbar|जलाल उद्दीन मुहँमद अकबर
Ruhollah Khomeini|امام خمینی
Guru Nanak|گٗروُ نانَک
Subhash Kak|سُباش كاک
Chandragupta Maurya|चंद्रगुप्त मौर्य
Shivaji Bhonsle I|शिवा जी
Musa al-Kadhim|امام موسی کاظم
Vinayak Damodar Savarkar|विनायक दामोदर सावरकर
Harbhajan Singh Yogi|یوگۍ بھَجَن
Firoz Khan Nun|ملک فیروز خان نون
Praful Bidwai|پرَفُل بِدوَئی
Habba Khatun|حببا کھاتٗن
Abdul Ahad Azad|عَبدالاحد آزاد
Adriaan van der Willigen|Adriaan van der Willigen
Adriaan van der Willigen Pz.|Adriaan van der Willigen Pz.
Adriaen Foly|Adriaen Foly
Osman Khalid Butt|عَثمان خالِد بَٹ
Rasool Mir|رَسوُل ميٖر
Nitasha Kaul|نِتاشا کؤل
Rajiv C. Mody|راجیٖؤ سٖی۔ مودی
Jan Pawlowski|Jan Pawlowski
Lionel Cavin|Lionel Cavin
Jean-Philippe Anstett|Jean-Philippe Anstett
Francisco Alonso Martos|Francisco Alonso Martos
Jesús Martínez Verón|Jesús Martínez Verón
Joaquín de la Concha Alcalde|Joaquín de la Concha Alcalde
Felipe Medina Benjumea|Felipe Medina Benjumea
Konstantina Sintzaniki|Konstantina Syntzanaki
Gjergj Zefi|Gjergj Zefi
Linus Kvist|Linus Kvist
Erki Laanemäe|Erki Laanemäe
Ingram Cuff|Ingram Cuff
Nikita Stenkovoy|Nikita Stenkovoy
Maria Ögn Gudmundsdottir|Maria Ögn Gudmundsdottir
Cornelia Cyrus|Cornelia Cyrus
Ioulia Eremeeva|Ioulia Eremeeva
Julia Bradley|Julia Bradley
Simona Wagnerova|Simona Wagnerova
Sara Savino|Sara Savino
Wendy Paez|Wendy Paez
Kevin McCambridge|Kevin McCambridge
Florian Auer|Florian Auer
Emīls Cipulis|Emīls Cipulis
Adele de la Rey|Adele de la Rey
Fanny Leleu|Fanny Leleu
Marián Skupek|Marián Skupek
Adam Dobeš|Adam Dobeš
Mara Morell|Mara Morell
Dylan Sorensen|Dylan Sorensen
Kasey Clark|Kasey Clark
Sofie Van Rooijen|Sofie Van Rooijen
Sofia Martelli|Sofia Martelli
Élodie Le Bail|Elodie Le Bail
Camille Tryoen|Camille Tryoen
Klara Fischnaller|Klara Fischnaller
Lisa Isebaert|Lisa Isebaert
Rosalie Van der Wolf|Rosalie Van der Wolf
Kristina Nenadovic|Kristina Nenadovic
Iva Bozac|Iva Bozac
Fanli Shen|Fanli Shen
Petra Stiasny|Petra Stiasny
Maryoly Sosa|Maryoly Sosa
Natalia Saiz|Natalia Saiz
Jonas Oehmichen|Jonas Oehmichen
Katharina Fox|Katharina Fox
Vladimir Lenin|ولادِیمِیر لینٖن
Nelson Mandela|نیلسَن منٛڈیلَ
Aamir Khan|عامر خان
Asif Ali Zardari|آصف علي زرداري
Imran Khan|عمران خان
Premchand|پرٮ۪م چنٛد
Rani Lakshmibai|रानी लक्षमीबाई
Arundhati Roy|اَروُندھتی رِاُۓ
Hasan al-Askari|امام حسن عسکری
Mohammad-Taqi Bahjat Foumani|آیت اللہ محمد تقی بہجت
Abbas Qumi|شیخ عباس قمی
Khudiram Bose|ख़ुदी राम बोज़
K. B. Hedgewar|केशव बलिराम हेडगेवार
Abhay Sopori|ابھے سوپوری
Thomas Eduardo Hearne|Thomas Eduardo Hearne
Rupa Bhawani|روُپا بوانۍ
Syed Bashir Ahmad|سِیٖد بَشِیٖر اَحَمَد
Vojtech H. Lindtner|Vojtech H. Lindtner
Philipp Wobeto|Philipp Wobeto
Sonia Fisch-Muller|Sonia Fisch-Muller
Laurent Vallotton|Laurent Vallotton
John Hollier|John Hollier
Dionisio García Cortázar|Dionisio García Cortázar
Máximo Cánovas del Castillo|Máximo Cánovas del Castillo
Karla Vallejos|Daniela Vallejos
Vanessa Mark|Vanessa Mark
Alexander Bernardi|Alexander Bernardi
Olivia Araujo|Olivia Araujo
Victor Povzner|Victor Povzner
Mantas Januskevicius|Mantas Januskevicius
Bolivar Espinosa|Bolivar Espinosa
Mattija Lojen|Mattija Lojen
Joanne Cavill|Joanne Cavill
Beata Jasińska|Beata Jasińska
Olga Mikhailoyskaia|Olga Mikhailoyskaia
Els Bauden|Els Bauden
Sabrina Arhab|Sabrina Arhab
Cecilia Bäckstedt|Cecilia Bäckstedt
Madelline Mendoza|Madelline Mendoza
Karen Umaña|Karen Umaña
Thomas Lienert|Thomas Lienert
Barbara Venerito|Barbara Venerito
Ana Yunta|Ana Yunta
Iulian Oprea|Iulian Oprea
Leon Felderer|Leon Felderer
Cezara Curmei|Cezara Curmei
Roberts Plūme|Roberts Plūme
Erica Voss|Erica Voss
Julia Słupecka|Julia Słupecka
Eric Fantazzini|Eric Fantazzini
Arnis Bebrišs|Arnis Bebrišs
Ludivine Loze|Ludivine Loze
Ilse Pluimers|Ilse Pluimers
Taylor Lawrence|Taylor Lawrence
Cédric Follador|Cédric Follador
Ana Garza|Ana Garza
Christy Keely|Christy Keely
Asia Zontone|Asia Zontone
Lisa Poller|Lisa Poller
Céline Ondet|Céline Ondet
Alexandra Carle|Alexandra Carle
Henriette Frederiksen|Henriette Frederiksen
Gloria Van Mechelen|Gloria Van Mechelen
Julie Debock|Julie Debock
Elise Tahay|Elise Tahay
Evy Roelen|Evy Roelen
Anja Jakasa|Anja Jakasa
Ayan Khankishiyeva|Ayan Khankishiyeva
Erik Schmidt|Erik Schmidt
Sofiia Shevchenko|Sofiia Shevchenko
Helena Bieber|Helena Bieber
David Cameron|ٖڈیوڈ کَیمرن
Rabindranath Tagore|रबिंद्र नाथ टागौर
Ashoka|اَشوک
Sheikh Muhammad Abdullah|شيخ عبدالله
Ghulam Mustafa Jatoi|غلام مصطفی جتوئی
George Abraham Grierson|जॉर्ज अब्राहम ग्रियर्सन
Robert Jones|Robert Jones
Dibyesh Anand|دِبَیش آنٛنَد
José Luis Álvarez Álvarez|José Luis Álvarez
Syed Ali Shah Geelani|سید الی شاح گیلانی
Obaidullah Aleem|عَبیدالله عَلیم
Omkar N. Koul|اومکار کول
Syed Jawad Naqvi|سید جواد نقوی
Friederike Spitzenberger|Friederike Spitzenberger
Claude Vaucher|Claude Vaucher
Bertrand Devouard|Bertrand Devouard
Christian Hammers|Christian Hammers
Gert Kivistik|Gert Kivistik
Ilia Cota|Ilia Cota
Carlo Jurisevic|Carlo Jurisevic
Birkir Snaer Ingvason|Birkir Snaer Ingvason
Barbora Svrckova|Barbora Svrckova
Wendy Ducruex|Wendy Ducruex
Tatiana Droujinina|Tatiana Droujinina
Tatiana Bossak|Tatiana Bossak
Chantalle Gehrig|Chantalle Gehrig
Séverine Villance|Séverine Villance
Lada Koslikova|Lada Koslikova
Samanta Loschi|Samanta Loschi
Darnelle Moore|Darnelle Moore
Rachel Leroux|Rachel Leroux
Šárka Chmurová|Šárka Chmurová
Karina Clemant|Karina Clemant
Sarah Wimmer|Sarah Wimmer
Riccardo Schöpf|Riccardo Schöpf
Eduard Crăciun|Eduard Crăciun
Irina Strebel|Irina Strebel
Sara Villani|Sara Villani
Andreas Haas|Andreas Haas
Joseph Williamson|Joseph Williamson
Julia Van Bokhoven|Julia Van Bokhoven
Candice Lill|Candice Lill
Sara Cueto Vega|Sara Cueto Vega
Idoia Eraso|Idoia Eraso
Adriana San Roman|Adriana San Roman
Fiona Mangan|Fiona Mangan
Anne Van Rooijen|Anne Van Rooijen
Alireza Fazeli Monfared|علیرضا فاضلی منفرد
Andrea Mediero|Andrea Mediero
Xubane Garai|Xubane Garai
Garazi Korta|Garazi Korta
Mika Schneider|Mika Schneider
Lucie Liboreau|Lucie Liboreau
Muskilda Olortiz|Muskilda Olortiz
Daniel Berlinski|Daniel Berlinski
Subhas Chandra Bose|सुभाष चंद्र बोज़
Shah Rukh Khan|شاہ رخ خان
Alī ibn Abī Ṭālib|علی ابن ابی طالب
Pranab Mukherjee|پرَنَب مُکھرجي
Zafarullah Khan Jamali|ظفر اللہ خان جمالی
Priyanka Chopra|پریانکا چوپڑا
Abul Kalam Azad|مولانا آزاد
Chaudhry Muhammad Ali|چوہدری محمد علی
Guru Gobind Singh|गुरु गोबिंद सिंघ
Vijaya Lakshmi Pandit|ؤجِۓ لَکشمي پنٛڈِت
Amir Khan|عامر خان
Nurul Amin|نور الامین
Trevor Beattie|Trevor Beattie
Hari Singh|ہَرۍ سِنٛگھ
Aseem Ahmed Abbasee|اَسیٖم اَحمَد عَباسۍ
Natasja Nobels|Natasja Nobels
Mujeeb Rahman Chandio Hussaini|مجیب الرحمان حسینی
Miguel López González|Miguel López González
Rodrigo Medina Benjumea|Rodrigo Medina Benjumea
Alfonso Toro Buiza|Alfonso Toro Buiza
José Jiménez Jimena|José Jiménez Jimena
Giacomo Tocci|Giacomo Tocci
Fabienne Lupo Magnaudet|Fabienne Lupo Magnaudet
Kelly Vedovelli|Kelly Vedovelli
Yanina Kuskova|Yanina Kuskova
Greta Karasiovaite|Greta Karasiovaite
Joseph Samudio|Joseph Samudio
Dimitrios Christakos|Dimitrios Christakos
Muhammad Shahmir Aiman Abdul Halim|Muhammad Shahmir Aiman Abdul Halim
Sakchai Phodingam|Sakchai Phodingam
Karina Louise Sørensen|Karina Louise Sørensen
Mira Peeters|Mira Peeters
Cybil Di Guistini|Cybil Di Guistini
Anna-Sophia Czilwik|Anna-Sophia Czilwik
Myriam Desrosiers|Myriam Desrosiers
Adéla Vlnova|Adéla Vlnova
Monika Richterova|Monika Richterova
Nicholas Timmings|Nicholas Timmings
Ruth Demeijer|Ruth Demeijer
Chantal Polansky|Chantal Polansky
Liliano Leenknegi|Liliano Leenknegi
Kim Van Gastel|Kim Van Gastel
Nicole Peitzmeier|Nicole Peitzmeier
Dorota Gregorowicz|Dorota Gregorowicz
Jonathan Eric Gustafson|Jonathan Eric Gustafson
Simona Martini|Simona Martini
Monika Kopinska|Monika Kopinska
Dominik Hufschmid|Dominik Hufschmid
Joanne Duval|Joanne Duval
Evy Tillaert|Evy Tillaert
Joana Eslava|Joana Eslava
Barbara Sniezynska|Barbara Sniezynska
Megan Panton|Megan Panton
Garazi Estevez|Garazi Estevez
Usoa Ostolaza|Usoa Ostolaza
Lorenz Hollenbach|Lorenz Hollenbach
Matthias Grahé|Matthias Grahé
Bruno Schiemann|Bruno Schiemann
Justin Jacob|Justin Jacob
Paula Villalon|Paula Villalon
Amitabh Bachchan|امیتابھ بچن
Gopal Krishna Gokhale|गोपाल कृष्ण गोखले
Abhinavagupta|اَبِنٛوگُپتٰ
Ram Mohan Roy|राजा राम मोहन राए
Muhammad Iqbal|محمد اقبال
Chandra Shekhar Azad|चंद्र शेखर आज़ाद
Viola Paulitz|Viola Müller-Paulitz
Ibrahim Ismail Chundrigar|ابراہیم اسماعیل چندریگر
Moeenuddin Ahmad Qureshi|معین الدین قریشی
Farooq Abdullah|فاروق عبدالله
Adriaen Honich|Adriaen Honich
Arnimal|اَرنيٖمال
Dinanath Nadim|دِيٖنا نات ندِيٖم
Ghulam Haider Gagroo|غُلام حیٖدر گَگروُ
Yaseen Anwer|یٰسِین اَنور
Anicia Proba|Anicia Proba
Agnishekhar|اَگنۍ شٮ۪کَر
Jürg Stäubli|Jürg Stäubli
Alain de Chambrier|Alain de Chambrier
Eusebio Calonge Francés|Eusebio Calonge Francés
Joaquín Pla Laporta|Joaquín Pla Laporta
Jacopo Orsini|Jacopo Orsini
Victor-Charles-Émile Dain|Victor-Charles-Émile Dain
Ilene Marckx|Ilene Marckx
Masrat Zahra|مَسرت زھرا
Lianne Witkin|Lianne Witkin
Teodor Rusev|Teodor Rusev
Rokas Kmieliauskas|Rokas Kmieliauskas
Marc Oliver Pritzen|Marc Oliver Pritzen
Tsveta Nesheva|Tsveta Nesheva
Doreen Weise|Doreen Weise
Nele Van Den Bossche|Nele Van Den Bossche
Sandra Degueldre|Sandra Degueldre
Claudia Marietta|Claudia Marietta
Karry Ellen Hellmuth|Karry Ellen Hellmuth
Patricia Hempel|Patricia Hempel
Ann Roegiers|Ann Roegiers
Saskia Van Duuren|Saskia Van Duuren
Marieke Haverdings|Marieke Haverdings
Luisiana Pegoraro|Luisiana Pegoraro
Erika Schertl|Erika Schertl
Deira Mari|Deira Mari
Nadia Zuccherelli|Nadia Zuccherelli
Silvia Zoller|Silvia Zoller
Elfie Kunz|Elfie Kunz
Karin Avenant|Karin Avenant
Ljudmilla Corneo|Ljudmilla Corneo
Cornelia Dreher|Cornelia Dreher
Alina Bondarenko|Alina Bondarenko
Viviana Gatto|Viviana Gatto
Zeyan Shafiq|زِیان شفیق
Risa Dreyer|Risa Dreyer
Mārtiņš Bots|Mārtiņš Bots
Inmaculada Rafael|Inmaculada Rafael
Detelina Marinova|Detelina Marinova
Dawn Richardson Wilson|Dawn Richardson Wilson
Mike Evelyn|Mike Evelyn
Luciana Roland|Luciana Roland
Caroline Andersson|Caroline Andersson
Margot Bourguignon|Margot Bourguignon
Allison Zava|Allison Zava
Lien Lanssens|Lien Lanssens
Flavie Bador|Flavie Bador
Sarah Borremans|Sarah Borremans
Ainhize Barrainkua|Ainhize Barrainkua
Molly Patch|Molly Patch
Laura Molenaar|Laura Molenaar
Anna Maria Gürtler|Anna Maria Gürtler
Ainara Arroyo|Ainara Arroyo
Alba Leonardo|Alba Leonardo
Kenny Weyh|Kenny Weyh
Joyce Echaquan|Joyce Echaquan
Leonardo da Vinci|लिओनर्दो दा विंची
Mahatma Gandhi|महात्मा गांधी
Vladimir Putin|ولادِیمِیر پُیوتِن
Gautama Buddha|गौतम बुद्ध
Vallabhbhai Patel|वल्लभ भाई पटेल
Liaquat Ali Khan|لیاقت علی خان
Raja Ravi Varma|راجہٕ رَوی وَرما
Ali al-Sistani|آیت اللہ سید علی سیستانی
Muhammad Ali Bogra|محمد علی بوگرہ
Muhammad Khan Junejo|محمد خان جونیجو
Lala Lajpat Rai|लाला लाजपत राए
Guru Tegh Bahadur|गुरु तेग़ बहादुर
Huseyn Shaheed Suhrawardy|حسین شہید سہروردی
Ahmad Sirhindi|شیخ احمد اَلفاروقي اَسرہندي
Balakh Sher Mazari|بلخ شیر مزاری
Pratap Singh I|महाराना प्रताप
Rehmat Aziz Chitrali|رحمت عزیز چترالی
Bilhana|بِلحَنا
Ali Zafar|علی ظفر
Saifuddin Kitchlew|सैफ़ुद्दीन किचलू
Adriaen Cornelisz Beeldemaker|Adriaen Cornelisz Beeldemaker
Sarabjit Singh|سَرَبجیٖت سِنٛگھ
Muhammed Azam Didamari|مُحَمَد اَعٔظم دیٖداماريی
Thomas Velley|Thomas Velley
Mehvish Mushtaq|مہوش مشتاق
Pablo Pintado|Pablo Pintado
Nadir Alvarez|Nadir Alvarez
Frank Hauenschild|Frank Hauenschild
Sylvia Hoffman|Sylvia Hoffman
Liam Christie|Liam Christie
Keaan Van Venrooij|Keaan Van Venrooij
Cristina Michelle Mata Pitti|Cristina Michelle Mata Pitti
Nikola Levkov|Nikola Levkov
Virag Buzsaki|Virag Buzsaki
Jennifer Manefield|Jennifer Manefield
Caroline Payot-Podevin|Caroline Payot-Podevin
Rhonda Quick|Rhonda Quick
Letizia Giardinelli|Letizia Giardinelli
Valentina Poli|Valentina Poli
Maya Escolar|Maya Escolar
Simone Trafelet|Simone Trafelet
Tara Mulder|Tara Mulder
Cindy Bauwens|Cindy Bauwens
Gitana Gruodyte|Gitana Gruodyte
Ruth Ellway|Ruth Ellway
Moira Tarraran|Moira Tarraran
Carolyn Maxwell|Carolyn Maxwell
Juri Gatt|Juri Gatt
Ionuț Șișcanu|Ionuț Șișcanu
Natalia Jamróz|Natalia Jamróz
Sebastian Mitterer|Sebastian Mitterer
Mischa Bredewold|Mischa Bredewold
Svenja Betz|Svenja Betz
Silvia Moroni|Silvia Moroni
Maud Rijnbeek|Maud Rijnbeek
Anna Bohata|Anna Bohata
Justine Louchaert|Justine Louchaert
Monique Ludovicy|Monique Ludovicy
Fien De Wispelaere|Fien De Wispelaere
Eléonore Saraiva|Eléonore Saraiva
Sara Ortiz|Sara Ortiz
Carolina Moreno|Carolina Moreno
Marta Brugue|Marta Brugue
Valerya Velichko|Valerya Velichko
Wan Yiu Jamie Wong|Wan Yiu Jamie Wong
Karien Van Jaarsveld|Karien Van Jaarsveld
Ines Cantera|Ines Cantera
Uxue Albizua|Uxue Albizua
Irantzu Beloki|Irantzu Beloki
Sabela Rey|Sabela Rey
Phil Harres|Phil Harres
Jannis Maul|Jannis Maul
Carlota Perurena|Carlota Perurena
Barack Obama|بَراک اؤبامہ
Jawaharlal Nehru|جَؤاہَر لال نہروُ
Noam Chomsky|نٲؤم چومسکۍ
Benazir Bhutto|بینظیر بھٹو
Aishwarya Rai|اَیشوریا رائۓ
Zayed Khan|زید خان
Hasan ibn Ali|امام حسن
Bilawal Bhutto Zardari|بلاول بھٹو زرداري
Bal Gangadhar Tilak|बाल गंगाधर तिलक
Ranjit Singh Sandhu|مَہراذہٕ رَنٛجیٖت سِنٛگھ
Khawaja Nazimuddin|خواجہ ناظم الدین
Ernst Stojaspal|Ernst Stojaspal
Malik Meraj Khalid|معراج خالد
Lalleshwari|لَلٮ۪شورۍ
Ram Prasad Bismil|राम प्रसाद बिस्मिल
Juan de Arespacochaga|Juan de Arespacochaga
Elīza Tīruma|Elīza Tīruma
Hassam-ud-Din Rashidi|پير حسام الدين راشدي
Mufti Mohammad Sayeed|مُفتي مُحَمَد سيٖد
Mehbooba Mufti|محبوبہ مفتی
Sanjay Kak|سَنٛجے کاک
Marcantonio Bragadin|Marcantonio Bragadin
Aziz Kashmiri|ازِز کشمؠرِ
Pedrito Martinez|Pedrito Martínez
Nikola Tvrtković|Nikola Tvrtković
José María Mendoza Ussía|José María Mendoza Ussía
Peter Schuchert|Peter Schuchert
José López Zanón|José López Zanón
Juan de Haro Piñar|Juan de Haro Piñar
Giovanni Battista Tocci|Giovanni Battista Tocci
Gaston Lecreux|Gaston Lecreux
Luciano Méndez|Luciano Méndez
Alekss Krasts|Alekss Krasts
Panagiotis Christopoulos-Cheller|Panagiotis Christopoulos-Cheller
Anastasios Kourmpetis|Anastasios Kourmpetis
Neftali Martinez|Neftali Martinez
Julie Hutsebaut|Julie Hutsebaut
Marina Khodchenkova|Marina Khodchenkova
Clarissa Breuer|Clarissa Breuer
Alena Popadova|Alena Popadova
Caroline Orens|Caroline Orens
Elisa Neri|Elisa Neri
Negringa Raudonite|Negringa Raudonite
Laurence Restoin|Laurence Restoin
Deborah Geentjens|Deborah Geentjens
Delphine Deschamps|Delphine Deschamps
Marie Kolarikova|Marie Kolarikova
Natascha Klewitz|Natascha Klewitz
Nimesha Smith|Nimesha Smith
Giancarlo Montedori|Giancarlo Montedori
Jozef Hušla|Jozef Hušla
Krists Lindenblats|Krists Lindenblats
Julia Hilber|Julia Hilber
Jung Hyun-woo|Jung Hyun-woo
Beata Sandström|Beata Sandström
Yasmine De Wulf|Yasmine De Wulf
Nathalie Cadol|Nathalie Cadol
Alice Zovico|Alice Zovico
Fiona Mertens|Fiona Mertens
Eleanor Wiseman|Eleanor Wiseman
Juliette Trombini|Juliette Trombini
Allyson Webb Charland|Allyson Webb Charland
Justine Lescrauwaet|Justine Lescrauwaet
Elena Debouck|Elena Debouck
Margot Pompanon|Margot Pompanon
Saioa Olite|Saioa Olite
Michaela Matzbacher|Michaela Matzbacher
Esthefania Hurtado|Esthefania Hurtado
Dominic Meinel|Dominic Meinel
