George Washington|जर्ज वासिङ्टन
George W. Bush|जर्ज डब्लु बुश
Plato|प्लेटो
Meryl Streep|मेरिल स्ट्रीप
Narendra Modi|नरेन्द्र मोदी
Indira Gandhi|इन्दिरा गान्धी
Ban Ki-moon|बान कि-मुन
Kofi Annan|कोफी अन्नान
Osama bin Laden|ओसामा बिन लादेन
Emily Dickinson|एम्लि डिकिन्सन
Mao Zedong|माओ त्से-तुंग
Marie Curie|मारिया क्युरी
Dorothy Hodgkin|डोरोथी हजकिन
Grazia Deledda|ग्राजिया डेलेड्डा
Peter the Great|पीटर महान
A. P. J. Abdul Kalam|अब्दुल कलाम
Salman Rashid Khan|सलमान खान
Martin Luther|मार्टिन लूथर
Harivansh Rai Bachchan|हरिवंश राय बच्चन
Thomas Jefferson|थोमस जेफर्सन
Bruce Lee|ब्रुस ली
Xavi Hernández|जावी हर्नान्डेज
Chester Bennington|चेस्टर बेनिंगटन
Steve Jobs|स्टिभ जब्स
Gustave Eiffel|गुस्ताभ आइफिल
Tracy Caldwell Dyson|ट्र्यासी क्याल्डवेल डायसन
Jimmy Carter|जिम्मी कार्टर
Klaas-Jan Huntelaar|क्लास-जान हन्टेलार
Taylor Swift|टेलर स्विफ्ट
Avril Lavigne|एभ्रिल लेभिन्ज
Sonali Bendre|सोनाली बेन्द्रे
Malala Yousafzai|मलाला युसुफजई
Alexander Graham Bell|अलेक्ज्याण्डर ग्राहम बेल
Gwyneth Paltrow|गेनिथ पाल्ट्रो
Alexis Texas|एलेक्सिस टेक्सास
Aria Giovanni|एरिया जिओभानी
Mila Kunis|मिला कुनिज
Helen Keller|हेलेन केलर
Doris Lessing|डोरिस लेसिङ्ग
Rosa Parks|रोजा पार्क्स
Wisława Szymborska|विसलावा जिम्बोस्का
Fernando Torres|फर्नान्डो टोरेस
Sitting Bull|सिटिङ बुल
Angus Young|अन्गुस योउङ्ग
Elfriede Jelinek|एलफ्रिड जेलीनेक
Catherine Zeta-Jones|क्याथरिन जिटा-जोन्स
Ilona Staller|इलोना स्टालर
Bimal Roy|बिमल राय
Mehboob Khan|महबूब खान
Ali Khamenei|अली खामेनी
Baburam Bhattarai|बाबुराम भट्टराई
Liam Neeson|लियाम निसन
Genelia D'Souza|जेनेलिया डिसुजा
Thibaut Courtois|थिबाउट कोर्टियस
Eduard Bernstein|एडुवार्ड बेर्नश्टाइन
John Milton|जोन मिल्टन
Tenzing Norgay|तेन्जिङ नोर्गे शेर्पा
Harrison Ford|हैरिसन फोर्ड
John Terry|जोन टेरी
Mirza Ghalib|मिर्जा गालिब
Bahadur Shah Zafar|बहादुर शाह जफर
Zulfiqar Ali Bhutto|जुल्फिकार अली भुट्टो
Sania Mirza|सानिया मिर्जा
Nawaz Sharif|नवाज शरिफ
Park Geun-hye|पार्क गेयुन हेई
Mahasweta Devi|महाश्वेता देवी
Émile Borel|एमिल बोरेल
Kirron Kher|किरण खेर
Aruna Irani|अरुणा ईरानी
Manoj Bajpai|मनोज बाजपेयी
Javier Hernández|ज्याभिअर हर्नाण्डेज
Usher|अस्स
Mary Carey|म्यारी केरी
Dani Alves|ड्यानियल एल्वस
Jean Tirole|जेन तिरोल
Katie Holmes|केटि होल्म्स
Alexis Sánchez|एलेक्सिस सान्चेज
Nicolás Otamendi|निकोलस ओतामेन्दी
Ramakrishna|रामकृष्ण परमहंस
Pitbull|पिटबुल
Preity Zinta|प्रीति जिन्टा
Rachel McAdams|रशेल म्याकऐड्म्स
Famke Janssen|फाम्की जेन्सेन
Zhang Zilin|झाङ जिलिन
Frances McDormand|फ्रान्सेस म्याकडोरमन्ड
Chandrika Kumaratunga|चन्द्रिका कुमारातुंगा
Amir Khosrow|अमीर खुसरो
Jordin Sparks|जोर्डन स्पार्क्स
Josh Hutcherson|जश हचर्सन
Lily Collins|लिली कोलिन्स
Carlos Gardel|कार्लोस गारडेल
Bhimrao Ramji Ambedkar|भीमराव अम्बेडकर
Mumtaz Mahal|मुमताज महल
Madhuri Dixit|माधुरी दीक्षित
Teagan Presley|टिगन प्रेस्ली
Atal Bihari Vajpayee|अटल बिहारी वाजपेयी
Gemma Ward|जेम्मा वार्ड
Liu Yang|लिउ याङ
Sophie Jonas|सोफी टर्नर
Cristina Bella|क्रिस्टिना बेल्ला
Riyo Mori|रियो मोरी
Alexis Amore|एलेक्सिस अमोरे
Lal Bahadur Shastri|लालबहादुर शास्त्री
Ally Sheedy|एल्ली सिडी
Cindy Crawford|सिन्डी क्रफोर्ड
May-Louise Flodin|मे-लुइस फ्लोडिन
Kasturba Gandhi|कस्तूरबा गान्धी
Hyapatia Lee|ह्यापासिया ली
Charaka|चरक
Adrenalynn|एड्रियाना लेन
Malaika Arora|मलाइका अरोडा खान
Miranda Otto|मिरेन्डा अट्टो
Arnold Vosloo|आर्नोल्ड भास्लो
Kei Nishikori|केई निशिकोरी
Tyrese Gibson|टाइरिस गिवसन
Donnie Yen|डोनी येन
Javad Nekounam|जाभेद नेकोउनाम
Fakhruddin Ali Ahmed|फखरुद्दीन अली अहमद
Abhimanyu|अभिमन्यु
Mary Kom|मेरी कोम
Shruti Haasan|श्रुति हासन
J. P. Dutta|जेपी दत्ता
Mandakini|मन्दाकिनी
Motilal Nehru|मोतीलाल नेहरू
Mangal Pandey|मंगल पाण्डे
Tanner Mayes|टान्नर मेज
Akshaye Khanna|अक्षय खन्ना
Sonia Baby|सोनिया बेबी
Sydnee Steele|सिड्नी स्टिल
Mika Tan|मिका टान
Soha Ali Khan|सोहा अली खान
Shannon Lucio|श्यान्नोन लुसिओ
Heather Hunter|हिदर हन्टर
Amber Smith|एम्बर स्मिथ
Barbara Jordan|बारबरा जोर्डन
Bunny Bleu|बन्नी ब्लेयू
Saina Nehwal|साइना नेहवाल
Padmini|पद्मिनी
Meena Kumari|मीना कुमारी
Mahadevi Varma|महादेवी वर्मा
Kiran Mazumdar-Shaw|किरण मजूमदार-शा
Victoria Givens|भिक्टोरिया गिभन्स
Linda Forsberg|लिन्डा फोर्सबर्ग
Ashwini Ponnappa|अश्विनी पोनप्पा
Asin|असिन
Edwin van der Sar|इड्वीन भेन डर सार
Luís Figo|लुइस फिगो
Rivaldo|रिभाल्डो
Luka Modrić|लुका मोड्रिच
Jack Black|ज्याक ब्ल्याक
Christine Lagarde|क्रिस्टिन लागार्द
Chris Pratt|क्रिस प्राट
Bina Rai|बीना राय
Angela Ahrendts|एन्जेला अहरेन्ड्ट्स
Pia Miranda|पिया मिरान्डा
Céline Tran|क्याट्सुनी
Chanel Preston|च्यानल प्रेस्टन
M. F. Husain|मकबुल फिदा हुसैन
Jackie Shroff|जैकी श्राफ
Nandita Das|नन्दिता दास
Nagendra Prasad Rijal|नगेन्द्रप्रसाद रिजाल
Virbhadra Singh|वीरभद्र सिंह
Steve Forbes|स्टिभ फोर्ब्स
Pooja Bhatt|पूजा भट्ट
Charlie Munger|चार्ल्स मङ्गर
Lindsey Meadows|लिन्ड्से मिडोस
Bam Bahadur Kunwar|बमबहादुर राणा
Kapil Sibal|कपिल सिब्बल
Chintamani Nagesa Ramachandra Rao|चिन्तामणी नागेश रामचन्द्र राव
Manoj Kumar|मनोज कुमार
Sharad Malhotra|शरद मल्होत्रा
Vidhu Vinod Chopra|विधु विनोद चोपडा
Muzaffar Ali|मुजफ्फर अली
Krishna Bahadur Mahara|कृष्णबहादुर महरा
Bombayla Devi Laishram|बोम्बायला देवी लैशराम
Sugriva|सुग्रीव
Smita Bansal|स्मिता बंसल
Sakshi Tanwar|साक्षी तन्वर
Cyrus Pallonji Mistry|सायरस मिस्त्री
Tony Greig|टोनी ग्रेग
Raageshwari|रागेश्वरी
Sadhana Sargam|साधना सरगम
Hansika Motwani|हंसिका मोटवानी
Kirti Nidhi Bista|कीर्तीनिधि विष्ट
Mohan Shamsher Jang Bahadur Rana|मोहन शमशेर जङ्गबहादुर राणा
Manoj Kumar|मनोज कुमार
Aiden Ashley|एडेन एस्ली
Mukesh|मुकेश
Tricia Devereaux|ट्रिसिया डेभेरेयक्स
Sabrine Maui|सब्रिन माउइ
Parmanand Jha|परमानन्द झा
Lisa Lipps|लिसा लिप्स
Baji Rao I|बाजीराव प्रथम
Misbah-ul-Haq|मिसवाह उल हक
SaRenna Lee|सरेना ली
Dominica Leoni|डोमिनिका लियोनी
Yuvraj Singh|युवराज सिंह
Vikram Bhatt|विक्रम भट्ट
Krishnakumarasinh Bhavasinh Gohil|कृष्णकुमारसिंह भावसिंह गोहिल
Abella Anderson|एबेल्ला एन्डरसन
Amshuverma|अंशुवर्मा
Mohit Chauhan|मोहित चौहान
Ashok Dinda|अशोक डिन्डा
Devon Lee|डेभन ली
Zoya Akhtar|जोया अख्तर
Haruki Mizuno|हारुकी मिजुनो
Paresh Rawal|परेश रावल
Shivraj Singh Chauhan|शिवराज सिंह चौहान
Lizz Tayler|लिज टेलर
Ebony Ayes|एबोनी आइज
Benegal Rama Rau|बेनेगल रामा राव
Shivshakti Sachdev|शिवशक्ति सचदेव
Nagarjun|वैद्यनाथ मिश्र 'यात्री'
Saroj Khan|सरोज खान
Gulshan Grover|गुलशन ग्रोवर
Upen Patel|उपेन पटेल
Neha Dhupia|नेहा धूपिया
Shiney Ahuja|शाइनी आहूजा
Jaya Prada|जयाप्रदा
S. Sreesanth|शान्ताकुमारन श्रीसन्त
Lakshmi Rai|लक्ष्मी राय
Mohan Bhagwat|मोहन भागवत
Nandana Sen|नन्दना सेन
Eoin Morgan|इयोन मोर्गन
Harmanpreet Kaur|हरमनप्रीत कौर
Dale Steyn|डेल स्टेन
C. Rangarajan|सी रङ्गराजन
Mohammad Shahzad|मोहम्मद शाहजाद
Saeed Admal|सईद अजमल
Rakhi Sawant|राखी सावन्त
Noriko Tatsumi|नोरिको तात्सुमी
Samantha Saint|सामन्था सेन्ट
Jiah Khan|जिया खान
Preeti Jhangiani|प्रीति झाङ्गियानी
Jacinda Ardern|जेसिन्डा एर्डर्न
Remy LaCroix|रेमि लाक्रोइक्स
Hazel Keech|हेजल कीच
Lalit Narayan Mishra|ललित नारायण मिश्र
Krishna Sobti|कृष्णा सोबती
Kalyan Singh|कल्याण सिंह
Dadu Dayal|दादूदयाल
Barkha Dutt|बरखा दत्त
Nicole Aniston|निकोल एनिस्टन
Billie Kay|बिली के
Princess Shruti of Nepal|अधिराजकुमारी श्रुति
Drashti Dhami|द्रष्टी धामी
Vibhavari Deshpande|विभावरी देशपाण्डे
Cara Lott|कारा लट
Aarti Chhabria|आरती छाबड़िया
Aasiya Kazi|आशिया काजी
Abhishek Pratap Shah|अभिषेक प्रताप शाह
Adah Sharma|अदा शर्मा
Aditya Roy Kapur|आदित्य रोय कपूर
Akshu Fernando|अक्षु फेर्नन्डो
Alia Bhatt|आलिया भट्ट
Amrapali Dubey|आम्रपाली दुबे
Angaraag Mahanta|पापोन
Diana Penty|डायना पेन्टी
Arjun Bijlani|अर्जुन बिज्लानी
Aroon Clansey|अरून क्ल्यानसे
Bal Narsingh Kunwar|बालनरसिंह कुँवर
Bimal Magar|विमल घर्ती मगर
Binod Das|विनोद दाश
Casey Dumont|क्यासी डुमन्ट
Puja Banerjee|पूजा बोस
Dayanand Shetty|दयानन्द शेट्टी
Dina Wadia|दीना वाडिया
Gauahar Khan|गौहर खान
Gauri Malla|गौरी मल्ल
Geeta Kapur|गीता कपूर
Ghulam Mustafa Khan|गुलाम मुस्तफा खान
Giaa Manek|जिया मानेक
Gurmeet Ram Rahim Singh|गुरमीत राम रहीम सिंह
Gyanendra Malla|ज्ञानेन्द्र मल्ल
Rao Raja Hanut Singh|राव राजा हनुत सिंह
Har Dayal|लाला हरदयाल
Himmanshoo A. Malhotra|हिमान्शु मल्होत्रा
Ram Vilas Paswan|रामविलास पासवान
Isha Talwar|इशा तलवार
Jay Bhanushali|जय भानुशाली
Joshna Chinappa|जोशना चिनप्पा
Kanika Kapoor|कनिका कपूर
Karan Wahi|करन वाही
Kortney Kane|कर्ट्नी केन
Kushal Tandon|कुशाल टण्डन
Lakshmi Menon|लक्ष्मी मेनन
Lalitha Lenin|ललिता लेनिन
Laxmi Narayan Tripathi|लक्ष्मी नारायण त्रिपाठी
Madan Krishna Shrestha|मदनकृष्ण श्रेष्ठ
Mehboob Alam|महबुब आलम
Mahesh Chhetri|महेश क्षेत्री
Malati Bedekar|मालती बेडेकर
Malvika Subba|माल्भिका सुब्बा
Sasha Banks|शाशा बेङ्क्स
Moeen Ali|मोईन अली
Mugdha Godse|मुग्धा गोडसे
Nidhi Razdan|निधि राजदान
Olivia Colman|ओलिभिया कोल्मेन
Paras Khadka|पारस खड्का
Pooja Gaur|पूजा गौर
Prachi Tehlan|प्राची तेहलान
Prasoon Joshi|प्रसून जोशी
Preeti Kaur|प्रीति कौर
Preeti Sagar|प्रीति सागर
Rajkummar Rao|राजकुमार राव
Raqesh Vashisth|राकेश वशिष्ठ
Rekha Bhardwaj|रेखा भारद्वाज
Remo D'Souza|रेमो डीसूजा
Richa Chadha|ऋचा चड्ढा
Sanaya Irani|सनाया ईरानी
Sanjay Khan|संजय खान
Sarah Jane Hamilton|सराह जेन ह्यामिल्टन
Shazia Ilmi|शाजिया इल्मी
Shraddha Arya|श्रद्धा अर्या
Nicole Oring|निकोल ओरिङ्ग
Sitaram Kattel|सिताराम कट्टेल
Sonarika Bhadoria|सोनारिका भदोरिया
Swapnil Joshi|स्वप्निल जोशी
Tulsi Ghimire|तुलसी घिमिरे
Upendra Mahato|उपेन्द्र महतो
Yuvika Chaudhary|युविका चौधरी
Zulfi Syed|जूलफि सैयद
Shakti Gauchan|शक्ति गौचन
Meera Sanyal|मीरा सन्याल
Rekha Thapa|रेखा थापा
Chandraghanta|चन्द्रघन्टा
Motilal|मोतीलाल
Raj Mehra|राज मेहरा
Subash Prasad Khakurel|सुवास खकुरेल
Mugdha Chaphekar|मुग्धा चाफेकर
Lopamudra Bhattacharji|लोपामुद्रा भट्टाचार्जी
Nivetha Tharseth|निवेथा थोमस
Rohit Roy|रोहित राय
Amrita Basnet|अमृता बस्नेत
Koili Devi Mathema|कोइलीदेवी
|मुगाली थापा
Balkrishna Sama|बालकृष्ण सम
Rakshya Rana|रक्षा राणा
Biraj Bhatta|विराज भट्ट
|संतोष पन्त
|सुस्मिता केसी
Sagar Pun|सागर पुन
Hemant Soren|हेमन्त सोरेन
Arundhati Bhattacharya|अरुन्धति भट्टाचार्य
Barsaman Pun|बर्षमान पुन
Basanti Kumal Chaudhari|बसन्ती कुमाल चौधरी
Nikita Singh|निकिता सिंह
Nalina Chitrakar|नलिना चित्रकार
Jaya Prakash Malla|जयप्रकाश मल्ल
Ankita Gaba|अङ्किता गाबा
Shakti Aurora|शक्ति अरोडा
Nischal Basnet|निश्चल बस्नेत
Nikki Galrani|निक्की गलरानी
Kanika Maheshwari|कनिका महेश्वरी
Freddy Daruwala|फ्रेडी दारूवाला
Nisha Rawal|निशा रावल
Akshar Patel|अक्षर पटेल
Kriti Sanon|कृति सेनन
Mrunal Thakur|मृणाल ठाकुर
Digangana Suryavanshi|दीगंगना सूर्यवंशी
Shruti Bapna|श्रुति बाफना
Indira Ranamagar|इन्दिरा राणा मगर
Sidhant Gupta|सिद्धान्त गुप्ता
Neha Mehta|नेहा मेहता
Sooraj Pancholi|सूरज पञ्चोली
Bhargavi Rao|भार्गवी राव
Sankhadhar Sakhwa|शङ्खधर शाख्वा
Vijay Kumar Pandey|विजय कुमार पाण्डे
Sher Dhan Rai|शेरधन राई
Alisson|अलिस्सोन
Radha Paudel|राधा पौडेल
Halsey|हल्जि
Asha Bhat|आशा भाट
Villy Aellen|Villy Aellen
Namita Dali|नमिता दली
Badshah|बादशाह
Helly Shah|हेली शाह
Sayyeshaa|सायेशा सैगल
Hari Prasad Rimal|हरिप्रसाद रिमाल
Bhawana Ghimire|भावना घिमिरे
|अमित मोहन झा
|कमला चौधरी
|जगदीश चन्द्र अनिल
|मदन ठाकुर
|राजकुमार मल्लिक
|राजेश मोहन झा
Nicolas Pépé|निकोलस पेपे
Harshaali Malhotra|हर्षाली मल्होत्रा
Mandy Rose|मेण्डि रोज
Hardik Patel|हार्दिक पटेल
Sai Dharam Tej|साई धरम तेज
Swastima Khadka|स्वस्तिमा खड्का
Archana Kochhar|अर्चना कोच्चर
Kamal Khatri|कमल खत्री
Bardish Chagger|बर्दिश चग्गर
Marta Unzué|मार्ता अन्जुई
Rishma Gurung|रेश्मा गुरुङ
Zahida Zaidi|जाहिदा जेदी
|आश्मा डिसी
|स्वेता खड्का
Babu Bogati|बाबु बोगटी
Anusmriti Sarkar|अनुस्मृति सरकार
Kunhu Muhammed|कुन्हु मुहम्मद
Kamal Shrestha|कमल श्रेष्ठ
Ayushman Joshi|आयुस्मान जोशी
Dharmapaal Barsingh Thapa|धर्मपालवरसिँह थापा
Sushil Chhetri|सुशील क्षेत्री
Balbhadra Shah|बलभद्र शाह
Rohit John Chhetri|रोहित जोन क्षेत्री
Chanira Bajracharya|चनिरा बज्राचार्य
Shradha Sharma|श्रद्धा शर्मा
Riya Bhatia|रिया भाटिया
Dalima Chhibber|डालीमा छिब्बर
Manuel Martínez Chumillas|Manuel Martínez Chumillas
Ángel Cadarso del Pueyo|Ángel Cadarso del Pueyo
Shubhi Ahuja|शुभी अहुजा
Nikita Chandak|निकिता चन्दक
Barsha Raut|वर्षा राउत
Sushil Shrestha|सुशील श्रेष्ठ
Melina Rai|मेलिना राई
Mamta Chaudhary|ममता चौधरी
Narayan Prakash Saud|नारायण प्रकाश साउद
Sushan Bhari|सुशन भारी
Rabindra Jha|रवीन्द्र झा
Nikita Dutta|निकिता दत्ता
Madan Kumari Shah|मदन कुमारी शाह (गरिमा शाह)
Mukti Prasad Pathak|मुक्ति प्रसाद पाठक
Manpur Chaudhary|मानपुर चौधरी
Rishikesh Pokhrel|ऋषिकेश पोखरेल
Asha Chaturbedi|आशा चतुर्वेदी
Pashupati Chulagai|पशुपति चौलागाई
Rameshwor Prasad Dhungel|रामेश्वर प्रसाद ढुङ्गेल
Ram Krishna Yadav|राम कृष्ण यादव
Karda Badhur Thapa|कर्ण बहादुर थापा
Lalit Jung Shahi|ललित जंग शाही
Narayan Maan Bijukche|नारायण मान बिजुक्छेँ (रोहित)
Paddha Narayan Chaudhari|पद्म नारायण चौधरी
LalBabu Singh Bhuihar|लालबाबु सिंह भुइहार
Kamaleshwor Puri Goshami|कमलेश्वर पूरी गोस्वामी
Kalpana Sob|कल्पना सोब
Vijay Kumar Gachhdar|विजय कुमार गच्छदार
Bimal Kumar Kedia|विमल कुमार केडिया
Bimalendra Nidhi|विमलेन्द्र निधी
Prem Bahadur Ale|प्रेम बहादुर आले
Prem Bahadur Giri|प्रेम बहादुर गिरी
Prem Suwal|प्रेम सुवाल
Shakuntala RajBhandari|शकुन्तला राजभण्डारी (कार्की)
Shyam Kumar Shrestha|श्याम कुमार श्रेष्ठ
Krishna Prasad Sitaula|कृष्ण प्रसाद सिटौला
Ganesh Man Gurung|गणेश मान गुरुङ्ग
Gita Chhetri|गीता क्षेत्री
Santa Kumar Tharu|सन्त कुमार थारु
Prakash Sharma Paudel|प्रकाश शर्मा पौडेल
Balram Adhakari|बलराम अधिकारी
Badhur Singh Thapa|बहादुर सिंह थापा
Vishwendra Pashwan|बिश्वेन्द्र पासवान
Surendra Prasad Jaiswal|सुरेन्द्र प्रसाद जयसवाल
Surendra Raj Acharya|सुरेन्द्र राज आचार्य
Sumitra Tharuni|सुमित्रा थरुनी
Bansidhar Mishra|डा. बंशिधर मिश्र
Kalyani Priyadarshan|कल्याणी प्रियदर्शन
Aakash Bista|आकाश बिस्ट
Sandeep Sunar|सन्दीप सुनार
Sundeep Jora|सुन्दीप जोरा
Sunny Patel|सन्नि पटेल
Prakash KC|प्रकाश केसि
Harishankar Sah|हरिशंकर शाह
Saraswoti Chaudhary|सरस्वती कुमारी चौधरी
Gopal Prasad Parajuli|गोपाल प्रसाद पराजुली
Prakash Neupane|प्रकाश न्यौपाने
Barsha Siwakoti|बरशा सिवाकोटी
kalpana regmi|कल्पना रेग्मी
Ratneshwar Lal Kayastha|रत्नेश्वर लाल कायस्थ
Shreya Khadka|श्रेया खड्का
Sujata Rai|सुजाता राई
Nery Thapa|नेरी थापा
Hima Das|हिमा दास
Max Müller|म्याक्स मुलर
Mahendra Bahadur Shahi|महेन्द्र बहादुर  शाही
Madhav Rani Shah|माधवी रानी साह
Man Bahadur  Bishokarma|मान बहादुर विश्वकर्मा
Bijay Chaurasia|विजय चौरसिया
Orso Orsini|Orso Orsini
Abhinandan Varthaman|अभिनन्दन वर्द्धमान
Komal Oli|कोमल ओली
Nirmal Purja|निर्मल पुर्जा
Ashok Kumar Yadav|अशोक कुमार यादव
Gita Kumari Yadav|गीता कुमारी यादव
Govinda Bahadur Neupane|गोविन्द बहादुर न्यौपाने
Manju Kumari|मन्जु कुमारी
Minu Gurung|मिनु गुरुङ
Pritam Acharya|प्रितम आचार्य
Fanny Vaucher|Fanny Vaucher
Bhumika Giri|भूमिका गिरी
Kate Sayer|Kate Sayer
Krishna Malla|कृष्ण मल्ल
Anna Kulikova|Anna Kulikova
Jean-Pierre Lloyd|Jean-Pierre Lloyd
Areke Hassink|Areke Hassink
Paula Fedirchuk|Paula Fedirchuk
Claudia Migliorini|Claudia Migliorini
Sylvia Debboudt|Sylvia Debboudt
Miranda De Permentier|Miranda De Permentier
Aurélie Anaise|Aurélie Anaise
Gulnara Fatkullina|Gulnara Fatkullina
Mirza Nikolajev|Mirza Nikolajev
Elīna Ieva Vītola|Elīna Ieva Vītola
Kyle Murray|Kyle Murray
Stefan Kiefer|Stefan Kiefer
Stephen Harper|स्टेफेन हार्पर
Galileo Galilei|ग्यालिलियो ग्यालिली
Bob Marley|बब मार्ली
Molière|मलिएर
Socrates|सुकरात
Dante Alighieri|दान्ते ऐलिगिरी
Caligula|कालिगुला
Robin van Persie|रोबिन भान पर्सी
Rajiv Gandhi|राजीव गान्धी
Céline Dion|सेलिन डियोन
Hippocrates|हिप्पोक्रेटीस
Charles Dickens|चार्ल्स डिकेन्स
50 Cent|फिफ्टी सेन्ट
Hillary Clinton|हिलरी रडम क्लिन्टन
Homer|होमर
Kalidasa|कालिदास
Joan of Arc|जोन अफ अर्क
Rosa Luxemburg|रोजा लक्सेम्बर्ग़
Yuri Gagarin|युरी गगारिन
Akbar|अकबर
Kwame Nkrumah|क्वामे न्क्रुमा
Michael Faraday|माइकल फराडे
Johannes Gutenberg|जोन गुटेन्बर्ग
Ronald Reagan|रोनाल्ड रेगन
Rafael Nadal|रफाएल नडाल
Siobhan Chamberlain|सिओभान क्याम्बरलेन
Serena Williams|सेरेना विलियम्स
Harry S. Truman|हैरी ट्रूमन
Grace Hopper|ग्रेस हूपर
James Madison|जेम्स म्याडिसन
Britney Spears|ब्रिट्नी स्पेयर्स
Franklin Pierce|फ्र्याङ्कलिन पार्स
Anousheh Ansari|अनुशेह अन्सारी
Stephen Hawking|स्टिफन हकिङ
Mike Shinoda|माइक शिनोडा
Chris Watson|कृस वाट्सन
Jeremy Renner|जेरेमी रेनर
Herodotos|हीरोडोटस
Hema Malini|हेमा मालिनी
Alektra Blue|एलेक्ट्रा ब्लु
Ashlynn Brooke|एश्लिन ब्रुक
Beyoncé|बेयोन्से
Rihanna|रिहाना
Lana Del Rey|लेना डेल रे
Michael Phelps|माइकल फ्लेप्स
Jim Carrey|जिम केरी
Julia Roberts|जुलिया रोबर्ट्स
Virginia Woolf|भर्जिनिया वुल्फ
Katy Perry|केइटी पेरी
Chris Jericho|क्रिस जेरिको
Cameron Diaz|क्यामरुन डियाज
Zac Efron|ज्याक एफ्रोन
Satyendra Nath Bose|सत्येन्द्र नाथ बोस
Wangari Muta Maathai|वाङ्गारी माथाई
Swami Vivekananda|स्वामी विवेकानन्द
Hrishikesh Mukherjee|ऋषिकेश मुखर्जी
Christa Wolf|क्रिस्टा वुल्फ
Rajinikanth|रजनीकान्त
Ursula von der Leyen|उर्जुला भोन डर लायन
Bal Thackeray|बाल ठाकरे
Mike Tyson|माइक टाइसन
Anne Boleyn|ऐनी बोलिन
Selena Gomez|सेलेना गोमेज
Guru Nanak|गुरु नानक
Winona Ryder|विनोना राईडर
Mario Götze|मारियो गोट्जे
Miranda Kerr|मिरेण्डा केर
Neymar|नेयमार
Tanuja|तनुजा
Tanishaa Mukerji|तनिशा मुखर्जी
Emma Stone|एम्मा स्टोन
Ariana Grande|अरिएना ग्रान्ड
Lata Mangeshkar|लता मंगेशकर
Dimple Kapadia|डिम्पल कपाडिया
John Constable|जोन कन्स्टेबल
Kiki Håkansson|किकी हाकानस्सन
Dara Singh|दारा सिंह
Zeami Motokiyo|जेमि
William Hogarth|विलियम होगार्थ
Matt Damon|म्याट डामोन
Fergie|फर्गी
Li Na|ली ना
Gal Gadot|गाल गादोत
Kim Kardashian|किम कार्दशियन
Elisha Cuthbert|एलिसा कुथबर्ट
Chandragupta Maurya|चन्द्रगुप्त मौर्य
Freida Pinto|फ्रिडा पिन्टो
Annette Bening|एन्नेट्ट बेनिङ
Brendan Fraser|ब्रिनडेन फ्रासर
Bradley Cooper|ब्राडली कुपर
Eden Hazard|एडेन हाज़ार्ड
Carmen Luvana|कारमेन लुभाना
Amber Heard|अम्बर हर्ड
Allison Janney|एलिसन जेनी
Kelly Macdonald|केली म्याकडोनाल्ड
Jordana Brewster|र्जोडना ब्रिस्टर
Rebeca Linares|रिबेका लिनरेस
Monique Alexander|मोनिक अलेक्जेन्डर
Hrithik Roshan|ऋतिक रोशन
Cecilia Roth|सिसिलिया रोट
Hayley Atwell|हेइली एट्वेल
Janet Reno|जेनेट रेनो
Jill Kelly|जिल केली
Shivaji Bhonsle I|शिवाजी
Dichen Lachman|दिछेन ल्याखमेन
Jenna Presley|जिना प्रेस्ली
Nikky Blond|निक्की ब्लन्ड
Gauge|गज
Stacy Silver|स्ट्यासी सिल्भर
I. K. Gujral|इन्द्र कुमार गुजराल
Christy Canyon|कृष्टी क्यान्योन
Linsey Dawn McKenzie|लिन्से डन म्याकेन्जी
Sophia Santi|सोफिया सान्ती
Shawna Lenee|शव्ना लेनी
Yasmine Lafitte|यास्मिन लफिट्टे
Yukta Mookhey|युक्ता मुखी
Theresa May|थेरेसा मे
Juli Ashton|जुली अस्टन
Kathy Hilton|क्याथी हिल्टन
Emily Rose|एमिली रोज
Konkona Sen Sharma|कोंकोना सेन
Sabrina Ferilli|सब्रिना फेरिल्ली
Roman Reigns|रोमन रेन्ज
Ashutosh Gowariker|आशुतोष गोवरिकर
Amrita Arora|अमृता अरोडा
Katalin Vad|क्याटालिन भाड
Jeff Bezos|जेफ बेजोस
Tulsidas|तुलसीदास
Jagadish Chandra Bose|डा. जगदीश चन्द्र बोस
Pushpa Kamal Dahal|पुष्प कमल दाहाल
Abhijit Banerjee|अभिजीत बनर्जी
Shammi Kapoor|शम्मी कपूर
Tony Abbott|टोनी एबोट
Earle Page|अर्ल पेज
Sushil Kumar|सुशील कुमार
Shashi Kapoor|शशि कपूर
Mithun Chakraborty|मिथुन चक्रवर्ती
Kelli McCarty|केली म्याककार्टी
Jennifer Ketcham|जेनिफर केचह्याम
Arjun Rampal|अर्जुन रामपाल
Jasmin St. Claire|ज्यास्मिन सेन्ट क्लाइरी
Antoine Griezmann|एन्टोनी ग्रिजम्यान
Tu Youyou|तु युयु
Sheila Dikshit|शीला दीक्षित
Nadira|नादिरा
Divya Bharti|दिव्या भारती
Shabana Azmi|शबाना आजमी
Alka Yagnik|अलका याज्ञनिक
Gayatri Joshi|गायत्री जोशी
Rokeya Sakhawat Hossain|बेगम रुकय्या
Amy Fisher|एमी फिसर
Ela Bhatt|इला भट्ट
Caroline Pierce|क्यारोलिन पाइर्स
Chloe|क्लोए
Sonu Nigam|सोनू निगम
Vinayak Damodar Savarkar|विनायक दामोदर सावरकर
Amrita Prakash|अमृता प्रकाश
Ellen DeGeneres|एलेन डिजेनर्स
Gillian Anderson|गिलियन एंडरसन
Eleanor Hallowell Abbott|इलिनुर हलोवेल एवोट
Anupama Chopra|अनुपमा चोपडा
Anastasia Mayo|अनास्टासिया मायो
Shobhaa De|शोभा डे
Norah Jones|नोराह जोन्स
Lux Kassidy|लक्स क्यासिडी
Bibi Jones|बिबी जोन्स
Sunil Chhetri|सुनिल क्षेत्री
Aruna Vasudev|अरुणा वासुदेव
Farhan Akhtar|फरहान अख्तर
Sonakshi Sinha|सोनाक्षी सिन्हा
Allu Arjun|अल्लू अर्जुन
James Anderson|जेम्स एन्डरसन
Begum Hazrat Mahal|बेगम हजरत महल
R. Madhavan|आर. माधवन
Cindy Hope|सिन्डी होप
Vivek Oberoi|विवेक ओबेरोय
M. Visvesvaraya|मोक्षगुंडम विश्वेश्वरय्या
Ben Howard|बेन हावर्ड
Bhagwan Das|भगवान दास
Koena Mitra|कोइना मित्रा
Saeed Jaffrey|सईद जाफरी
Madan Kumar Bhandari|मदन भण्डारी
Jacques Kallis|ज्याक कालिस
Éva Henger|इभा हेङ्गर
Ranbir Kapoor|रणबीर कपुर
Yui Tatsumi|युइ तात्सुमी
Sophia Rossi|सोफिया रोसी
Ai Iijima|आई ईजिमा
David in Islam|दौड गाविस
Eric Betzig|एरिक बेजिग
Jimmy Shergill|जिमी शेरगिल
Kendall Jenner|केन्डल जेन्नर
Ramanand Sagar|रामानन्द सागर
Kailash Kher|कैलाश खेर
Inzamam-ul-Haq|इन्जमाम उल हक
Neerja Bhanot|नीरजा भनोट
Asma Jahangir|आस्मा जहाँगीर
Sanjay Kapoor|संजय कपूर
John O'Keefe|जोहन ओ केफे
Salma Agha|सलमा आगा
Waqar Younis|वकार युनिस
Pratibha Ray|प्रतिभा राय
Vishnu Narayan Bhatkhande|विष्णु नारायण भातखंडे
Govinda|गोविन्दा
Sriti Jha|सृति झा
Rachel Roxxx|राचेल रक्स
Kausalya|कौशल्या
Rajkumar Santoshi|राजकुमार सन्तोषी
Lela Star|लेला स्टर
Lasith Malinga|लसिथ मलिङ्गा
Dakota Johnson|डेकोटा जोनसन
Shamita Shetty|शमिता शेट्टी
Vidyapati|विद्यापति
Pawan Kumar Chamling|पवन कुमार चामलिङ
Pratap Singh Shah|प्रतापसिंह शाह
Mandavi|माण्डवी
Rubina Ali|रुबीना अली
Sharka Blue|शर्का ब्लू
Babita Kumari|बबीता फोगाट
Jamie Brooks|जेमी ब्रुक्स
Ravindra Jadeja|रविन्द्र जडेजा
Ajay Jadeja|अजय जडेजा
Kiran Bedi|किरण बेदी
Koppillil Radhakrishnan|कोप्पिल्लिल राधाकृष्णन
Sarah Blake|सराह ब्ल्याक
Adam Voges|एडम वोगेस
Maneka Gandhi|मेनका गान्धी
Nanna Grønnevik|डिना जेवेल
Jyothika|ज्योतिका
Aditya Pancholi|आदित्य पञ्चोली
Allauddin Khan|उसताद अलाउद्दीन खान
Astha Laxmi Shakya|अष्टलक्ष्मी शाक्य
Nawazuddin Siddiqui|नवाजुद्दीन सिद्दीकी
Ravichandran Ashwin|रविचन्द्रण अश्विन
Daiane|डायने
Zarine Khan|जरीन खान
Pran|प्राण
Kumar Sanu|कुमार सानु
Lily Carter|लिली कार्टर
Jandi Lin|जान्डी लिन
Velvet Rose|भेल्भेट रोज
Blue Angel|ब्लू एन्जल
Mukul S. Anand|मुकुल आनन्द
Pampha Bhusal|पम्फा भुषाल
Prakash Jha|प्रकाश झा, फिल्म निर्देशक
Morné Morkel|मोर्ने मोर्केल
Suresh Raina|सुरेश रैना
Murali Vijay|मुरली विजय
Umesh Yadav|उमेश यादव
Kratika Sengar|कृतिका सेंगर
Stuart Binny|स्टुआर्ट बिन्नी
Vinay Kumar|विनय कुमार
Nirmala Deshpande|निर्मला देशपाण्डे
Heather Starlet|हिदर स्टार्लेट
Asit Sen|असित सेन
Anita Hassanandani|अनिता हस्सनन्दनी
Pushpa Basnet|पुष्पा बस्नेत
Devyani Rana|देवयानी राणा
Muppavarapu Venkaiah Naidu|वेङ्कैया नायडू
Sandhya Agarwal|सन्ध्या अग्रवाल
Honey Wilder|हनी वाइल्डर
Queen Ratna of Nepal|रानी रत्न राज्यलक्ष्मी देवी शाह
Ranga Nath Poudyal|रङ्गनाथ पौडेल
Tatevik Sazandaryan|तातेभिक साजानदार्यन
Narayan Man Bijukchhe|नारायणमान बिजुक्छे
Aditi Rao Hydari|अदिति राव हैदरी
Adriaan van der Willigen|Adriaan van der Willigen
Adriaan van der Willigen Pz.|Adriaan van der Willigen Pz.
Adriaen Foly|Adriaen Foly
Aindrita Ray|ऐन्ड्रिता रे
Aishwarya Sakhuja|ऐश्वर्या सखुजा
Alyssa Love|एलिसा लभ
Amit Kumar|अमित कुमार
Anupama Deshpande|अनुपमा देशपाण्डे
Ashita Dhawan|अशिता धवन
Balaji Vishwanath|बालाजी विश्वनाथ
Ileana Citaristi|इलियाना सिटारिस्टी
Marillyn Hewson|मारिलिन ह्युसन
Dashrath Chand|दशरथ चन्द
Kyra Dutt|कायरा दत्त
Deepshika|दीपशिखा
Dharma Bhakta Mathema|धर्मभक्त माथेमा
Edvard Moser|एडभार्ड मोजर
Farah Khan Ali|फराह खान अली
Gail Koziara Boudreaux|गेल कोजिएरा बौद्रोउ
Ganesh Hegde|गणेश हेगडे
Ganganath Jha|गंगानाथ झा
Gippy Grewal|गिप्पी ग्रेवाल
H. V. R. Iengar|एचभिआर आयङ्गर
Harshdeep Kaur|हर्षदीप कौर
Hasleen Kaur|हसलिन कौर
Huma Qureshi|हुमा कुरैसी
Jaswinder Brar|जसविन्दर ब्रार
K. G. Ambegaonkar|के जी अम्बेगाओङ्कर
K. Palanisamy|के पलानीस्वामी
Kartik Aaryan|कार्तिक आर्यन
Kaveri Jha|कावेरी झा
Katayoun Riahi|कातायुँ रियाही
Lalita Pawar|ललिता पवार
Leena Jumani|लीना जुमानी
Linzi Drew|लिन्जी ड्र्यु
Rohit Shetty|रोहित शेट्टी
Mahira Khan|माहिरा खान
Mithoon|मिथुन
Mohammad Irfan Ali|मोहम्मद इरफान अली
Mohit Malhotra|मोहित मल्होत्रा
Mona Singh|मोना सिंह
Mouli Ganguly|मौली गाङ्गुली
Naga Chaitanya|नागा चैतन्य
Neelam Kothari|निलम कोठारी
Neena Gupta|नीना गुप्ता
Nikita Thukral|निकिता ठुक्राल
Niruta Singh|निरुता सिंह
Padma Khanna|पदमा खन्ना
Pakhi Hegde|पाखी हेगडे
Pallavi Sharda|पल्लवी शारदा
Piyush Goyal|पीयूष गोयल
Priya Anand|प्रिया आनन्द
Priyanka Karki|प्रियंका कार्की
Ravi Kishan|रवि किशन
Ravi Varman|रवि वर्मन
Raza Murad|रजा मुराद
Rita Bhaduri|रिटा भादुडी
Ruchira Kamboj|रुचिरा कम्बोज
Sandali Sinha|सन्दली सिन्हा
Sanjam Regmi|सञ्जम रेग्मी
Sayaji Shinde|सयाजी शिन्दे
Sayeed Quadri|सईद कादरी
Shaheer Sheikh|शाहीर शेख
Shaili Chopra|शैली चोपड़ा
Sharat Saxena|शरत सक्सेना
Shefali Zariwala|शेफाली जरिवाला
Shibani|शिबानी दान्डेकर
Shrenu Parikh|श्रेनु पारिख
Shubhangi Atre Poorey|शुभांगी अत्रे पूरे
Smriti Mehra|स्मृति मेहरा
Sonal Chauhan|सोनल चौहान
Subash Nemwang|सुवासचन्द्र नेम्बाङ
Suchitra Bhattacharya|सुचित्रा भट्टाचार्य
Supriya Pathak|सुप्रिया पाठक
Suraj Singh Thakuri|सुरज सिंह ठकुरी
Sushil Kumar Modi|सुशील कुमार मोदी
Swanand Kirkire|स्वानन्द किरकिरे
Swati Reddy|स्वाती रेड्डी
Texas Presley|टेक्सास प्रेस्ली
Tulsi Kumar|तुलसी कुमार
Usha Rajak|उषा रजक
Sushant Singh Rajput|सुशान्त सिंह राजपुत
Jitendra Karki|जितेन्द्र कार्की
Momoka Mizukami|मोमोका मिजुकामी
Pankaj Tripathi|पंकज त्रिपाठी
Jennifer Winget|जेनिफर विङ्गेट
N. S. Hardikar|नारायण सुब्बाराव हार्दिकर
Kishore Pahadi|किशोर पहाडी
Tara Nath Sharma|तारानाथ शर्मा
Nima Rumba|नीमा रुम्बा
Pramod Kharel|प्रमोद खरेल
|युना उप्रेती
Shree Krishna Shrestha|श्रीकृष्ण श्रेष्ठ
Sanchita Luitel|सञ्चिता लुइटेल
Sujal Shrestha|सुजल श्रेष्ठ
Tejashwi Yadav|तेजस्वी यादव
Urjit Patel|उर्जित पटेल
Radha|राधा (अभिनेत्री)
Aaliyah Love|आलिया लभ
Penny Pax|पेन्नी प्याक्स
Phalgunanda|महागुरु फाल्गुनन्द
Hari Mohan Jha|हरिमोहन झा
Gurbani Judge|गुरबानी जज
Madhurima Tuli|मधुरिमा तुली
Munmun Dutta|मूनमून दत्ता
Sitashma Chand|सिताश्मा चन्द
Geetanjali Thapa|गीताञ्जलि थापा
Kiara Advani|कियारा आडवाणी
Anukriti Gusain|अनुकृति गोसाई
Anaswara Kumar|अनासवारा कुमार
Surendra Pandey|सुरेन्द्र बहादुर पाण्डे
Tek Bahadur Gurung|टेक बहादुर गुरुङ
Sambit Patra|संबित पात्रा
Renato Sanches|रेनाटो सान्चेस
Aditya Chaudhary|आदित्य चौधरी
Raghunandan Das|रघुनन्दन दास
Anmol K.C.|अनमोल केसी
Adriana Chechik|एड्रियाना चेचिक
Shriya Pilgaonkar|श्रीया पिलगांवकर
Sajana Rana|सजना राना
Umesh Shrestha|उमेश श्रेष्ठ
Tilak Pariyar|तिलक परियार
|पुजा गुरुङ
|सारङ्गा श्रेष्ठ
Sunil Pokharel|सुनील पोखरेल
Charlie Puth|चार्लि पथ
Parull Chaudhry|पारुल चौधरी
|उदित नारायण
|उमेश मिश्र
|कृष्ण मोहन झा
Gonu Jha|गोनू झा
|जगदीश प्रसाद मंडल
|नागेन्द्र कर्ण
|नीलम चौधरी
|प्रकाश झा, मैथिली रंगमंच
|प्रदीप बिहारी
|प्रियंका झा
|रवीन्द्र नाथ ठाकुर
|राजा त्रिभुवन बिर बिक्रम शाह
Siya Ram Jha ''Saras''|सियाराम झा "सरस"
Parul Gulati|पारुल गुलाटी
Pragya Jaiswal|प्रज्ञा जैसवाल
Mira Rai|मीरा राई
Lilanath Ghimire|लीलानाथ घिमिरे
Jyoti Magar|ज्योती मगर
Anna Sharma|अन्नपूर्ण शर्मा
Ruhi Singh|रुही सिंह
Laxmirani Majhi|लक्ष्मीरानी माझी
Jan Pawlowski|Jan Pawlowski
Suboth Bhati|सुबोथ भाटी
Iris Mittenaere|आइरिस मित्तेनायर
Kalu Pande|कालु पाण्डे
Lionel Cavin|Lionel Cavin
Mahima Silwal|महिमा सिलवाल
Saayoni Ghosh|सयानी घोष
Puneet Mehra|पुनित मेहरा
Sandeep Lamichhane|सन्दिप लामिछाने
Raju Rijal|राजु रिजाल
Moon Banerrjee|मून बनर्जी
Kajal Raghwani|काजल राघवानी
Jean-Philippe Anstett|Jean-Philippe Anstett
Shivaram Singh Basnyat|शिवराम सिंह बस्न्यात
Kehar Singh Basnyat|केहरसिंह बस्न्यात
Indira Dangi|इन्दिरा दाँगी
Pramod Sawant|प्रमोद सावन्त
Aparna Dutta Gupta|अप्रना दत्ता गुप्ता
Dipendra Singh Airee|दीपेन्द्र सिंह ऐरी
Francisco Alonso Martos|Francisco Alonso Martos
Jesús Martínez Verón|Jesús Martínez Verón
Joaquín de la Concha Alcalde|Joaquín de la Concha Alcalde
Felipe Medina Benjumea|Felipe Medina Benjumea
Bishal Rai B|विशाल राई
Guru Randhawa|गुरु रन्धावा
Manushi Chhillar|मनुषी छिल्लर
Dhinchak Pooja|धिन्चक पूजा
Ram Chandra Chaudhary|राम चन्द्र चौधरी
Atisha Pratap Singh|अतिशा प्रताप सिंह
|रोहिणी हट्टन्गडी
Kathy Jetnil-Kijiner|क्याथी जेटनील-किजीनर
Anajni Shrestha|अञ्जनी श्रेष्ठ
Man Kumar Gautam|मन कुमार गौतम
Jivan Bahadur Shahi|जीवन बहादुर शाही
Tara Devi Rai|तारा देवी राई
Bhanu Bhakta  Dhakal|भानु भक्त ढकाल
Dr. Ganesh Kumar Mandal|डा. गणेश कुमार मण्डल
Saroj Sharma|सरोज शर्मा
Narayan Bhadhur Karki|नारायण बहादुर कार्की
Usha Yadav|उषा यादव
Laxmi Kumari Chaudhary|लक्ष्मी कुमारी चौधरी
Bhim Prasad Acharya|भीम प्रसाद आचार्य
Rajeev Bikram Shah|राजीव विक्रम शाह
Ram Chandra Pokharel|राम चन्द्र पोखरेल
Ram Narayan Vidari|राम नारायण विडारी
Rammaya Bogati|राममाया वोगटी
Asha Yadav|आशा यादव
Rita Rawal|रिता रावल
Rupa Maharjan|रुपा महर्जन (श्रेष्ठ)
Aasha Chatubedi|आशा चतुवेदी
Lila Devi Shrestha|लिला देवी श्रेष्ठ
Santa Manavi|शान्ता मानवी
Shiva Kumari Gotame(Sarki)Nagarkoti|शिव कुमारी गोतामे -सार्की
Shiva Chandra Chaudhary|शिव चन्द्र चौधरी
Bichari Prasad Yadav|विचारी प्रसाद यादव
Kalasa Devi Mahara|कलसा देवी महरा
Dr. Vijay Kumar Singh|डा. विजय कुमार सिंह
Kedar Prasad Sanjel|केदार प्रसाद संजेल
Pratikshya Tiwari Mukhiya|प्रतिक्षा तिवारी मुखिया
Sita Giri|सिता गिरी -ओली)
Prem Kishor Prasad Shah Teli|प्रेम किसोर  प्रसाद  साह तेली
Buddhiram Bhandari|वुद्धिराम भण्डारी
Shambhu Lal Shrestha|शम्भु लाल श्रेष्ठ
Ganesh Kumar Pahadi|गणेश कुमार पहाडी
Giriraj Mani Pokharel|गिरीराज मणी पोखरेल
Goma Kunwar|गोमा कुवर
Gauri Kumari Oli|गौरी कुमारी ओली
Sesh Nath Adhakari|शेष नाथ अधिकारी
Shankar Bhandari|शंकर भण्डारी
Pramila Rana|प्रमिला राणा
Sathyanarayan Bhagat Bin|सत्यनारायण भगत विन
Ganga Lal Tuladhar|गंगा लाल तुलाधर
Puskarnath Ojha|पुष्करनाथ ओझा
Balbir Prasad Chaudhary|बलवीर  प्रसाद चौधरी
Priya Raina|प्रिया रैना
Krishna Karki|कृष्ण कार्की
Abhinash Bohara|अभिनास बोहोरा
Sushil Kandel|सुशिल कंडेल
Dipesh Bhandari|दिपेस भण्डारी
Lalit Rajbanshi|ललित राजबंसि
Harjeet Singh|हारजीत सिंह
Sumit Maharjan|सुमित महर्जन
Sagar Kumar|सागर कुमार
Indu Verma|इन्दु बर्मा
Phool Babu|शेख अबुलकलाम आजाद
|पी. टी. उषा
Anil Sah|अनिल साह
Meghna Mishra|मेघना मिश्रा
Sapna Choudhary|सपना चौधरी
Santosh Lama|सन्तोष लामा
Akash shrestha|आकाश श्रेष्ठ
Amrita jaisi|अमृता जैसी
Konstantina Sintzaniki|Konstantina Syntzanaki
Soniya Yadav|सोनिया यादव
Suryaday Das Urarao|सुर्यदेव दास उराँव
|प्रेमा शाह
Jakob Blasel|ज्याकब ब्लासेल
Alka Kumari Jha|अल्का कुमारी झा
Karima Begam|करिमा बेगम
Shiv Chandra Chaudhary|शिव चन्द्र चौधरी
Rubi Karna|रुबी कर्ण
Manoj Kumar Singh|मनोज कुमार सिंह
Upendra Mahato|उपेन्द्र महतो
Madan Sen Prasad Shreevastav|मदन सेन प्रसाद श्रीवास्तव
Pralad Giri Goswami|प्रलाद गिरी गोस्वामी
Thakur Prasad Gyawaly|ठाकुर प्रसाद ज्ञवाली
Gjergj Zefi|Gjergj Zefi
Linus Kvist|Linus Kvist
Erki Laanemäe|Erki Laanemäe
Ingram Cuff|Ingram Cuff
Nikita Stenkovoy|Nikita Stenkovoy
Maria Ögn Gudmundsdottir|Maria Ögn Gudmundsdottir
Cornelia Cyrus|Cornelia Cyrus
Ioulia Eremeeva|Ioulia Eremeeva
Julia Bradley|Julia Bradley
Simona Wagnerova|Simona Wagnerova
Sara Savino|Sara Savino
Florian Auer|Florian Auer
Emīls Cipulis|Emīls Cipulis
Marián Skupek|Marián Skupek
Adam Dobeš|Adam Dobeš
Mara Morell|Mara Morell
Dylan Sorensen|Dylan Sorensen
Jonas Oehmichen|Jonas Oehmichen
Abraham Lincoln|अब्राहम लिंकन
Julian Assange|जुलियन असान्ज
Jenna Jameson|जेना जेम्सन
Lionel Messi|लियोनेल मेस्सी
Charlie Chaplin|चार्ली च्याप्लिन
Julius Caesar|जूलियस सिजर
Usain Bolt|युसेन बोल्ट
Vladimir Lenin|लेनिन
Ferdinand Magellan|फर्डिनान्ड म्यागलन
Neil Armstrong|निल आर्मस्ट्रङ
Hugo Lloris|ह्युगो लोरिस
George Orwell|जर्ज अरवेल
Joachim Löw|जोएचिम लो
Corbin Bleu|कोर्बिन ब्लू
Johann Wolfgang von Goethe|योहान वोल्फगान्क भान गोटे
Elizabeth I of England|एलिजाबेथ प्रथम
James Cook|जेम्स कुक
Kublai Khan|कुबलाई खान
Leonhard Euler|लियोनार्ड ओइलर
Nelson Mandela|नेल्सन मन्डेला
Saladin|सलाउद्दीन
Satyajit Ray|सत्यजीत राय
Steven Spielberg|स्टीवन स्पिलबर्ग
Aamir Khan|आमिर खान
Tipu Sultan|टिपु सुल्तान
Nikki Haley|निक्की हेली
Pelé|पेले
Xi Jinping|सि जिनपिङ
Tenzin Gyatso|१४हम दलाई लामा
Al Gore|अल गोर
Lady Gaga|लेडी गागा
Donald Trump|डोनाल्ड ट्रम्प
Hannah Harper|हन्ना हार्पर
Nina Mercedez|निना मर्सिडिज
Ana Ivanovic|एना इभानोभिक
Yash Chopra|यश चोपडा
Scarlett Johansson|स्कार्लेट जोहानसन
Hirohito|हिरोहितो
Alina Plugaru|एलिना प्लुगारु
Avy Scott|एभी स्कट
Annie Cruz|एन्नी क्रुज
Johnny Depp|जोनी डेप
Natalie Portman|नटाली पोर्टम्यान
Herta Müller|हर्टा मुलर
Leonardo DiCaprio|लियोनार्डो डिक्याप्रिओ
Pol Pot|पोल पट
Sandra Bullock|सान्ड्रा बुलक
Jodie Foster|जुडी फोस्टर
Selma Lagerlöf|सेल्मा लागेर्लाफ
Raima Sen|राइमा सेन
Eric Clapton|एरिक क्ल्यप्तोन
Esha Deol|ईशा देओल
Jean Renoir|ज्यां रेनुआ
Nelly Sachs|नेलि साचस
Gottlieb Daimler|गट्लिब डायमलर
Dru Berrymore|ड्रु ब्यारिमोर
Dolly Buster|डली बुस्टर
Charlize Theron|शार्लिज थेरोन
Om Puri|ओम पुरी
J. M. Barrie|जेम्स म्याथ्यु बेरी
Jahangir|जहाँगीर
Robin Li|रोबिन ली
Dakota Fanning|डेकोटा फेनिङ
Taylor Vixen|टेलर भिक्सन
Alicia Keys|एलिसिया किज
Subrahmanyan Chandrasekhar|सुब्रह्मण्यन चन्द्रशेखर
Elinor Ostrom|इलिनर अस्ट्रम
Imran Khan|इमरान खान
Sarvepalli Radhakrishnan|सर्वपल्ली राधाकृष्णन
Mairead Maguire|मैरेड मगुइरे
Betty Williams|बेटि विलियम्स
Bipasha Basu|बिपाशा बसु
Tabu|तबु
Nargis|नरगिस
Mark Wahlberg|मार्क वाह्ल्बर्ग
Premchand|प्रेमचन्द
Alexandra Kollontai|आलेक्सान्द्रा कोलोन्ताइ
Jane Addams|जेन एडम्स
Rani Lakshmibai|रानी लक्ष्मीबाई
Kareena Kapoor|करीना कपूर खान
Manisha Koirala|मनिषा कोइराला
Jennifer Lawrence|जेनिफर लरेन्स
Jim Parsons|जिम पार्सन्स
Aurobindo Ghosh|अरविन्द घोष
Alexis Bledel|एलेक्सिस ब्लेडल
Joshua Reynolds|सर जोशुवा रेनालड्स
Alyson Hannigan|एलीसन हनिंगन
Tigranes the Great|पीएम फाडू
Ali Larter|एली लार्टर
Amanda Crew|अमेन्डा क्र्यू
Sadio Mané|साडियो माने
Thiago Silva|थियागो सिल्भा
Faye Reagan|फाय रेगन
Arundhati Roy|अरुन्धति राय
Jerry Yang|जेरी याङ्ग
Kiran Desai|किरण देसाई
Ai Sugiyama|अई सुगीयामा
Miranda Richardson|मिरेन्डा रिचर्डसन
Lucy Hale|लुसी हेल
Samantha Morton|समान्था मोर्टन
Anna Hazare|अन्ना हजारे
Olave Baden-Powell|ओलेभ वेडेन पावेल
Sasha Alexander|साशा एलेक्जेन्डर
Nicole Anderson|निकोल एण्डरसन
Tory Lane|टोरी लेन
Tarra White|तारा व्हाइट
Nikki Benz|निक्की बेन्ज
Carmella Bing|कार्मेला बिङ्ग
Eva Angelina|इभा एन्जेलिना
Monica Sweetheart|मोनिका स्विटहर्ट
Junko Tabei|जुन्को ताबेई
Teresa Palmer|टेरेसा पाल्मर
Brooke Hogan|ब्रूक होगन
Sheryl Sandberg|सेरिल स्याण्डबर्ग
Lanny Barby|ल्यानी बार्बी
Kate Bosworth|केट बोस्वर्थ
Clara Morgane|क्लारा मोर्गन
Phoenix Marie|फोनिक्स मारिया
Bailee Madison|बेइली म्याडिसन
Brittany Andrews|ब्रिट्यानी एन्ड्र्यू
Ángel Di María|एन्जेल डी मारिया
Sushmita Sen|सुष्मिता सेन
Arvind Swamy|अरविन्द स्वामी
Shakib Al Hasan|शाकिब अल हसन
Joanna Angel|जोआन्ना एन्जल
Alisha Klass|एलिसा क्लास
Céline Bara|सेलिन बारा
Jessie Andrews|जेस्सी एन्ड्रिउज
Katja K|क्याट्जा के
Svetlana Aleksievich|स्वेतलाना अलेकस्विच
Sky Lopez|स्काइ लोपेज
Emile Vandervelde|एमिल भान्डेरभेल्डे
Jesse Capelli|जेस्सी क्यापेली
Alice Walton|एलिस वाल्टन
Dahlia Grey|डालिया ग्रे
Charlie Laine|चार्ली लेन
R. Venkataraman|रामस्वामी वेंकटरमण
Don Bradman|डोनाल्ड ब्रेडम्यान
Dev Anand|देव आनन्द
Madhav Kumar Nepal|माधव कुमार नेपाल
Amrish Puri|अमरीश पुरी
Rahul Bose|राहुल बोस
Ernesto Cesaro|अर्नेस्टो सिसैरा
Minissha Lamba|मिनीषा लाम्बा
Sophie Dee|सोफी डी
Kamal Haasan|कमल हासन
George Monbiot|जोर्ज मोनवोइट
Dynamo|डायनेमो
Koel Mullick|कोएल मल्लिक
Sarat Chandra Chattopadhyay|शरतचन्द्र चट्टोपाध्याय
Akhilesh Yadav|अखिलेश यादव
Pasang Lhamu Sherpa|पासाङ ल्हामु शेर्पा
Roberto Carlos|रोबर्टो कार्लोस
Sinnamon Love|सिनामोन लभ
Chloe Jones|क्लोए जोनस
Marta Abba|मार्ता अब्बा
Roxy Jezel|रक्सी जेजेल
Domonique Simone|डोमोनिक सिमोन
Diego Costa|डियागो कोस्टा
Dana DeArmond|डाना डेअर्मन्ड
Karisma Kapoor|करिश्मा कपूर
Mamata Banerjee|ममता बनर्जी
Anushka Sharma|अनुष्का शर्मा
Cathy Barry|क्याथी ब्यारी
Elise Kellond-Knight|एलिस केलन्ड-नाइट
Monique Covét|मोनिका कोभट
Sarah Gregorius|सराह ग्रेजोरियस
Alicia Rio|एलिसिया रियो
Shweta Tiwari|श्वेता तिवारी
Vyjayanthimala|वेजयन्ती माला
Sher Bahadur Deuba|शेरबहादुर देउबा
Aurangzeb|औरंगजेब
Ananda Krishnan|आनन्द कृष्णन
Himani Rajya Lakshmi Devi|हिमानी शाह
Jenteal|जेन्टिल
Jennifer Rhodes|जेनिफर रोड्स
Abhay Deol|अभय देओल
Shekhar Kapur|शेखर कपूर
Kaká|काका
Bhanu Athaiya|भानु अथैय्या
Sunil Gavaskar|सुनील गावस्कर
Danny Denzongpa|डैनी डेन्जोंगपा
Priyanka Vadra|प्रियंका गांधी
Tanya Tate|तान्या ट्याट
Kunal Kohli|कुणाल कोहली
Bipin Chandra Pal|विपिन चन्द्र पाल
Rahat Fateh Ali Khan|राहत फतेह अली खान
Evgeny Alekseev|एवजेनी अलेकसीव
Valmiki|वाल्मीकि
Demi Delia|डेमी डेलिया
Man Mohan Adhikari|मनमोहन अधिकारी
August Palm|अगस्ट पाल्म
Asami Jō|आसामी जो
Ranveer Singh|रणवीर सिंह
Chris Rogers|क्रिस रोजर्स
Isabel Ice|इजाबेल आइस
Surya Bahadur Thapa|सूर्य बहादुर थापा
Dana Vespoli|डाना वेसपोली
Aishwarya of Nepal|रानी ऐश्वर्य राज्यलक्ष्मी शाह
Jack Ma|ज्याक मा
Sonam Kapoor|सोनम कपूर
Arbaaz Khan|अरबाज खान
Dipika Pallikal|दीपिका पल्लीकल
Adnan Sami|अदनान सामी
Surekha Sikri|सुरेखा सिकरी
Meggan Mallone|मेगान म्यालन
Melissa Ordway|मेलिसा ओर्डवे
William E. Moerner|विलियम मर्नर
Manohar Parrikar|मनोहर पर्रीकर
Matrika Prasad Koirala|मातृकाप्रसाद कोइराला
Ram Raja Prasad Singh|राम राजा प्रसाद सिंह
Amrita Pritam|अमृता प्रीतम
Rohan Marley|रोहन मार्ली
Sanjeev Kumar|संजीव कुमार
Avika Gor|अविका गोर
Akhil Kumar|अखिल कुमार
Mahesh Bhatt|महेश भट्ट
Sister Nivedita|भगिनी निवेदिता
Aftab Shivdasani|आफताब शिवदसानी
Tulsi Giri|तुल्सी गिरी
Kelly Stafford|केली स्टफोर्ड
Seema Biswas|सीमा बिश्वास
Mohinder Amarnath|मोहिन्दर अमरनाथ
Murli Manohar Joshi|मुरली मनोहर जोशी
Georgia|जर्जिया जोन्स
Andie Valentino|एन्डी भेलेन्टिनो
Rana Bahadur Shah|रणबहादुर शाह
Sativa Rose|सतिभा रोज
Amol Palekar|अमोल पालेकर
Alisha Chinai|अलीशा चिनाय
Mayasura|मयासुर
Mahendralal Sarkar|महेन्द्रलाल सरकार
Bhakti Thapa|भक्ति थापा
Govind Ballabh Pant|गोविन्द वल्लभ पन्त
Trisha Krishnan|तृषा
Ami Ayukawa|एमी आयुकावा
Mukul Dev|मुकुल देव
Bishnu Prasad Paudel|बिष्णु प्रसाद पौडेल
Nalini Jaywant|नलिनी जयवन्त
Candy Apples|क्यान्डी एपल्स
Jassie|जेस्सी
Madison Parker|म्याडिसन पार्कर
Rakeysh Omprakash Mehra|राकेश ओमप्रकाश मेहरा
Uma Bharti|उमा भारती
Krishna Poonia|कृष्णा पूनिया
Stuart Broad|स्टुअर्ट ब्रड
Janardhan Sharma|जनार्दन शर्मा
Jessie Volt|जेस्सी भोल्ट
Johnny Walker|जनी वाकर
Keri Windsor|केरी वाइन्डसर
Bhumika Chawla|भूमिका चावला
Akkineni Nagarjuna|अक्किनेनी नागार्जुन
Brendon McCullum|ब्रेन्डन म्याकुलम
Mushfiqur Rahim|मुस्फिकर रहिम
Anup Jalota|अनूप जलोटा
Bhanumathi Ramakrishna|भानुमती
N. T. Rama Rao Jr.|जूनियर एनटिआर
Archita Sahu|अर्चिता साहु
Deeksha Seth|दीक्षा सेठ
Diana Edulji|डायना एडुल्जी
Sunitha Krishnan|सुनिता कृष्णन
Y. S. Jaganmohan Reddy|वाइएस जगनमोहन रेड्डी
Mohammad Hafeez|मोहम्मद हफीज
Pooja Batra|पूजा बतरा
Nafisa Ali|नफीसा अली
Ekta Kapoor|एकता कपूर
Parveen Sultana|परवीन सुल्ताना
Sushma Seth|सुषमा सेठ
Balbhadra Kunwar|बलभद्र कुँवर
Kitu Gidwani|किटू गिडवानी
Brie Bella|ब्रि बेला
Elena Roger|एलेना रोजर
Chintaman Dwarkanath Deshmukh|सिडी देशमुख
Nikki Bella|निक्की बेला
Ayesha Kapur|आयशा कपूर
Abhijeet Sawant|अभिजीत सावंत
Ronit Roy|रोनित रोय
Aamina Sheikh|आमिना शेख
Aamna Sharif|आमना शरीफ
Aaron Finch|एरोन फिन्च
Aashka Goradia|आशका गोरडिया
Abhi Bhattacharya|अभि भट्टाचार्य
Abir Abrar|अबीर अबरार
Alka Lamba|अलका लाम्बा
Anu Aggarwal|अनु अग्रवाल
Archana Gupta|अर्चना गुप्ता
Ash Hollywood|एश हलीवूड
Asha Negi|आशा नेगी
Atul Kulkarni|अतुल कुलकर्णी
B. N. Adarkar|बिएन आदरकार
Baba Faqir Chand|बाबा फकीर चन्द
Ben Stokes|बेन स्टोक्स
Bhikhari Thakur|भिखारी ठाकुर
Bhupi Sherchan|भूपि शेरचन
Grazielle|ग्राजिल्ले
Chitrangada Singh|चित्रांगदा सिंह
Dani Daniels|ड्यानी ड्यानीयल्स
Deep Narayan Singh|दीप नारायण सिंह
Deepti Naval|दीप्ती नवल
Diandra Soares|डायेन्ड्रा सोरेस
Dilip Joshi|दिलीप जोशी
Dinesh Lal Yadav|दिनेश लाल यादव
Ganesh Thapa|गणेश थापा
Guru Prasad Mainali|गुरूप्रसाद मैनाली
Hiten Tejwani|हितेन तेजवानी
Irshad Kamil|इरशाद कामिल
Jaspinder Narula|जसपिन्दर नरूला
Jay Soni|जय सोनी
Kamini Kaushal|कामिनी कौशल
Kane Richardson|केन रिचर्डसन
Karishma Tanna|करिश्मा तन्ना
Homa Sarshar|होमा सर्शार
Khadija Mumtaz|खदीजा मुमताज
Khil Raj Regmi|खिलराज रेग्मी
Nithya Menen|नित्या मेनन
Kul Bahadur Gurung|कुल बहादुर गुरुङ
Kunal Ganjawala|कुणाल गाञ्जावाला
Lavanya Tripathi|लावण्या त्रिपाठी
Lekhnath Paudyal|लेखनाथ पौड्याल
Mahii Vij|माही विज
Maithripala Sirisena|मैत्रीपाला सिरीसेना
Malina Joshi|मलिना जोशी
Meera|मीरा
Minoti Desai|मिनोती देसाई
Mohit Sharma|मोहित शर्मा
Nabin Bhattarai|नविन के भट्टराई
Namrata Shrestha|नम्रता श्रेष्ठ
Nongthombam Biren Singh|एन बीरेन सिंह
Palak Muchhal|पलक मुच्छल
Pankit Thakker|पंकित ठक्कर
Parijat|पारिजात
Pratibha Singh|प्रतिभा सिंह
Sona Mohapatra|सोना मोहपात्रा
Puri Jagannadh|पुरी जगन्नाध
Radhika Pandit|राधिका पण्डित
Raghava Lawrence|राघव लरेन्स
Raj Ballav Koirala|राजबल्लभ कोइराला
Rannvijay Singh|रणविजय सिंह
Rati Pandey|रति पाण्डेय
Regina Cassandra|रेजिना क्यासेन्द्रा
Rhea Chakraborty|रिया चक्रवर्ती
Rita Dey|रीता डे
Ritu Beri|रितु बेरी
Romit Raj|रोमित राज
Kishkindhakanda|किष्किन्धाकाण्ड
Ruby Day|रुबी डे
Sagarika Ghatge|सागरिका घाटगे
Sahana Bajracharya|साहना बज्राचार्य
Sana Amin Sheikh|साना अमीन शेख
Sara Khan|सारा खान
Sargun Mehta|सरगुन मेहता
Sayantani Ghosh|सायंतनी घोष
Shweta Prasad|श्वेता बासु प्रसाद
Smitha Harikrishna|स्मिता हरिकृष्ण
Smriti Irani|स्मृति ईरानी
Sreerupa Bose|श्रीरूपा बोस
Subrata Roy|सुब्रत रॉय
Sujata Sridhar|सुजाता श्रीधर
Sumeet Raghavan|सुमीत राघवन
Sumitra Mahajan|सुमित्रा महाजन
Tanya Abrol|तान्या अब्रोल
Vanessa Axente|भेनेस्सा एक्सेन्ट
Vicki Chase|विक्की चेस
Vijay Sethupathi|विजय सेतुपति
Vijay Rupani|विजय रूपाणी
Wilson Bikram Rai|विल्सन विक्रम राई
Yami Gautam|यामी गौतम
Vishal Dadlani|विशाल दादलानी
Bikesh Kuthu|बिकेश कुथु
Binod Chaudhary|विनोद चौधरी
Adrianna Luna|एड्रिना लुना
|संजय
Kul Shekhar Sharma|कुलशेखर शर्मा
Nilima Jogalekar|नीलिमा जोगलेकर
Lendl Simmons|लेन्डल सिमन्स
Raju Lama|राजु लामा
Bairagi Kainla|वैरागी काइँला
Srikanth Kidambi|श्रीकान्त किदम्बी
Sulajja Firodia Motwani|सुलज्जा फिरोदिया मोटवानी
Tanya Dubash|तान्या दुबाश
Sharmila Biswas|शर्मिला विश्वास
Jitendra Mukhiya|जितेन्द्र मुखिया
Jassie Gill|जस्सी गिल
Jaya Bhattacharya|जया भट्टाचार्य
Payal Ghosh|पायल घोष
Ridhima Ghosh|ऋधिमा घोष
Rani Chatterjee|रानी चटर्जी
Roshni Walia|रोशनी वालिया
Shafaq Naaz|शफक नाज
Sushma Karki|सुष्मा कार्की
Saiyami Kher|सैयामि खेर
Gayathri Iyer|गायत्री अय्यर
Arunima Lamsal|अरुणिमा लम्साल
Kanchan Chandra Bade|कञ्चन चन्द्र बाद
Patralekha Paul|पत्रलेखा पल
Sudhir Chaudhary|सुधीर चौधरी
Keerthy Suresh|कीर्ति सुरेश
Jasleen Royal|जसलीन कौर रोयल
Priyanka Gill|प्रियंका गिल
Sangina Baidya|संगीना वैद्य
Dhirendra Premarshi|धीरेन्द्र प्रेमर्षि
Akash Giri|आकाश गिरी
Varun Tej|वरुण तेज
Raftaar|रफ्तार
Krishna Bhooshan Bal|कृष्णभूषण बल
Chakrapani Chalise|चक्रपाणि चालिसे
Jebika Karki|जेविका कार्की
|पुजा चन्द
|राजेश पायल राई
Samiksha Bhatnagar|समीक्षा भटनागर
|आशीष अनचिन्हार
|गोविन्द पाठक
|चन्द्रशेखर कामति
|प्रीति ठाकुर
|महेन्द्र नारायण राम
|मोहन भारद्वाज
|राजेन्द्र पंडित
Jigyasa Singh|जिज्ञासा सिंह
Karishma Sharma|करिश्मा शर्मा
Vojtech H. Lindtner|Vojtech H. Lindtner
Emilio Insolera|एमिलियो इंसोलरा
Harshvardhan Kapoor|हर्षवर्धन कपूर
Katherine Maher|क्याथरिन माहेर
Zaira Wasim|जायरा वसीम
Philipp Wobeto|Philipp Wobeto
Sushila Karki|सुशीला कार्की
Shirley Setia|शर्ली सेतिया
Baisali Mohanty|बैसाली मोहन्ती
Rahul Yadav|राहुल यादव
Deepika Amin|दीपिका अमिन
Sonia Fisch-Muller|Sonia Fisch-Muller
Hetal Dave|हेतल दवे
Koushani Mukherjee|कौशानी मुखर्जी
Sharmila Malla|शर्मिला मल्ल
Jignesh Mevani|जिग्नेश मेवाणी
Laurent Vallotton|Laurent Vallotton
Mira Seth|मीरा सेठ
Nain Singh Thapa|नैनसिंह थापा
John Hollier|John Hollier
Usha Khadgi|उषा खड्गी
Mohna Ansari|मोहना अन्सारी
Dionisio García Cortázar|Dionisio García Cortázar
Máximo Cánovas del Castillo|Máximo Cánovas del Castillo
Sahara Basnet|सहारा बस्नेत
Dilli Jung Thapa|डिल्लीजङ्ग थापा
Aruna Shahi|अरूणा शाही
|मञ्जरी फडनिस
Seema Tomar|सीमा तोमर
Sarada Paudel|शारदा पौडेल
Chham Bahadur Gurung|छम बहादुर गुरुङ
Janak Bahadur Buda|जनक बहादुर बुढा
Bhakta Bahadur Bishwakarma Khapangi|भक्तबहादुर विश्वकर्मा खपाङ्गी
Anajana Chaudhary|अन्जना चौधरी
Janak Raj Chaudhary|जनक राज चौधर
Nirjala Raut|निर्जला राउत
Aangtawa Sherpa|अन्गतावा शेर्पा
Tulasa Rana|तुलसा राना
Bhism Nath Adhikari|भीष्म नाथ अधिकारी
Pradeep Giri|प्रदिप गिरी
Narbhan Kami|नरभान कामी
Ram Dulari Chaudhary|राम दुलारी चौधरी
Dinesh Prasad Prasaila Yadav|दिनेश प्रसाद प्रसैला यादव
Ram Hari Subedi|राम हरि सुवेदी
Indra Bahadur Baniya|इन्द्र बहादुर बानिया
Punaram Thapa|पुनाराम थापा
Rukmini Chaudhary|रुकमिणी चौधरी
Nirmal Prakash Subedi|निर्मल प्रकाश सुवेदी
Wongdi Sherpa|ओङदी शेर्पा
Kamala Devi Mahata|कमला देवी महता
Shiva Kumar Mandal Kebat|शिव कुमार मण्डल केवट
Bikash Lamsal|विकाश लम्साल
Bikram Khanal|विक्रम खनाल
Kabita Kumari Sardar|कविता कुमारी सरदार
Sherdhan Rai|शेरधन राई
Sitaram Mahato|सीताराम महतो
Shakti Bahadur Basnet|शक्ति बहादुर वस्नेत
Shayendra Bantawa|शयन्द्र बान्तवा
Krishna Prasad Poudel|कृष्ण प्रसाद पौडेल
Ganesh Singh Thagunna|गणेश सिंह ठगुन्ना
Purna Badhur Khadka|पूर्ण बहादुर खड्का
Gauri Shankar Chaudhary|गौरी शंकर चौधरी
Ganga Chaudhary|गंगा चौधरी (सत्गौवा)
Sher Bahadur Tamang|शेर बहादुर तामाङ्ग
Chandi Prasad Rai|चण्डि प्रसाद राई
Sabiya Prabin|सबिया प्रवीन
Sarbendra Nath Sukla|सर्वेन्द्र नाथ शुक्ल
Balaram Adhikari|बलराम अधिकारी
Shurya prakash Wala Rai|सूर्य प्रकाश वाला राई
Suryaman Gurung|सूर्यमान गुरुङ्ग
Sushhil Kumar Shrestha|सुशील कुमार श्रेष्ठ
Shahab Alam|साहाब आलम
Farveez Maharoof|फर्वीज महरूफ
Sunam Gautam|सुनम गौतम
Parmesh Kumar|प्रमेस कुमार
Rajbir Singh|रजविर सिंङ
Dipesh Kandel|दिपेश कंडेल
Pranit Thapa Magar|प्रनित थापा मगर
Nurdhoj Sen|नुर्धोज सेन
Anil Sah|अनिल शाह
Rekha Rawal|रेखा रावल
Roshni Sahota|रोशनी सहोटा
Khadga Shamsher Jang Bahadur Rana|खड्ग शमशेर जङ्गबहादुर राणा
Purna Nepali|पूर्ण नेपाली
Deepa Rai|दीपा राई
luniva singh|लुनिभा सिंह
Anjali Waiba|अञ्जली वाइबा
kamala pun|कमला पुन
Bishal Shrestha|विशाल श्रेष्ठ
Suman Kumar Mallick|सुमन कुमार मल्लिक
Bimlesh Adhikari|बिमलेश अधिकारी
Greta Thunberg|ग्रेटा थनबर्ग
Bhim bhadur Rawal|भीम बहादुर रावल
|आफताब शिवदसानी
|प्रकास राज
Alexandria Villaseñor|अलेक्जान्ड्रिया भिलासेनोर
Manish Kumar Suman|मनिष कुमार सुमन
Anushka Shrestha|अनुष्का श्रेष्ठ
Ashok Kumar Yadav|अशोक कुमार यादव
Asim Azhar|असीम अजहर
Bachha Raut Ahir|बच्चा राउत अहिर
Jagat Prasad Yadav|जगत प्रसाद यादव
Manju Kumari Yadav|मन्जु कुमारी यादव
Mohammad Samir|मोहम्मद समीर
Nagendra Rae Yadav|नगेन्द्र राई यादव
Phil Kingston|फिल किंगस्टन
Vanessa Mark|Vanessa Mark
Alexander Bernardi|Alexander Bernardi
Pradeep Nepal|प्रदीप नेपाल
Olivia Araujo|Olivia Araujo
Victor Povzner|Victor Povzner
Mantas Januskevicius|Mantas Januskevicius
Bolivar Espinosa|Bolivar Espinosa
Mattija Lojen|Mattija Lojen
Joanne Cavill|Joanne Cavill
Beata Jasińska|Beata Jasińska
Olga Mikhailoyskaia|Olga Mikhailoyskaia
Els Bauden|Els Bauden
Sabrina Arhab|Sabrina Arhab
Cecilia Bäckstedt|Cecilia Bäckstedt
Iulian Oprea|Iulian Oprea
Leon Felderer|Leon Felderer
Cezara Curmei|Cezara Curmei
Roberts Plūme|Roberts Plūme
Erica Voss|Erica Voss
Julia Słupecka|Julia Słupecka
Eric Fantazzini|Eric Fantazzini
Arnis Bebrišs|Arnis Bebrišs
Taylor Lawrence|Taylor Lawrence
Cédric Follador|Cédric Follador
Erik Schmidt|Erik Schmidt
David Cameron|डेविड क्यामरुन
Angela Merkel|एन्जेला मर्केल
William Shakespeare|विलियम शेक्सपियर
Aristotle|अरस्तू
J. R. R. Tolkien|जे. आर. आर. टोल्कियन
Trygve Lie|ट्रेग्भी लाई
Saddam Hussein|सद्दाम हुसेन
Bruno Mars|ब्रुनो मार्स
Sasha Grey|साशा ग्रे
Marilyn Monroe|मर्लिन मुनरो
Marco Polo|मार्को पोलो
Rabindranath Tagore|रबीन्द्रनाथ टेगोर
Margaret Thatcher|मार्गरेट थ्याचर
Ashoka|सम्राट अशोक
Chanakya|चाणक्य
Karl Marx|कार्ल मार्क्स
Queen Victoria|महारानी भिक्टोरिया
Aryabhata|आर्यभट्ट
Robert Baden-Powell, 1st Baron Baden-Powell|बेडेन पावेल
Vinoba Bhave|विनोबा भावे
Michelle Obama|मिशेल ओबामा
Kaley Cuoco|केली क्वोकोह
Bertha von Suttner|बेर्था भन सटनर
Arthur Fadden|अर्थर फेडेन
Bryan Cranston|ब्रायन क्रान्सटन
Rowan Atkinson|रोवान एटकिनसन
Alfred Nobel|अल्फ्रेड नोबेल
Jessica Jaymes|जेस्सिका जेमेस
Judi Dench|जुडी डेन्च
Brie Larson|ब्री लार्सन
Mother Teresa|मदर टेरेसा
K. Chandrashekar Rao|के चन्द्रशेखर राव
Pablo Neruda|पाब्लो नेरुदा
Brad Pitt|ब्राड पिट
Alicia Rhodes|एलिसिया रोडेस
Aletta Ocean|एलेट्टा ओसन
Francis Drake|फ्रान्सिस ड्रेक
Tom Cruise|टम क्रुज
Mariah Carey|मारिया केरी
Kim Il-sung|किम इल-सुंग
Manmohan Singh|मनमोहन सिंह
Archduke Franz Ferdinand|फ्रान्ज फर्डिनान्ड
Philipp Lahm|फिलिप लाम
The Great Khali|द ग्रेट खली
Lindsay Lohan|लिन्ड्से लोहन
Christian Bale|क्रिस्टियन बेल
Ginni Rometty|गिनी रोमेटी
Raj Kapoor|राज कपूर
Juan Manuel Santos|हुआन मानुअल सान्टोस
Ram Baran Yadav|रामवरण यादव
Gabriela Mistral|ग्याब्रिएला मिस्ट्रल
Sigrid Undset|सिग्रिड उन्डसेट
Steven Seagal|स्टिभन सिगल
Sergey Brin|सर्गी ब्रिन
Gabriela Sabatini|ग्याब्रिएला सबातिनी
Isabelle Adjani|इसाबेल अदजानी
Hilary Duff|हिलारी डफ
Thomas Paine|थोमस पेन
Anna Kournikova|एना कोर्निकोवा
Amanda Peet|अमान्डा पिट
Cheteshwar Pujara|चेतेश्वर पुजारा
Ajay Devgn|अजय देवगन
Kajol|काजोल देवगन
Tamannaah|तमन्ना भाटिया
Chris Brown|कृस ब्राउन
Mohammed Rafi|मोहम्मद रफी
Pink|पिङ्क
Stephenie Meyer|स्टैफिनी मेईर
Jennifer Garner|जेनिफर गार्नर
Vijay Mallya|विजय माल्या
Kate Beckinsale|केट बेकिंस्ले
Steve Ballmer|स्टिभ बाल्मर
Gareth Bale|ग्यारेथ बेल
Khaled Hosseini|खालिद हुसेनी
Guti|गुटी
Nick Jonas|निक जोनस
Maggie Gyllenhaal|म्याग्गी जिलेनहाल
Kate Winslet|केट विन्स्लेट
Virat Kohli|विराट कोहली
DMX|डि एम यक्
Kajal Aggarwal|काजल अग्रवाल
Dana Delany|डेना डिलेनी
Jennifer Stone|जेनिफर स्टोन
Kate Upton|केट अप्टन
Nora Zehetner|नोरा जेहेट्नर
Jana Cova|जाना कोभा
Paula Patton|पौला पेटन
Ginger Lynn|जिंजर लिन
Tsai Ing-wen|साइ इङ वेन
Sandra Romain|सान्ड्रा रोमेन
Francesca Le|फ्रान्सिस्का ली
Jane Darling|जेन डार्लिङ्ग
Moana Pozzi|मोना पोज्जी
Melissa Lauren|मेलिस्सा लरेन
Dora Venter|डोरा भेन्टर
Shay Jordan|शे जोर्डन
Brea Bennett|ब्रिया बेन्नेट
Sunny Leone|सन्नी लियोन
Diego Forlán|डिएगो फोर्लान
Meera Syal|मीरा सान्याल
Mayawati|मायावती
Indra Nooyi|इंदिरा नुई
Tim Cook|टिम कुक
Navjot Singh Sidhu|नवजोत सिंह सिद्धू
Alexa Rae|एलेक्सा रे
Yaragudipati Venkata Mahalakshmi|लक्ष्मी
Revathi|रेवती
Sanjay Dutt|सञ्जय दत्त
Sammo Hung|स्यामो हुङ
António Guterres|एन्टोनियो गुटेर्रेस
Shakti Kapoor|शक्ति कपूर
Saad Zaghloul|साद जगलुल
Dhanush|धनुष
Ratan Tata|रतन टाटा
Sadiq Khan|सादिक खान
Sooraj R. Barjatya|सूरज बडजात्या
Mehmood Ali|महमूद
James Rodríguez|जेम्स रोडरिगेज
Dino Morea|डीनो मोरिया
Gabriella Wilde|ग्याब्रिएला वाइल्ड
Adriana Sage|एड्रिना सेज
P. Chidambaram|पी.चिदम्बरम
Dilip Kumar|दिलीप कुमार
Dhyan Chand|ध्यानचन्द सिंह
Anil Ambani|अनिल अम्बानी
Sofia Jakobsson|सोफिया ज्याकब्सन
Alexandra Popp|एलेक्जेन्ड्रा पप
Mya Diamond|म्या डायमण्ड
Justine Joli|जस्टिन जोली
Brigitta Bulgari|ब्रिगिटा बुल्गरी
Ashlyn Gere|एस्लिन गेरे
Deidre Holland|डेइड्रे हल्याण्ड
Jwala Gutta|ज्वाला गुट्टा
Bionca|बायोन्का
Jayalalitha Jayaram|जयललिता
Aparna Popat|अपर्णा पोपट
Roberto Carlos|रोबर्टो कार्लोस
Rekha|रेखा
Waheeda Rehman|वहीदा रहमान
Ali Krieger|एली क्रिजर
Nikki Nova|निक्की नोभा
Lal Krishna Advani|लालकृष्ण आडवाणी
Barbara Dare|बार्बरा डेर
Jayam Ravi|जयम रवि
Vijender Singh|विजेन्द्र सिंह
Amy Adams|एमी एडम्स
Nani|नानी
Paras Shah|पारस शाह
Jennifer Stewart|जेनिफर स्टेवार्ट
Chelsea Blue|चेल्सी ब्लू
Breanne Benson|ब्रिएन्ने बेनसन
Basappa Danappa Jatti|बासप्पा दनप्पा जत्ती
Mohammad Hidayatullah|मुहम्मद हिदायतुल्लाह
Sahana Pradhan|सहाना प्रधान
Namrata Shirodkar|नम्रता शिरोडकर
Ashley Fires|एस्ली फाइर्स
Crystal Knight|क्रिष्टल नाइट
Steve Waugh|स्टिभ वा
Neha Sharma|नेहा शर्मा
Hitomi Kobayashi|हितोमी कोबायासी
Sunny Deol|सनी देओल
Raghuram Rajan|रघुराम राजन
Chandra Shamsher Jang Bahadur Rana|चन्द्र शमशेर जङ्गबहादुर राणा
Queen Komal of Nepal|रानी कोमल
Chittadhar Hridaya|चित्तधर हृदय
Maimi Yajima|मइमी यजिमा
Kamal Nath|कमल नाथ
Pu Zoramthanga|जोरामथङ्गा
Michael Clarke|माइकल क्लार्क
Parkash Singh Badal|प्रकाश सिंह बादल
Anirban Lahiri|अनिर्बन लहिरी
Pratyusha Banerjee|प्रत्युषा बनर्जी
Urmila Matondkar|उर्मिला मातोंडकर
Colleen Brennan|कोलिन ब्रेनान
Vinod Khanna|विनोद खन्ना
Vani Jairam|वाणी जयराम
Mahesh Babu|महेश बाबु
Wang Jianlin|वाङ जियानलिन
Padma Shamsher Jang Bahadur Rana|पद्म शमशेर जङ्गबहादुर राणा
Reita Faria|रीता फारिया
Prateik Babbar|प्रतीक बब्बर
Arjun Kapoor|अर्जुन कपूर
Nana Patekar|नाना पाटेकर
Bhanubhakta Acharya|भानुभक्त आचार्य
Rati Agnihotri|रति अग्निहोत्री
Shri Guru Ravidass|संत रविदास
Parashara|पराशर ऋषि
Birbal Sahni|प्रो. बीरबल साहनी
Gautam Gambhir|गौतम गम्भीर
Mimi Miyagi|मिमी मियागी
Chris Gayle|क्रिस गेल
Kunal Kapoor|कुणाल कपूर
Mahela Jayawardene|माहेला जयवर्दने
Aarya Babbar|आर्य बब्बर
Nirupa Roy|निरूपा रोय
Ariana|एरिना
Bijaya Kumar Gachchhadar|बिजयकुमार गच्छदार
Fujiko Kano|फुजिको कानो
Leyla Milani|लेला मिलानी
Jessie St. James|जेसी सेन्ट जेम्स
José Luis Álvarez Álvarez|José Luis Álvarez
Kalki Koechlin|कल्की केकला
Nazia Hassan|नाजिया हसन
Damodar Pande|दामोदर पाण्डे
Michelle Keegan|मिचेल किगन
Mohammad Azharuddin|मोहम्मद अजहरुद्दीन
Virender Sehwag|वीरेन्द्र सहवाग
Shaan|शान
Ganesh Man Singh|गणेशमान सिंह
Nara Chandrababu Naidu|चन्द्रबाबू नायडू
Karan Singh Grover|करन सिंह ग्रोवर
Tim Southee|टिम साउथी
Ram Jethmalani|राम जेठमलानी
Aditi Gowitrikar|अदिति गोवित्रिकर
Tamaki Katori|तामाकी काटोरी
Vidyut Jamwal|विद्युत जमवाल
Ashutosh Rana|आशुतोष राणा
Ghulam Nabi Azad|गुलाम नबी आजाद
Pinarayi Vijayan|पिनाराई विजयन
Raj Babbar|राज बब्बर
Shanti Swaroop Bhatnagar|शान्ति स्वरूप भटनागर
Zubeen Garg|जुबिन गर्ग
Poonam Dhillon|पूनम ढिल्लोन
Angel Kelly|एन्जल केली
Jayme Langford|जेमी ल्याङ्गफोर्ड
Ileana D'Cruz|इलियाना डीक्रूज
Bhoja|भोज
Man Singh I|राजा मान सिंह
Rani Padmini|रानी पद्मिनी
Amar Singh Thapa|अमरसिंह थापा
KK|केके
Uddhav Thackeray|उद्धव ठाकरे
Chunky Pandey|चंकी पाण्डे
Lakshmi Kant Jha|एलके झा
Ashok Kumar|अशोक कुमार
Pooja Chopra|पूजा चोपडा
Rohit Chand|रोहित चन्द
Holly Michaels|होली मिचेल्स
Randeep Hooda|रणदीप हुड्डा
Sirarpie Der Nersessian|सिरार्पी देर नेर्सेसियन
Arati Mukhopadhyay|आरती मुखर्जी
Aaryan Sigdel|आर्यन सिग्देल
Achint Kaur|अचिन्त कौर
Ali|अली
Amar Upadhyay|अमर उपाध्याय
Mamta Sharma|ममता शर्मा
Amina J. Mohammed|अमिना जे मोहम्मद
Amit Shah|अमित शाह
Annu Kapoor|अन्नू कपूर
Anuja Chauhan|अनुजा चौहान
Apara Mehta|अपरा मेहता
Arnab Ranjan Goswami|अर्णव गोस्वामी
Arundhati Ghose|अरुन्धति घोष
Arzu Rana Deuba|आरजु राणा देउवा
Reina Leone|रिना लियोनी
Bhagat Singh Koshiyari|भगत सिंह कोश्यारी
Bhusan Dahal|भूषण दाहाल
Bipana Thapa|बिपना थापा
Bismah Maroof|बिस्माह मारूफ
Catherine Tresa|क्याथरीन टेरेसा
Chahatt Khanna|चाहत खन्ना
Chhavi Rajawat|छवि राजावत
Debina Bonnerjee|देबिना बनर्जी
Bayley|बेइली (कुस्ती खेलाडी)
Faisal Khan|फैजल खान
Fathima Beevi|फातिमा बीबी
Fawad Afzal Khan|फवाद खान
Gajendra Narayan Singh|गजेन्द्र नारायण सिंह
Gargi Banerji|गार्गी बेनर्जी
Gauri Shinde|गौरी शिन्दे
Gema Simon|जेमा सिमोन
Hari Bansha Acharya|हरिवंश आचार्य
Hemlata|हेमलता
Hussain Kuwajerwala|हुसैन कुवाजेर्वाला
Ishaan Khatter|इशान खट्टर
Jai Ram Thakur|जयराम ठाकुर
Jal Shah|जल शाह
Jamie Summers|ज्यामी समर्स
Jayanti Patnaik|जयन्ति पटनायक
Jesse Randhawa|जेसी रन्धावा
Joanna Jet|जोअन्ना जेट
Rakel Liekki|राकेल लिक्की
Karan Kundra|करन कुन्दरा
Kavita Kaushik|कविता कौशिक
Kim Carroll|किम क्यारोल
Kriti Kharbanda|कृति खरबन्दा
Leena Yadav|लीना यादव
Lynn McDonald|लिन म्याकडोनाल्ड
Madhura Naik|मधुरा नायक
Mahesh Thakur|महेश ठाकुर
Mayanti Langer|मयन्ती ल्याङ्गर
Meg Lanning|मेग लानिङ
Mini Mathur|मिनी माथुर
Neeti Mohan|नीति मोहन
Nita Ambani|नीता अम्बानी
Nushrat Bharucha|नुसरत भरुचा
Padmini Rout|पद्मिनी राउट
Pankaj Dheer|पंकज धीर
Parul Chauhan|पारूल चौहान
Pema Khandu|पेमा खान्डू
Prachee Shah Pandya|प्राची शाह
Pradeep Kumar Gyawali|प्रदिप कुमार ज्ञवाली
Prakash Chandra Lohani|प्रकाशचन्द्र लोहनी
Raghubar Das|रघुवर दास
Rajendra Rawal|राजेन्द्र रावल
Rajshree Thakur|राजश्री ठाकुर
Reecha Sharma|ऋचा शर्मा
Rekha Punekar|रेखा पुणेकर
Riddhi Dogra|रिद्धि डोगरा
Ritu Kumar|रितु कुमार
Rochelle Maria Rao|रोशेल राव
Roshni Chopra|रोशनी चोपडा
Ruby Rana|रुबी राणा
Samapika Debnath|समापिका देबनाथ
Sambhavana Sheth|सम्भावना सेठ
Sanjeeda Sheikh|संजीदा शेख
Sapna Mukherjee|सपना मुखर्जी
Shahid Anwar|सहिद अनवर
Shekhar Suman|शेखर सुमन
Shukraraj Shastri|शुक्रराज शास्त्री
Shweta Gulati|श्वेता गुलाटी
Soni Razdan|सोनी रज्दान
Suman Ranganathan|सुमन रङ्गनाथन
Sunita Dulal|सुनिता दुलाल
Supriya Pilgaonkar|सुप्रिया पिलगांवकर
Swara Bhaskar|स्वरा भास्कर
Taapsee Pannu|तापसी पन्नू
Tameka Yallop|टमेका बट
Tamsin Omond|तामसिक ओमोन्ड
Tia Bajpai|टिया बाजपेई
Tinnu Anand|टीनू आनन्द
Tripti Nadakar|तृप्ती नदाकर
Yogmaya Neupane|योगमाया न्यौपाने
Shristi Shrestha|सृष्टी श्रेष्ठ
Indra Bahadur Rai|इन्द्रबहादुर राई
Shahana Goswami|शहाना गोस्वामी
Karamchand Uttamchand Gandhi|करमचन्द गान्धी
Kritika Kamra|कृतिका कामरा
Meena Parande|मीना परान्डे
Kamalendumati Shah|कमलेंदुमति शाह
Sai Paranjpye|सई परांजपे
Kalyana Bikram Adhikary|कल्याण विक्रम अधिकारी
Aangdawa Sherpa|आङ दावा शेर्पा
|कृष्टी मैनाली
Kshetra Pratap Adhikari|क्षेत्रप्रताप अधिकारी
Gaman Gurung|गमन गुरुङ
Jagadish Ghimire|जगदीश घिमिरे
Dinesh Adhikari|दिनेश अधिकारी
Bhim Bahadur Rawal|भीम बहादुर रावल
|रञ्जना शर्मा
Saraswati Chaudhary|सरस्वती चौधरी
|सुमिना श्रेष्ठ
Mitchell Marsh|मिचेल मार्श
Mohammed Iqbal Khan|इकबाल खान
Sri Divya|श्री दिव्या
Sarla Thakral|सरला ठकराल
Elli Avram|एली एवराम
Keisha Kane|केशा केन
Archana Bhargava|अर्चना भार्गव
Zoya Afroz|जोया अफ्रोज
Avantibai|अवन्तीबाई
Shakti Anand|शक्ति आनन्द
Amyra Dastur|अमायरा दस्तूर
Nikita Anand|निकिता आनन्द
Subrahmanyam Jaishankar|सुब्रह्मण्यम जयशङ्कर
Jagat Prakash Nadda|जगत प्रकाश नड्डा
Sheeba Chaddha|शीबा चड्ढा
Gurleen Chopra|गुरलिन चोपडा
Ihana Dhillon|इहाना ढिल्लोन
Tiger Shroff|टाइगर श्राफ
Swati Verma|स्वाती वर्मा
Avinash Karn|अविनाश कर्ण
Naresh Budayair|नरेश बुढाएैर
Amar Neupane|अमर न्यौपाने
Jonita Gandhi|जोनिता गान्धी
Adrian Pradhan|एड्रियन प्रधान
Preeti Singh|प्रीति सिंह
Luv Ranjan|लव रञ्जन
Srishty Rode|सृष्टि रोडे
Subin Limbu|सुविन लिम्बू
Pragya Yadav|प्रज्ञा यादव
Teriya Magar|तेरिया मगर
Suman Pokhrel|सुमन पोखरेल
Jasveer Kaur|जसवीर कौर
Deepa Malik|दीपा मलिक
Aarif Sheikh|आरिफ शेख
Tahir Bhasin|ताहिर राज भसीन
Shilpi Sharma|शिल्पी शर्मा
Veena Sahajwalla|विणा सहजवाला
Sanam Puri|सनम पुरी
Anil Chandra Thakur|अनिलचन्द्र ठाकुर
Aadya Bedi|आध्या बेदी
Chandra Devi Dahal|चन्द्रा देवी दाहाल
Ritu Varma|ऋतु वर्मा
|जगदीश शमशेर राणा
Deepak Raj Giri|दीपक राज गिरी
Nabindra Raj Joshi|नविन्द्र राज जोशी
Rohan Dhakal|रोहन ढकाल
Chandra Ghimire|चन्द्र घिमिरे
Evana Manandhar|इभाना मानन्धर
Ruhanika Dhawan|रूहानिका धवन
|अशोक कुमार ठाकुर
|कुमार मनोज कश्यप
|कृष्ण कुमार कश्यप
|गिरिवरधारी चौधरी
|गोविन्द झा
|चन्द्र भानु सिंह
|ज्योति सुनीत चौधरी
|राजीव कुमार वर्मा
|विनोद बिहारी लाल
|शशिधर कुमर "विदेह"
|शिव सिंह
|श्याम दरिहरे
|श्याम सुन्दर शशि
|सुनील कुमार मल्लिक
Chiranjibi Nepal|चिरञ्जीवी नेपाल
Vicky Kaushal|विक्की कौशल
Rajendra Rajya Lakshmi Devi|रानी राजेन्द्र लक्ष्मी
Onsari Gharti Magar|ओनसरी घर्तिमगर
Mireia Lalaguna Royo|मिरेया लालागुना
Vindhya Tiwari|विन्ध्या तिवारी
Friederike Spitzenberger|Friederike Spitzenberger
Sakshi Agarwal|साक्षी अग्रवाल
Tridha Choudhury|ट्रिधा चौधरी
Kanhaiya Kumar|कन्हैया कुमार
Angur Baba Joshi|अङ्गुरबाबा जोशी
Ishita Raj Sharma|इशिता राज शर्मा
Mahavir Singh Phogat|महावीर सिंह फोगाट
Devika Vaidya|देविका वैद्य
Prem Singh Tamang|प्रेम सिंह तामाङ्ग
Mithila Sharma|मिथिला शर्मा
Neeraj Chopra|नीरज चोपडा
|सन्दिप क्षेत्री
Aditi Ashok|अदिति अशोक
Namita Toppo|नमिता टोप्पो
Claude Vaucher|Claude Vaucher
Biraj Thapa Magar|विराज थापा मगर
Pyar Jung Thapa|प्यारजङ्ग थापा
Samita Bajracharya|समिता बज्राचार्य
Shahil Khan|शाहील खान
Prakashi Tomar|प्रकाशी तोमर
Rojina Shrestha|रोजिना श्रेष्ठ
Amruta Patil|अमृता पाटिल
Ramchandra Yadav|रामचन्द्र यादव
|सिरिन इबाडी
Trishna Singh|तृष्णा सिँह
Shalini Pandey|शालिनी पाण्डे
Gauri Lankesh|गौरी लङ्केश
Ranju Kumari Jha|रंजु कुमारी झा
Sakal Dev Sutihar|सकल देव सुतिहार
Ashok Kumar Mandal|अशोक कुमार मण्डल
Mohamaad Jakir Husaian|मोहम्मद जाकिर हुसैन
Lalit Bhandari|ललित भण्डारी
Ramkrishna Yadav|रामकृष्ण यादव
Ramchandra Sah Teli|रामचन्द्र साह तेली
Lal Babu Raut|लाल वावु राउत
Indraa Jha|इन्द्रा झा
Istiyak Ahmad Khan|इस्तियाक अहमद खान
Narendra Vikram Nemang|नरेन्द्र विक्रम नेम्वाङ्ग
Romi Gauchan Thakali|रोमी गौचन थकाली
Dr. Usha Kiran Ansari|डा. उषा किरण अन्सारी
Prushotam Paudel|पुरुषोत्तम पौडेल
Kamala Devi Sharma|कमला देवी शर्मा
Lila Magar|लीला मगर
Kamala Dong|कमला दोङ
Kalpana Chaudhary|कल्पना चौधरी
Kalpana Sharma Joshi|कल्पना शर्मा जोशी
Binda Devi Ale|विन्दा देवी आले (राना)
Bishal Bhattarai|विशाल भट्टराई
Kumari Laxmi Rai|कुमारी लक्ष्मी राइ
Kaushar Saha|कौशर शाह
Krishna Kumar Rai|कृष्ण कुमार राइ
Gokarna Raj Bista|गोकर्ण राज विष्ट
Krishna Bahadur Mahara|कृष्ण बहादुर महरा
Shyam Sundar Tiwadewal|श्याम सुन्दर टिवडेवाल
Guru Prasad Burlakoti|गुरुप्रसाद बुर्लाकोटी
Chandradevi Joshi|चन्द्रादेवी जोशी
Srijana Taramu Khatri|सिर्जना तरामु खत्री
Chinkaji  Shrestha|चिनकाजी श्रेष्ठ
Farmullha Mansur|फरमुल्लाह मंसुर
Bal Bahadur K.C|बल बहादुर के.सी.
Sindu Jalesa Budhathoki|सिन्धु जलेसा बुढाथोकी
Badhur Singh Lama|बहादुर सिंह लामा  ( तामाङ)
Sudhir Kumar Siwakoti|सुधिर कुमार सिवाकोटी
Sunil Badhur Thapa|सुनिल बहादुर थापा
Subash Chandra Shah Thakuri|सुभास चन्द्र शाह ठकुरी
Surendra Prasad Pandey|सुरेन्द्र प्रसाद पाण्डे
Surendra Prasad Yadav|सुरेन्द्र प्रसाद यादव
Ramnaresh Giri|रामनरेश गिरी
Santosh Bhatta|सन्तोष भट्ट
Puran Vishwakarma|पुरन विश्वकर्मा
Harisankar Shah|हरिसंकर शाह
Bhupendra Thapa|भुपेन्द्र थापा
Bipin Khatri|बिपिन खत्री
Anjali Chand|अञ्जली चन्द
Karuna Bhandari|करुणा भण्डारी
|बसन्ती गुरुङ
Mohammad Lalbabu Raut|मोहम्मद लालबाबु राउत
Sunanda Sharma|सुनन्दा शर्मा
Dipendra Jha|दिपेन्द्र झा
Amrit dungana|अमृत ढुंगाना
Pratibha Mali|प्रतिभा माली
Sonu khadka|सोनु खड्का
Kopila Upreti|कोपिला उप्रेती
Daroji Eramma|दारोजि एराम्मा
Sarbendra Khanal|सर्वेन्द्र खनाल
Deborah Parker|डेवोराह पार्कर
Tony Kakkar|टोनी कक्कड़
Bertrand Devouard|Bertrand Devouard
Uma Devi Badi|उमा देवी बाडी
Cheam Badhaur Gurung|छम बहादुर गुरुङ
Dilman Pakhrin|दिलमान पाख्रिन
|परिधि शर्मा
Sundeep Jora|सन्दीप जोरा
Bhima Yadav|भीमा यादव
|जय भानुशली
Upendra Prasad Kushwaha|उपेन्द्र प्रसाद कुशवाहा
Lagan Lal Chaudhary|लगन लाल चौधरी
Naresh Kumar Yadav|नरेश कुमार यादव
Nira Kumari Sah|निरा कुमारी शाह
Om Prakash Sharma|ओम प्रकाश शर्मा
Pramila Kumari Yadav|प्रमिला कुमारी यादव
Catarina Lorenzo|क्याटरिना लोरेन्जो
Ayakha Melithafa|अयाखा मेलिथाफा
Christian Hammers|Christian Hammers
Yanting Ma|यान्तिंग मा
Sapana Roka Magar|सपना रोका मगर
Gert Kivistik|Gert Kivistik
Ilia Cota|Ilia Cota
Carlo Jurisevic|Carlo Jurisevic
Birkir Snaer Ingvason|Birkir Snaer Ingvason
Barbora Svrckova|Barbora Svrckova
Wendy Ducruex|Wendy Ducruex
Tatiana Droujinina|Tatiana Droujinina
Tatiana Bossak|Tatiana Bossak
Chantalle Gehrig|Chantalle Gehrig
Séverine Villance|Séverine Villance
Lada Koslikova|Lada Koslikova
Samanta Loschi|Samanta Loschi
Darnelle Moore|Darnelle Moore
Rachel Leroux|Rachel Leroux
Šárka Chmurová|Šárka Chmurová
Sarah Wimmer|Sarah Wimmer
Riccardo Schöpf|Riccardo Schöpf
Eduard Crăciun|Eduard Crăciun
Irina Strebel|Irina Strebel
Sara Villani|Sara Villani
Andreas Haas|Andreas Haas
Joseph Williamson|Joseph Williamson
Mika Schneider|Mika Schneider
Deepak Pun Magar|दीपक पुन मगर
Daniel Berlinski|Daniel Berlinski
Roald Amundsen|रोआल्ड एमन्डसन
Albert Einstein|अल्बर्ट आइनस्टाइन
Bill Clinton|बिल क्लिन्टन
Boutros Boutros-Ghali|बौत्रोस बौत्रोस-घाली
Dag Hammarskjöld|डग हम्मरस्क्जोल्ड
Johann Sebastian Bach|योहान सेबास्तियन बाख
Virgil|वर्जिल
Augustus|सिजर अगस्टस
Zinedine Zidane|जिनेदिन जिदाने
Subhas Chandra Bose|सुभाषचन्द्र बोस
Jacques Cartier|ज्याक कार्टिअर
Asima Chatterjee|असिमा चटर्जी
Winston Churchill|विन्स्टन चर्चिल
Marion Cotillard|मेरियन कोटिल्लर्ड
Laozi|लाओ जू
Shah Rukh Khan|शाहरूख खान
Katrina Kaif|क्याटरिना कैफ
Elizabeth II|एलिजाबेथ द्वितीय
Catherine, Duchess of Cambridge|क्याथरिन, क्याम्ब्रिजक डचेस
James Monroe|जेम्स मुनरो
Dave Grohl|डेभ ग्रोहल
Maya Angelou|माया एन्जोलो
Jean Shrimpton|जीन श्रीम्प्टन
Rosanna Davison|रोसाना डेभिसन
Ellie Goulding|एली गोल्डिङ
Danni Ashe|ड्यानी एशी
Jennifer Aniston|जेनिफर एनिस्टन
Akon|एकन
Leon Trotsky|त्रोत्स्की
Elizabeth Taylor|एलिजाबेथ टेलर
Angelina Valentine|एन्जेलिना भ्यालेन्टाइन
Annette Schwarz|एन्नेट्टे स्क्वार्ज
Muhammad Ali|मोहम्मद अली
Mark Zuckerberg|मार्क जुकरबर्ग
Jackie Chan|ज्याकी च्यान
Florence Nightingale|फ्लोरेन्स नाइटिङ्गेल
Nicole Kidman|निकोल किडम्यान
Emma Watson|एम्मा वाट्सन
Penélope Cruz|पेनेलोप क्रुज
Jennifer Lopez|जेनिफर लोपेज
William Blake|विलियम ब्लेक
Julia Gillard|जुलिया गिलार्ड
Nicolas Cage|निकोलस केज
Jessica Alba|जेस्सिका अल्बा
Triple H|ट्रिपल एच
Mary Shelley|म्यारी सेली
Marina Abramović|मरिना अब्रामोभिच
Sheikh Hasina|शेख हसिना
Pranab Mukherjee|प्रणब मुखर्जी
Arvind Kejriwal|अरविन्द केजरीवाल
Jay-Z|जे–जी
Babett Peter|बाबेट पिटर
Anita Augspurg|अनिता अग्सपर्ग
Willian|विल्लियन
Claudia Schiffer|क्लाउडिया सिफ
Briana Banks|ब्रियाना ब्यांक्स
Walter Scott|वाल्टर स्काट
Isco Alarcón|इस्को
Walt Whitman|वाल्ट ह्वाइटम्यान
Pierre de Coubertin|पियरे डे कोबेर्टिन
David Villa|डेविड भिया
Shah Jahan|शाहजहाँ
Tawakel Karman|तवाकुल करमान
Jagjit Singh|जगजीत सिंह
Rajesh Khanna|राजेश खन्ना
Har Gobind Khorana|हरगोविन्द खुराना
Talia Shire|टेलिया सायर
Jon Moxley|डिन एम्ब्राेज
Renee Pornero|रेनि पोर्नेरो
Nitish Kumar|नितीश कुमार
Adam Sandler|एडम स्याण्लर
Farida Jalal|फरीदा जलाल
Ayesha Takia|आयशा टाकिया
Priyanka Chopra|प्रियंका चोपडा
Nicki Minaj|निकी मिनाज
Jessica Biel|जेसिका बेल
Paulo Dybala|पाउलो डायबाला
Jason Statham|जेसन स्टेथम
Milla Jovovich|मिला जोभोभिच
Vin Diesel|भेन डिजेल
Nina Dobrev|निना दोब्रेव
Vaniity|भ्यानिटी
Rigoberta Menchú|रिगोबर्टा मेन्चु टम
Shashi Tharoor|शशि थरूर
Abul Kalam Azad|अबुल कलाम आजाद
Gyanendra of Nepal|ज्ञानेन्द्र शाह
Jody Williams|जडि विलियम्स
Diego Godín|डिएगो गोडिन
Emily Greene Balch|इमिलि ग्रिनी व्याल्च
Nelly|नेली
Elizabeth Banks|एलिजाबेथ ब्याङ्क्स
Mena Suvari|मेना सुभारी
Śuddhodana|सुद्धोदन
Emma Roberts|एम्मा रोबर्ट्स
Michelle Monaghan|मिशेल मोनाघन
Dale Carnegie|डेल कार्नेगी
Patanjali|पतञ्जलि
Kat Dennings|क्याट डेनिङ्स
Kagney Linn Karter|काग्नी लिन कार्टर
K. R. Narayanan|कोच्चेरील रामन नारायणन
Summer Glau|समर ग्लौ
Janine Lindemulder|जेनिन लिन्डमल्डर
Ivanka Trump|इभाङ्का ट्रम्प
Camila Vallejo|क्यामिला भ्यालेजो
Sunrise Adams|सनराइज एडम्स
Hanna Hilton|हान्ना हिल्टन
Crissy Moran|क्रिसी मोरन
Anna Malle|एन्ना मल्ले
Kaylai Lei|केल्यानी लेइ
Daniella Rush|ड्यानियल्ला रस
Sridevi|श्री देवी
Dorothy Parker|डोरोथी पार्कर
Johnni Black|जोहनी ब्ल्याक
Bridget Powers|ब्रिगेट पावर्स
Jessica May|जेसिका मे
Ivian Sarcos|इभियान सार्कोस
Lara Dutta|लारा दत्ता
Celina Jaitly|सेलिना जेटली
Henry Cavill|हेनरी केभिल
Darren Criss|ड्यारेन क्रिस
Mukesh Ambani|मुकेश अम्बानी
Philippe Coutinho|फिलिप काउटिन्हो
Abbas|अब्बास
Khan Abdul Ghaffar Khan|खान अब्दुल गफ्फार खान
Guru Gobind Singh|गुरु गोविन्द सिंह
Romelu Lukaku|रोमेलु लुकाकु
Alfred Deakin|अल्फ्रेड डेकिन
Charmane Star|कारमेन स्टार
Javed Jaffrey|जावेद जाफरी
Anushka Shetty|अनुष्का शेट्टी
Abrar Alvi|अबरार अलवी
Shankar Dayal Sharma|शंकरदयाल शर्मा
Bhaichung Bhutia|बाइचुङ भूटिया
Frank Klepacki|फ्रन्क क्लेपक्कि
Irrfan Khan|इरफान खान
Cara Fawn|कारा फन
Bhagat Singh|भगत सिंह
H. D. Deve Gowda|एचडी देवगौडा
Dharmendra|धर्मेन्द्र
Karna Das|कर्णदास
Faf du Plessis|फाफ डू प्लेसी
Lisa De Vanna|लिसा डे भाना
Bunny Luv|बन्नी लभ
Holly Sampson|होली स्याम्पसन
Eileen Daly|ऐलिन डेली
Scottie Thompson|स्कटी थम्प्सन
Teri Weigel|टेरी विगल
Helen Duval|हेलेन डुभल
P. V. Sindhu|पीवी सिन्धू
Francis|पोप फ्रान्सिस
Basu Chatterjee|बासु चटर्जी
Nici Sterling|निकी स्टर्लिङ
Noor Inayat Khan|नुर इनायत खान
Rukmini Devi Arundale|रुक्मिणी देवी अरुन्डेल
Vijaya Lakshmi Pandit|विजयलक्ष्मी पण्डित
Jhumpa Lahiri|झुम्पा लाहिड़ी
Sharmila Tagore|शर्मिला टेगोर
Dia Mirza|दिया मिर्जा
Shayla LaVeaux|सायला लाभेअक्स
Ria Percival|रिया पर्सिभल
Charley Chase|चार्ली चेस
Anksa Kara|अंक्सा कारा
Mia Smiles|मिया स्माइल्स
Medha Patkar|मेधा पाटकर
Smita Patil|स्मिता पाटिल
Divya Dutta|दिव्या दत्ता
Flick Shagwell|फ्लिक स्याग्वेल
Ricky Ponting|रिकी पोन्टिङ
Mahi Gill|माहि गिल
Nacho|नाचो
Sharlto Copley|स्रालतो कोप्ले
Dadasaheb Phalke|दादासाहेब फाल्के
Vijay|विजय
Ronaldo|रोनाल्डो
Alexandra Quinn|एलेक्जेन्ड्रा क्विन
Kathy Bates|क्याथलिन बेट्स
Shane Warne|शेन वार्न
Anupam Kher|अनुपम खेर
B. P. Koirala|विश्वेश्वरप्रसाद कोइराला
Tiana Lynn|टियाना लेन
Kamala Surayya|कमला सुरय्या
Ellyse Perry|एलिस पेरी
Janamejaya|जनमेजय
Drew Barrymore|ड्रयु ब्यारिमोर
Arshad Warsi|अर्शद वार्सी
David Dhawan|डेविड धवन
Jayaprakash Narayan|जयप्रकाश नारायण
Viv Richards|भिभ रिचर्ड्स
Sara Blakely|सारा ब्लेकली
Hollie Stevens|होली स्टिभन्स
Keylor Navas|केलर नाभास
Matthew Hayden|म्याथु हेडन
Wasim Akram|वसीम अक्रम
Phanishwar Nath 'Renu'|फणीश्वर नाथ 'रेणु'
Rina Nakanishi|रिना नाकानिसी
Naveen Patnaik|नवीन पटनायक
Sonali Kulkarni|सोनाली कुलकर्णी
Manorama|मनोरमा
Gautama Maharishi|गौतम ऋषि
Mohammad Nabi|मोहम्मद नबी
Moon Moon Sen|मुममुन सेन
Isamu Akasaki|इसामु आकासाकी
Jeetendra|जितेन्द्र
Karlie Montana|कार्ली मोन्टाना
Margot Robbie|मार्गो रबी
Priya Anjali Rai|प्रिया राय
Shreya Ghoshal|श्रेया घोषाल
K. J. Yesudas|केजे येशुदास
Yamunacharya|यामुनाचार्य
Amy Jackson|एमी ज्याक्सन
Dev Shamsher Jang Bahadur Rana|देव शमशेर जङ्गबहादुर राणा
Kunwar Inderjit Singh|के. आई. सिंह
Geeta Bali|गीता बाली
Subhash Ghai|सुभाष घई
Nargis Fakhri|नर्गिस फखरी
Savitribai Phule|सावित्रीबाई फुले
Hisila Yami|हिसिला यमी
Mandira Bedi|मन्दिरा बेदी
Moushumi Chatterjee|मौसमी चटर्जी
Sameera Reddy|समीरा रेड्डी
Vinod Kambli|विनोद काम्बली
Shane Watson|शेन वाट्सन
Veena Malik|वीना मलिक
Deeyah Khan|दीया खान
Robin Uthappa|रोबिन उथप्पा
Ram Manohar Lohia|राममनोहर लोहिया
Raskhan|रसखान
Alex Taylor|एलेक्स टेलर
Dalip Tahil|दिलीप ताहिल
Jeannie Pepper|जेन्नी पेपर
Ismat Chughtai|इस्मत चुगताई
Mumtaz|मुमताज
Srimanta Sankardeva|शंकरदेव
Naomi Tani|नाओमी टानी
Siddharth Narayan|सिद्धार्थ
Imtiaz Ali|इम्तियाज अली
Mitchell Johnson|मिचेल जोनसन
Kader Khan|कादर खान
Khadga Prasad Oli|खड्गप्रसाद ओली
Rakhee Gulzar|राखी गुलजार
Nikki Jayne|निक्की जेन
Mohit Suri|मोहित सूरी
Denice K.|डेनिस क्लारस्कोभ
Kadambini Ganguly|कादम्बिनी गांगुली
Rajkumar Hirani|राजकुमार हिरानी
Pankaj Kapur|पंकज कपूर
Sushilkumar Shinde|सुशील कुमार शिन्दे
Dhondo Keshav Karve|धोण्डो केशव कर्वे
Digvijaya Singh|दिग्विजय सिंह
Lalchand Rajput|लालचन्द राजपुत
Tessy Thomas|टेसी थोमस
Jhalkaribai|झलकारीबाई
Nassar|नास्सर
Snehal Pradhan|स्नेहल प्रधान
Neiphiu Rio|नेफियू रियो
Usha Uthup|ऊषा उत्थुप
Tanushree Dutta|तनुश्री दत्ता
Asha Parekh|आशा पारेख
Balamani Amma|नालापत बालमणि अम्मा
Archana Puran Singh|अर्चना पुरण सिंह
Nirupama Rao|निरुपमा राव
Ananya Khare|अनन्य खरे
Roopa Ganguly|रूपा गांगुली
Durga Khote|दुर्गा खोटे
Juhi Parmar|जुही परमार
Miss Pooja|मिस पूजा
Gagan Kumar Thapa|गगन कुमार थापा
Raaj Kumar|राज कुमार
Krishna Bahadur Kunwar Rana|कृष्णबहादुर राणा
Manasvi Mamgai|मानस्वी ममगई
Bhimsen Thapa|भीमसेन थापा
K. P. S. Menon|कुमार पद्म शिव शंकर मेनन
Kavita Seth|कविता सेठ
Abhaya Subba|अभय सुब्बा
Abhiman Singh Basnyat|अभिमान सिंह बस्नेत
Aditya Thackeray|आदित्य ठाकरे
Poonam Pandey|पूनम पाण्डेय
Ali Fazal|अली फजल
Amber Gurung|अम्बर गुरुङ
Amisha Basnet|अमिशा बस्नेत
Amitabh Bhattacharya|अमिताभ भट्टाचार्य
Anjali Lavania|अंजली लावानिया
Anjali Sharma|अञ्जली शर्मा
Anjori Alagh|अंजोरी अलघ
Anu Aga|अनु आगा
Armaan Malik|अरमान मलिक
Asha Saini|फ्लोरा सैनी
Ayushmann Khurrana|आयुष्मान खुराना
Emma Kete|इम्मा केटे
Benny Dayal|बेनी दयाल
Bharat Jangam|भरत जंगम
Bharat Khawas|भरत खवास
Bharati Achrekar|भारती आचरेकर
Bhupesh Baghel|भूपेश बघेल
Bhuwan K.C.|भुवन केसी
Anikka Albrite|एनीका अल्ब्रिट
Biraj Maharjan|विराज महर्जन
Maitreyi|मैत्रेयी
Chautariya Puskhar Shah|पुष्कर शाह
Christi Lake|कृष्टी लेक
Conrad Sangma|कनराड सङ्गमा
Leah Luv|लेह लभ
Lisa Daniels|लिसा ड्यानियल्स
Dimple Yadav|डिम्पल यादव
Disha Vakani|दिशा वकानी
Durjoy Datta|दुर्जोय दत्ता
Sana Khan|सना खान
Fowzieh Khalili|फावजीह खलीली
Gangalal shrestha|गङ्गालाल श्रेष्ठ
Gauri Pradhan Tejwani|गौरी प्रधान तेजवानी
Gopal Prasad Rimal|गोपाल प्रसाद रिमाल
Iman Xin Chemjong|ईमानसिंह चेम्जोङ
Ishita Arun|इशिता अरुण
Jacklyn Lick|ज्याक्लिन लिक
Jagdeep|जगदीप
Jessie Rogers|जेस्सी रोगर्स
Juhi Babbar|जूही बब्बर
Kadambari Murali|कादम्बरी मुरली
Karan Mehra|करन मेहरा
Karina Bacchi|करिना बच्ची
Karpoori Thakur|कर्पुरी ठाकुर
Kiran Juneja|किरन जुनेजा
Krushna Abhishek|कृष्णा अभिषेक
Krystle D'Souza|क्रिस्टल डिसूजा
Kumar Vishwas|कुमार विश्वास
Laxmi Chhaya|लक्ष्मी छाया
Mahek Chahal|महक चहल
Manoj Tiwari|मनोज तिवारी
Martin Guptill|मार्टिन गुप्टिल
Marylin Star|म्यारिलिन स्टार
Meena Kandasamy|मीना कन्दासामी
Meera Chopra|मीरा चोपडा
Mink Brar|मिङ्क ब्रार
Mukesh Tiwari|मुकेश तिवारी
Nandamuri Kalyan Ram|नन्दमुरी कल्याण राम
Neelam Deo|नीलम देओ
Neera Tanden|नीरा टन्डन
Nia Sharma|निया शर्मा
Nigaar Khan|निगार खान
Niharika Singh|निहारिका सिंह
Nina Arsenault|निना अर्सेनल्ट
Nirmala Sitaraman|निर्मला सीतारमन
Palak Jain|पलक जैन
Pooja Hegde|पूजा हेगडे
Pradeep Airee|प्रदीप ऐरी
Prithu Baskota|पृथु बास्कोटा
Raja Abel|राजा एबेल
Rani Rampal|रानी रामपाल
Ravindra Jain|रवीन्द्र जैन
Renee LaRue|रिनी लरुइ
Sudeep|सुदीप
Rustom Jal Vakil|रुस्तम जाल वकील
Sadhvi Rithambara|साध्वी ऋतम्भरा
Saurabh Shukla|सौरभ शुक्ला
Mohammed Shami|मोहम्मद शमी
Shantha Sinha|शान्ता सिन्हा
Shashikala|शशि कला
Shazahn Padamsee|शाजान पद्मसी
Shilpa Shirodkar|शिल्पा शिरोडकर
Shweta Salve|स्वेता साल्वे
Shyama|श्यामा
Siddaramaiah|सिद्धारमैया
Sister Shivani|शिवानी वर्मा
Sophie Choudry|सोफी चौधरी
Sugam Pokharel|सुगम पोखरेल
Sugandha Mishra|सुगन्धा मिश्रा
Sumi Khadka|सुमी खड्का
Sunanda Pushkar|सुनन्दा पुष्कर
Sunil Thapa|सुनील थापा
Sushma Shrestha|सुष्मा श्रेष्ठ
Tara Sutaria|तारा सुतारिया
Trevor Beattie|Trevor Beattie
Upasana Singh|उपासना सिंह
V. Narayanasamy|भी नारायणस्वामी
Varun Dhawan|वरुण धवन
Vinita Bali|विनीता बाली
Yadav Pant|यादव प्रसाद पन्त
Zhu Zhu|झू झू
Kamala Harris|कमला ह्यारिस
Hina Khan|हिना खान
Sipora Gurung|सिपोरा गुरुङ
Megan Young|मेगान योङ
Holly Ryder|होली राइडर
Louis Zamperini|लुइस ज़म्पेरीनी
Melinda Messenger|मेलिन्डा म्यासेन्जर
Debi Prasad Roy Choudhury|डिपी राय चौधरी
Manmohan Krishna|मनमोहन कृष्णा
Mridula Sinha|मृदुला सिन्हा
Naina Lal Kidwai|नैना लाल किदवई
Rahul Vishwakarma|राहुल विश्वकर्मा
Kamal Dixit|कमलमणि दीक्षित
Kiran Yadav|किरण यादव
Dilip Rayamajhi|दिलीप रायमाझी
Sharada Sharma|शारदा शर्मा
Satya Mohan Joshi|सत्यमोहन जोशी
Guru Thakur|गुरू ठाकूर
Lexi Swallow|लेक्सी स्वालो
Neha Kakkar|नेहा कक्कर
Tzeporah Berman|जेपोराह बर्मिन
Shraddha Kapoor|श्रद्धा कपूर
Ramesh Kshitij|रमेश क्षितिज
Ekta Bisht|एकता बिष्ट
Ankit Tiwari|अङ्कित तिवारी
Nimrat Kaur|निम्रत कौर
Lokman Singh Karki|लोकमान सिंह कार्की
Reema Bishwokarma|रिमा विश्वकर्मा
Babar Hayat|बाबर ह्यायत
Heydon Prowse|हेडन प्रोउज
Sadaf Taherian|सदाफ तहेरियन
Montazur Rahman Akbar|मनताजुर रहमान अकबर
Akshara Haasan|अक्षरा हासन
Jannat Zubair Rahmani|जन्नत जुबेर रहमानी
Khushboo Purohit|खुशबू पुरोहित
Allu Sirish|अल्लू शिरीष
Lauren Gottlieb|लारेन गाटलिब
Angela White|एन्जेला व्हाइट
Athiya Shetty|आथिया शेट्टी
Nisa Godrej|निसा गोदरेज
Bidita Bag|बिदिता बाग
Devendra Fadnavis|देवेन्द्र फडणवीस
Annie Gill|एनी गिल
Pernia Qureshi|पर्निया कुरैशी
Natasja Nobels|Natasja Nobels
Kanchi Singh|कान्ची सिंह
Shilpa Shinde|शिल्पा शिन्दे
Mansi Shrivastav|मानसी श्रीवास्तव
Bikram Lama|बिक्रम लामा
Ram Nath Kovind|राम नाथ कोविन्द
Martin Ødegaard|मार्टिन ओडेगार्ड
Sudeshna Sinha|सुदेशना सिन्हा
Anjan Bista|अञ्जन विष्ट
Dipa Karmakar|दीपा कर्मकार
Yama Buddha|यमबुद्ध
Kedar Ghimire|केदार घिमिरे
Shweta Chaudhry|श्वेता चौधरी
Mannara|मन्नारा चोपडा
Karan KC|करन केसी
Surangana Bandyopadhyay|सुराङ्गना बन्डोपाध्याय
|उत्तम प्रधान
Yadav Kharel|यादव खरेल
Karna Limbu|कर्ण लिम्बु
Asha Mishra|आशा मिश्र
|कुमार गंगानन्द सिंह
|जनार्दन प्रसाद झा 'द्विज'
|पंकज कुमार झा
|राजेन्द्र किशोर
|रामदेव प्रसाद मण्डल झाड़ूदार
|राजीव शर्मा
Sital Jha|शीतल झा
|श्वेता झा
Vijay Devarakonda|विजय देवरकोन्डा
Priscilla Chan|प्रिसिला चान
Wilhelm Binder|विलिहेलम बिन्डेर
Anjana Om Kashyap|अञ्जना ओम कश्यप
Erika Kaar|एरिका कार
Disha Patani|दिशा पटानी
Subin Bhattarai|सुबिन भट्टराई
Buddhi Sagar|बुद्धि सागर
Samragyee RL Shah|सम्राज्ञी राज्यलक्ष्मी शाह
Nayan Raj Pandey|नयनराज पाण्डे
|पुजना प्रधान
Salon Basnet|सलोन वस्नेत
Gaurav Pahari|गौरव पहारी
Anjali Thumba Subba|अञ्जली थुम्बा सुब्बा
Thonakal Gopi|थोनाकल गोपी
Sunil Bal|सुनिल बल
Maheshwar Panta|महेश्वर पन्त
Kirtiman Singh Basnyat|कीर्तिमान सिंह बस्न्यात
Rukshar Dhillon|रुक्सार ढिल्लोन
Rashmika Mandanna|रश्मिका मन्दाना
Bidhya Chapagain|विद्या चापागाईं
Ananya Birla|अनन्या बिड़ला
Nima Gharti Magar|नीमा धर्ती मगर
Anita Basnet|अनिता बस्नेत
Miguel López González|Miguel López González
Vinícius Júnior|भिनिसियस जुनियर
Rodrigo Medina Benjumea|Rodrigo Medina Benjumea
Alfonso Toro Buiza|Alfonso Toro Buiza
José Jiménez Jimena|José Jiménez Jimena
Ritu Lalit|रितु ललित
Jagat Jang Rana|जगतजङ्ग राणा
Tulsi Ghimire|तुलसी घिमिरे
Giacomo Tocci|Giacomo Tocci
Teku Nepali|कु. टेकु नेपाली
Nisha Kumari Sah|निशा कुमारी साह
Sarita Prasai|सरिता प्रसाई
Bhimsen Das Pradhan|भिमसेन दास प्रधान
Ram Dayal Mandal|राम दयाल मण्डल
Ram Bir Manandhar|राम वीर मानन्धर
Iehchha Raj Tamang|इच्छा राज तामाङ्ग
Narendra Sah Kalwar|नरेन्द्र साह कलवार
Uday Nepali Shrestha|उदय नेपाली श्रेष्ठ
Uday Shamsher Javara|उदय शम्शेर जवरा
Resham Bahadur Lama|रेशम बहादुर लामा
Laxmi Thapa Paasmaan|लक्ष्मी थापा पासमान
Nejma Aalam|नेजमा आलम
Lal Badhur Ghale|लाल बहादुर घले
Laxman Rajbanshi|लक्ष्मण राजवंशी
Shiva Badhur Khadka|शिव बहादुर खड्का
Dr. Sekhar Koirala|डा. शेखर कोईराला
Kumar Khadka|कुमार खड्का
Sivaji Yadav|डा. शिवजी यादव
Keshav Prasad Badal|केशव प्रसाद बडाल
Kripa Ram Rana|कृपा राम राना
Shyamkumar Shrestha|श्यामकुमार श्रेष्ठ
Prof. Dr. Krishna Bahadur Chhantel Thapa|प्रा. डा. कृष्ण बहादुर छन्तेल थापा
Ganesh Prasad Bimali|गणेश प्रसाद विमली
Gita Wagle|गीता वाग्ले
Gaura Prasai|गौरा प्रसाई (कोइराला)
Panchkarna Rai|पाँचकर्ण राई
Parmila Devi Das|प्रमिला देवी दास
Santa Kumar Darai|सन्त कुमार दरै
Gopal Giri|गोपाल गिरी
Chandra Prakash (C.P.) Mainali|चन्द्र प्रकाश (सी.पी.) मैनाली
Basundhara Rokaya|बसुन्धरा रोकाया
Khima Kumari B.K.|सिमा कुमारी बि.क.
Birendra Prasad Mahato|बिरेन्द्र प्रसाद महतो
Subarna Jarchan|सुर्वण ज्वारचन
Kamal Singh Airee|कमल सिंह ऐरी
Rohit Paudel|रोहित पौडेल
Pratham Salunke|प्रथम् सलुङ्के
Rajesh Pulami Magar|राजेश पुलामी मगर
Sobha Aale|सोभा आले
Biplab Kumar Deb|बिप्लब कुमार देब
Shovit Basnet|शोभित बस्नेत
Rupa Rana|रुपा राना
Priya Prakash Varrier|प्रिया प्रकाश वरियर
Manisha Chaudhary|मनिषा चौधरी
Sadina Shrestha|सादिना श्रेष्ठ
Alina Gurung|अलिना गुरुङ
Manju Gurung|मञ्जु गुरुङ
Kripa Adhikari|कृपा अधिकारी
Usha Kumari Bista|उषा कुमारी विष्ट
Saraswati Chaudhary|सरस्वती चौदरी
Ronali Amatya|रोनाली अमात्य
Aanchal Sharma|आँचल शर्मा
Ananya Panday|अनन्या पाण्डे
Aeindra Sundar Nemwang|अइन्द्र सुन्दर नेम्वाङ्ग
Bhawani Prasad Khaapunga|भवानी प्रसाद खापुङ्ग
Anuna De Wever|अनुना डे वेभर
Khyati Mangla|ख्याति मङ्गला
Dhvani Bhanushali|ध्वनि भानुशाली
Saroj Kumar Yadav|सरोज कुमार यादव
|पायल सरकार
Ansu Fati|अंशु फाती
Abdul Rahim Ansari|अब्दुल रहिम अंसारी
Chameli Devi Das|चमेली देवी दास
Sarada Shankar Prasad Kalawar|सारदा शङ्कर प्रसाद कलवार
Usha Kumari|उषा कुमारी
Gyanendra Kumar Yadav|ज्ञानेन्द्र कुमार यादव
Kiran Kumari Rae|किरण कुमारी राई
Subhadra Adhikari|सुभद्रा अघिकारी
Rhiana Gunn-Wright|रिआना गुन-राइट
Arshak Makichyan|अर्सक माकिचिन
Carl Smith (climate activist)|कार्ल स्मिथ
Sunita Maharjan|सुनिता महर्जन
Fabienne Lupo Magnaudet|Fabienne Lupo Magnaudet
Kelly Vedovelli|Kelly Vedovelli
Yanina Kuskova|Yanina Kuskova
Greta Karasiovaite|Greta Karasiovaite
Joseph Samudio|Joseph Samudio
Dimitrios Christakos|Dimitrios Christakos
Muhammad Shahmir Aiman Abdul Halim|Muhammad Shahmir Aiman Abdul Halim
Sakchai Phodingam|Sakchai Phodingam
Karina Louise Sørensen|Karina Louise Sørensen
Mira Peeters|Mira Peeters
Cybil Di Guistini|Cybil Di Guistini
Anna-Sophia Czilwik|Anna-Sophia Czilwik
Myriam Desrosiers|Myriam Desrosiers
Adéla Vlnova|Adéla Vlnova
Monika Richterova|Monika Richterova
Nicholas Timmings|Nicholas Timmings
Ruth Demeijer|Ruth Demeijer
Chantal Polansky|Chantal Polansky
Liliano Leenknegi|Liliano Leenknegi
Kim Van Gastel|Kim Van Gastel
Nicole Peitzmeier|Nicole Peitzmeier
Jonathan Eric Gustafson|Jonathan Eric Gustafson
Dominik Hufschmid|Dominik Hufschmid
Lorenz Hollenbach|Lorenz Hollenbach
Matthias Grahé|Matthias Grahé
Bruno Schiemann|Bruno Schiemann
Justin Jacob|Justin Jacob
Tim Berners-Lee|टिम बर्नर्स ली
Wolfgang Amadeus Mozart|वोल्फगान्क आमडेयुस मोजार्ट
Linda Lovelace|लिन्डा लभलेस
Isaac Newton|आइज्याक न्यूटन
Charles Darwin|चार्ल्स डार्विन
Roger Federer|रोजर फेडरर
Tom Hanks|टम ह्याङ्क्स
Chloë Grace Moretz|क्लोइ ग्रेस मोरेट्ज
Miranda Cosgrove|मिरेन्डा कसग्रोभ
Dr. Dre|डाक्टर ड्रि
Hugo Chávez|ह्युगो चाभेज
James Watt|जेम्स वाट
René Descartes|रने देकार्त
Mahavira|महावीर
Sachin Tendulkar|सचिन तेन्दुलकर
Tony Blair|टोनी ब्लेयर
Amitabh Bachchan|अमिताभ बच्चन
Diana, Princess of Wales|वेल्सक राजकुमारी डायना
Fidel Castro|फिडेल कास्ट्रो
Maria Sharapova|मारिया सारापोभा
Angelina Jolie|एन्जेलिना जोली
Diego Maradona|डिएगो म्याराडोना
Victoria Beckham|भिक्टोरिया बेक्ह्याम
Adele|एड्ली
Edmund Hillary|एडमण्ड हिलारी
Justin Bieber|जस्टिन बीबर
Slash|स्लाश
Ashley Long|एस्ली लङ्ग
Aimee Sweet|एमी स्वीट
Demi Lovato|डेमी लोभाटो
Mel Gibson|मेल गिबसन
Eddie Murphy|एड्डी मर्फी
William Wordsworth|विलियम वोर्डस्वर्थ
Amjad Khan|अमजद खान
Warren Buffett|वारेन बफे
Zico|जिको
Sunita Williams|सुनिता विलियम्स
Michael Bay|माइकल बे
Venkatraman Ramakrishnan|वेङ्कटरामन रामकृष्णन
C. V. Raman|चन्द्रशेखर वेङ्कट रामन
Claudia Ciesla|क्लाउडिया सिसला
Kirsten Dunst|किर्स्टेन डन्स्ट
Megan Fox|मेगान फक्स
Nelly Furtado|नेली फर्टाडो
Pearl S. Buck|पर्ल एस बुक
Cate Blanchett|केट ब्लान्चेट
Pamela Anderson|पामेला एन्डरसन
Manuel Neuer|म्यानुअल न्युएर
Salma Hayek|सलमा हायेक
Kristen Stewart|क्रिस्टिन स्टेवार्ट
George Michael|जर्ज माइकल
Amartya Sen|अमर्त्य सेन
Thomas Hardy|थोमस् हार्डी
Zakir Hussain|जाकिर हुसैन
Guru Dutt|गुरु दत्त
Reena Roy|रीना रोय
Vidya Balan|विद्या बालन
Jesse Jane|जेस्सी जेन
Jet Li|जेट ली
J. M. W. Turner|जोसफ टर्नर
Farah Khan|फराह खान
Nicole Scherzinger|निकोल शेर्जिङ्गर
Juan Mata|जुअान माटा
Gabriel Batistuta|ग्याब्रियल बाटिस्टुटा
Chris Evans|क्रिस इभान्स
Romário|रोमारिओ
Zeenat Aman|जीनत अमान
Emily Blunt|एमिली ब्लन्ट
Barbara McClintock|बारबारा म्याकिन्टोक
Kaká|काका
Phil Jones|फिल जोन्स
Anna Lindh|एना लिन्ध
Maggie Grace|म्याग्गी ग्रेस
Jelena Jensen|जेलेना जेनसन
Jaime Pressly|जैमी प्रेसली
Lexi Belle|लक्सी बेल्ले
Jessica Drake|जेस्सिका ड्रेक
Julia Ann|जुलिया एन
Juno Temple|जुनो टेम्पल
Alice Munro|एलिस मुनरो
Kayden Kross|केडेन क्रस
Kalpana Chawla|कल्पना चावला
Amber Lynn|अम्बर लिन
Nikita Denise|निकिता डेनिस
Bobbi Starr|बबी स्टार
Lexxi Tyler|लक्सी टेलर
Krissy Lynn|क्रिसी लेन
Chasey Lain|क्यासी लेन
Faith Leon|फेथ लियोन
Sarojini Naidu|सरोजनी नायडू
Saif Ali Khan|सैफ अली खान
Rishi Kapoor|ऋषि कपूर
Megan Rapinoe|मेगान र्‍यापिनो
Catalina Cruz|क्याटलिना क्रुज
Mallika Sherawat|मल्लिका शेरावत
Diana Hayden|डायना हेडेन
Nautica Thorn|नौटिका थोर्न
Raven Alexis|राभेन एलेक्सिस
Alex Jordan|एलेक्स जोर्डन
Tina Tyler|टिना टेलर
Tom Hiddleston|टम हिडल्स्टन
Terrence Howard|टेरेन्स होवार्ड
V. V. Giri|वी॰ वी॰ गिरि
Meher Baba|मेहेर बाबा
John Abraham|जोन अब्राहम
Gopal Krishna Gokhale|गोपाल कृष्ण गोखले
Ghulam Ishaq Khan|गुलाम इसाक खान
Gulzarilal Nanda|गुलजारीलाल नन्दा
Charan Singh|चौधरी चरण सिंह
Abhinav Bindra|अभिनव बिन्द्रा
Vyasa|व्यास
Chandra Shekhar|चन्द्रशेखर
Guru Ram Das|गुरु राम दास
Neelam Sanjiva Reddy|नीलम संजीव रेड्डी
Ajith Kumar|अजित कुमार
David Filo|डेभिड फिलो
Adam Gilchrist|एडम गिलक्रिस्ट
Kevin De Bruyne|केविन डी ब्रुने
Sunil Dutt|सुनील दत्त
Sushil Koirala|सुशील कोइराला
Gracy Singh|ग्रेसी सिंह
Melania Trump|मेलानिया ट्रम्प
Esther Duflo|एस्थर डुफ्लो
Kaitlyn Ashley|केटलिन एस्ली
Poppy Morgan|पप्पी मोर्गन
Melinda Gates|मेलिण्डा गेट्स
Devika Rani|देविका रानी
M. S. Subbulakshmi|एम. एस. सुब्बुलक्ष्मी
Selena Silver|सेलेना सिल्भर
Kavita Krishnamurthy|कविता कृष्णमूर्ति
Yana Gupta|याना गुप्ता
Wendi Knight|वेन्डी नाइट
Gulzar|गुलजार
Dhirubhai Ambani|धीरूभाई अम्बानी
Sneha Ullal|स्नेहा उल्लाल
Bhairon Singh Shekhawat|भैरोंसिंह शेखावत
Naseeruddin Shah|नसीरुद्दीन शाह
Geeta Dutt|गीता दत्त
MS Dhoni|महेन्द्र सिंह धोनी
Sergio Ramos|सर्जियो रामोस
Silvia Saint|सिल्भिया सेन्ट
Raphaël Varane|राफेल भराने
Mahalakshmi Iyer|महालक्ष्मी अय्यर
Anna Polina|एन्ना पोलिन
Lusine Zakaryan|लुजिन जाकर्यन
Lalu Prasad VYadav|लालू प्रसाद यादव
Prithvi Narayan Shah|पृथ्वीनारायण शाह
Ranodip Singh Kunwar|रणोद्दिप सिँह बहादुर राणा
Anu Malik|अनु मलिक
Seema Malhotra|सीमा मल्होत्रा
Tisca Chopra|टिस्का चोपडा
Vijay Anand|विजय आनन्द
Kumar Sangakkara|कुमार संगाकारा
Jaggi Vasudev|जग्गी वासुदेव
Maya|मायादेवी
Onuma Sittirak|अनुमा सित्थिरक
Jack Hobbs|जैक हब्स
Sohail Khan|सोहेल खान
Halle Berry|हेल बेरी
Juddha Shamsher Jang Bahadur Rana|जुद्ध शमशेर जङ्गबहादुर राणा
Viola Paulitz|Viola Müller-Paulitz
Himesh Reshammiya|हिमेश रेशमिया
Ramanuja|श्रीनिवास रामानुजन्
Saloni Aswani|सलोनी असवानी
Deepika Kumari|दिपिका कुमारी
Jynx Maze|जिंक्स मेज
Kylie Jenner|काइली जेनर
Puja Gupta|पुजा गुप्ता
Neha Marda|नेहा मर्दा
Padma Sachdev|पद्मा सचदेव
S. P. Balasubrahmanyam|एसपी बालासुब्रमण्यम
Hariharan|हरिहरन
Natasha Nice|नतासा नाइस
Anthony Martial|एन्थोनी मार्सल
Subarna Shamsher Rana|सुवर्ण शमशेर राणा
Javed Akhtar|जावेद अख्तर
Nikhil Advani|निखिल आडवाणी
Neil Nitin Mukesh|नील नितिन मुकेश
Sukhwinder Singh|सुखविन्दर सिंह
Jang Bahadur Rana|जङ्गबहादुर राणा
Vikram|विक्रम
Jana Jordan|जाना जोर्डन
Sonu Sood|सोनू सूद
Madan Mohan Malaviya|मदन मोहन मालवीय
Ahilyabai Holkar|अहिल्याबाई होल्कर
Mulayam Singh Yadav|मुलायम सिंह यादव
Kangana Ranaut|कङ्गना राणावत
Omar Abdullah|उमर अब्दुल्ला
Nayanthara|नयनतारा
Javagal Srinath|जवागल श्रीनाथ
Jhaverchand Meghani|झवेरचन्द मेघाणी
Panna Naik|पन्ना नाइक
Abhijeet Bhattacharya|अभिजीत भट्टाचार्य
Angel|एन्जल
Anil Kumble|अनिल कुम्बले
Charlotte Flair|सार्लेट फ्लेयर
Holly Wellin|होली विलिन
AB de Villiers|एबी डि भिलियर्स
Kei Mizutani|केई मिजुतानी
Girija Devi|गिरिजा देवी
Neha Bhasin|नेहा भासिन
Suriya|सूर्या
Phillip Hughes|फिलिप ह्यूज
Rana Daggubati|राणा डग्गुबती
Satine Phoenix|स्याटिन फोनिक्स
Rajnath Singh|राजनाथ सिंह
Farooq Abdullah|फारूक अब्दुल्ला
Mallika Sarabhai Shah|मल्लिका साराभाई
Ravi Shastri|रवि शास्त्री
Priyamani|प्रियामणि
Rohit Sharma|रोहित शर्मा
Sudha Murthy|सुधा मुर्ती
Kamalinee Mukherjee|कमलिनी मुखर्जी
Samantha Akkineni|सामन्था रूथ प्रभु
Mithali Raj|मिताली राज
Amit Mishra|अमित मिश्रा
Ishant Sharma|इशान्त शर्मा
Nagma|नगमा
Anjum Chopra|अन्जुम चोपडा
Ariyakudi Ramanuja Iyengar|अरैकुडी रामानुज अयंगार
Gautham Menon|गौतम मेनन
Kittur Chennamma|रानी चेन्नम्मा
Ashmit Patel|अस्मित पटेल
Laxmi Prasad Devkota|लक्ष्मीप्रसाद देवकोटा
Arun Jaitley|अरुण जेटली
Priya Tendulkar|प्रिया तेन्दुलकर
Raghav Sachar|राघव सच्चर
Smita Jaykar|स्मिता जयकर
Amarinder Singh|अमरिन्दर सिंह
Pritam Chakraborty|प्रीतम
Brandy Alexandre|ब्रान्डी एलेक्जेन्ड्रे
Ram Charan Teja|राम चरण
Bruna Abdullah|ब्रुना अब्दुल्लाह
Gurmeet Choudhary|गुर्मीत चौधरी
Anita Goel|अनिता गोयल
Additi Gupta|अदिति गुप्ता
Adil Hussain|आदिल हुसैन
Yogi Adityanath|योगी आदित्यनाथ
Adriaen Honich|Adriaen Honich
Agni Sapkota|अग्नी प्रसाद सापकोटा
Amit Trivedi|अमित त्रिवेदी
Anandiben Patel|आनन्दीबेन पटेल
Antara Biswas|अन्तरा विश्वास
Arijit Singh|अरिजीत सिंह
Armaan Kohli|अरमान कोहली
Janaki Ammal|जानकी अम्माल
Ashwini Chidananda Akkunji|अश्विनी अकुंजी
Bharat Bhushan|भारत भूषण
Bharat Kumar Shah|भरत कुमार शाह
Bharti Singh|भारती सिंह
Bobbi Bliss|बबी ब्लिस
Rajesh Hamal|राजेश हमाल
Venkatesh Daggubati|दग्गुबती बेङ्कटेश
Deepika Singh|दीपिका सिंह
Usha Khanna|उषा खन्ना
Dwayne Smith|ड्वेन स्मिथ
Farhaan Behardien|फरहान बेहार्डिन
Gautam Adani|गौतम अदानी
Gurdeep Kohli|गुरदीप कोहली
Pawan Kalyan|पवन कल्याण
Ishita Sharma|इशिता शर्मा
Priyanka Kothari|प्रियङ्का कोठारी
Jade-Blue Eclipse|जेड-ब्लू इक्लिप्स
Janey Robbins|जेनी रविन्स
Jayamant Mishra|जयमन्त मिश्र
Jharana Bajracharya|झरना बज्राचार्य
Kay Kay Menon|के के मेनन
Kiran Chemjong|किरण चेम्जोङ
Kirat Bhattal|किरत भट्टल
Lakshmi Puri|लक्ष्मी पुरी
Lata Sabharwal|लता सभरवाल
Laverne Cox|लावरीन कक्स
Lil Bahadur Chettri|लीलबहादुर क्षेत्री
Madhav Prasad Ghimire|माधवप्रसाद घिमिरे
Manish Paul|मनीष पल
Manoj Manchu|मनोज मान्चू
Mary Barra|मेरी बार्रा
Mitchell Starc|मिशेल स्टार्क
Motiram Bhatta|मोतिराम भट्ट
Neer Shah|नीर शाह
Neeta Kadam|नीता कदम
Negar Javaherian|नेगार जेभाहेरियन
Nikhil Upreti|निखिल उप्रेती
Urvashi Dholakia|उर्वशी ढोलकिया
Pulkit Samrat|पुलकित सम्राट
Puneet Issar|पुनीत इस्सर
Puneet Bist|पुनित बिस्ट
Radhika Apte|राधिका आप्टे
Rahul Roy|राहुल रोय
Rajkamal Chaudhary|राजकमल चौधरी
Rakul Preet Singh|रकुल प्रित सिंह
Ranjan Gogoi|रञ्जन गोगोई
Rashami Desai|रश्मी देसाइ
Ratan Rajput|रतन राजपूत
Ratna Pathak|रत्ना पाठक
Rucha Hasabnis|रुचा हसब्निस
Sagar Thapa|सागर थापा
Sanjay Mishra|सञ्जय मिश्र
Scott Morrison|स्कट मोरिसन
Karishma Manandhar|करिश्मा मानन्धर
Shalmali Kholgade|शाल्मली खोलगडे
Shama Sikander|शमा सिकन्दर
Shiv Shrestha|शिव श्रेष्ठ
Shiva Shankar|शिवशंकर मानन्धर
Siddhicharan Shrestha|सिद्धिचरण श्रेष्ठ
Smriti Narayan Chaudhari|स्मृति नारायण चौधरी
Sona Nair|सोना नायर
Steve Smith|स्टिव स्मिथ
Sudeepa Singh|सुदीपा सिंह
Sudesh Berry|सुदेश बेरी
Sudha Pennathur|सुधा पेन्नाथुर
Sukirti Kandpal|सुकृति काण्डपाल
Sumona Chakravarti|सुमोना चक्रवर्ती
Sunita Deshpande|सुनीता देशपान्डे
Terence Lewis|टेरेन्स लुईस
Tulip Joshi|तुलिप जोशी
Tun Tun|टुन टुन
Ujwala Nikam|उज्वला निकम
Unmukt Chand|उन्मुक्त चन्द
Vivian Dsena|विवियन डीसेना
Yogesh Nagar|योगेश नगर
Julie K. Smith|जुलिया क्रिस्टिन स्मिथ
Trent Boult|ट्रेन्ट बोल्ट
Ira Trivedi|इरा त्रिवेदी
Chhurim|छुरिम शेर्पा
Anicia Proba|Anicia Proba
A. C. N. Nambiar|अरातिल सी नारायण नाम्बियार
Surya Narayan Vyas|सूर्य नारायण व्यास
Hari Shankar Tripathi|हरिशंकर त्रिपाठी
Himalaya Shumsher Rana|हिमालय शमशेर जबरा
Satyendra Pyara Shrestha|सत्येन्द्र प्यारा श्रेष्ठ
Avinash Sachdev|अविनाश सचदेव
Shashank Vyas|शशांक व्यास
Kunti Moktan|कुन्ती मोक्तान
Nandita K.C.|नन्दिता केसी
Basundhara Bhusal|वसुन्धरा भुसाल
Binod Bhandari|विनोद भण्डारी
Arunima Sinha|अरूणिमा सिन्हा
Mrinalini Sharma|मृनालिनी शर्मा
Maddy O'Reilly|म्याडी ओ'रेल्ली
Indira Joshi|इन्दिरा जोशी
Naveen Kumar Gowda|नवीन कुमार गौडा
Mahasundari Devi|महासुन्दरी देवी
Erica Fernandes|एरिका फर्नान्डिज
Karanvir Bohra|करणवीर बोहरा
Tarina Patel|तरिना पटेल
Parul Yadav|पारुल यादव
Ansha Sayed|अंशा सयद
Naina Jaiswal|नैना जायसवाल
Sashi Rawal|शशी रावल
Tara Alisha Berry|तारा अलिशा बेरी
Nicole Amy Madell|निकोल एमी मडेल
Adaa Khan|अदा खान
Gyanu Rana|ज्ञानु राणा
Amar Sharma Dev Raj Bhar|अमर शर्मा देव राज भर
Raashi Khanna|राशी खन्ना
Sakshi Malik|साक्षी मलिक
Chandra Maharjan|चन्द्र महर्जन
B. S. Saroja|बिएस सरोजा
Manorama Jafa|मनोरमा जाफा
Aditi Pant|अदिति पन्त
Manohar Lal Khattar|मनोहर लाल खट्टर
Rajin Dhimal|रजिन धिमाल
|राम भरोस कापड़ि भ्रमर
|उपेन्द्र नाथ झा 'व्यास'
Anshuman Rath|अनसुमन रथ
Anjana Sunuwar|अन्जना सुनुवार
Anita Yadav (Nepal)|अनिता यादव
Jürg Stäubli|Jürg Stäubli
Richa Ghimire|ऋचा घिमिरे
|मुक्त राम आचार्य
|लक्ष्मण बस्नेत
Satrudhan Mahato|शत्रुधन महतो
Shiva Pariyar|शिव परियार
Sai Pallavi|साई पल्लवी
Kanchinath Jha "Kiran"|कांञ्चीनाथ झा "किरण"
|कुमार पवन
|नरेश कुमार विकल
|नीरज कर्ण
|महेन्द्र मलंगिया
|रवीन्द्र कुमार चौधरी
|राजेन्द्र विमल
|रूपेश कुमार झा 'त्योंथ'
|लक्ष्मण झा "सागर"
|विश्वनाथ झा "विषपायी"
|श्री राम
|हरिकांत लाल दास
Marcelo Fernandes|मार्रसेलो
Nabha Natesh|नाभा नतेश
Aastha Gill|आस्था गिल
Hebah Patel|हेबा पटेल
Leema Babu|लिमा बाबु
Manyata Dutt|मान्यता दत्त
Bindu Bhatt|बिन्दु भट्ट
Rajendra Chhetri|राजेन्द्र क्षेत्री
Debika Mitra|देबिका मित्रा
Barsha Lekhi|बर्षा लेखी
Charuvi Agrawal|चारूवी अग्रवाल
Ganesh Man Pun|गणेशमान पुन
Lhakpa Sherpa|लाक्पा शेर्पा
Khagendra Lamichhane|खगेन्द्र लामिछाने
|सुरवी जैन
Momina Mustehsan|मोमिना मुस्तहसेन
Alain de Chambrier|Alain de Chambrier
Nitendra Singh Rawat|नितेन्द्र सिंह रावत
Navjot Kaur|नवजोत कौर
Arjun Kumar (Music Director)|अर्जुन कुमार
Swati Bhise|स्वाति भिसे
Nisha Sharma|निशा शर्मा
Nhyoo Bajracharya|न्ह्यु ब्रजाचार्य
Binita Baral|बिनिता बराल
Mansi Aggarwal|मानसी अग्रवाल
Kali Prasad Baskota|कालीप्रसाद बाँसकोटा
Eusebio Calonge Francés|Eusebio Calonge Francés
Joaquín Pla Laporta|Joaquín Pla Laporta
Nidhhi Agerwal|निधि अग्रवाल
Subash Karki|सुबास कार्की
|ग्रेगर जोहान मेन्डेल
Mehuli Ghosh|मेहुली घोष
|सोनू वालिया
Madhu Shahi Thakuri|मधु शाही ठकुरी
Laxman Lal Karna|लक्ष्मण लाल कर्ण
Ganga Prasad Yadav|गंगा प्रसाद यादव
Satya Narayan Mandal|सत्य नारायण मण्डल
Anita Kumari Pariyar|अनिता कुमारी परियार
Chandra Bahadur Kunwar|चन्द्रबहादुर कुँवर
Sujata Pariyar|सुजाता परियार
Nar Bahadur Thapa Magar|नर बहादुर थापा मगर
Bhaskar Bhadra|भास्कर भद्रा
Narsingh Chaudhary|नरसिंह चौधरी
Jiwan Kumari Ghimire|जीवन कुमारी घिमिरे
Kamal Prasad Pangani|कमल प्रसाद पंगेनी
Rameshwar Phuyal|रामेश्वर फुयाल
Revati Raman Bhandari|रेवती रमण भण्डारी
Naresh Kharel|नरेश खरेल
Reshambahadur Baniya|रेशमबहादुर बानियाँ
Ram Kumar Subba|राम कुमार सुब्बा
Nardevi Pun Magar|नरदेवी पुन मगर
Lal Badhur Gurung|लाल बहादुर गुरुङ
Prataman Dhimal|पर्तमान धिमाल
Lalita Kumari Regmi|ललिता कुमारी रेग्मी
Karna Badhur B. K.|कर्ण बहादुर वि.क.
Parashuram Tamang|परशुराम तामाङ
Kamala Pant|कमला पन्त
Kul Badhur Gurung|कुल बहादुर गुरुङ्ग
Kedar Nandan Chaudhary|केदार नन्दन चौधरी
Shila Sharma|शीला शर्मा (खड्का)
Sarita Kumari Yadav|सरिता कुमारी यादव
Chitra Bahadur K.C|चित्र बहादुर के.सी.
Bishnu Maya Pariyar|विष्णु माया परियार
Veda Maya Bhandari|वेद माया भण्डारी (शाक्य)
Chunamani B.K Jangali|चुडामणी वि. क. जंगली
Vaijnath Chowdhury|वैजनाथ चौधरी (थारु)
Prof. Dr. Shashank Koirala|प्रा. डा. शशांक कोइराला
Ganesh Kumar Kambang|गणेश कुमार काम्बाङ्ग
Puspalata Lama|पुष्पलता लामा
Sabitra Devi Chaudhary|सावित्री देवी चौधरी
Pyare Lal Rana|प्यारे लाल राना
Prakash Jwala|प्रकाश ज्वाला
Sarwot Aara Khanam Halwini|सरवत आरा खानम हल्वाईनी
Saraswati Bjimya|सरस्वती वजिमय
Prakash Saran Mahat|प्रकाश शरण महत
Anupriya Goenka|अनुप्रिया गोयनका
Bikram Bhusal|बिक्रम भुसाल
Amit Shrestha|अमित श्रेष्ठ
Aasif Sheikh|आशिफ शेख
|निक्की स्टर्लिङ
Bhawana Lama|भावना लामा
Prajakta Koli|प्राजक्ता कोली
Deepika Prasain|दिपिका
Manas Bihari Verma|मानस बिहारी वर्मा
Shreekanti Pasi|श्रीकान्ती पासी
tukabhadra hamal|टुकाभद्रा हमाल
Dil Bahadur Gharti|दिल बहादुर घती
Tularaj Bista|तुलाराज विष्ट
Gaur Gopal Das|गौर गोपाल दास
Jacopo Orsini|Jacopo Orsini
Jassita Gurung|जसिता गुरुङ
Padmanaban Chengalvarayan|पद्मनाबन चेन्गलवारायण
Bijay Kumar Yadav|बिजय कुमार यादव
Shailendra Kumar Yadav|शैलेन्द्र कुमार यादव
Netra Bikram Sah|नेत्र बिक्रम साह
Ram Saroj Yadav|राम सरोज यादव
Sindhu Malla|सिन्धु मल्ल
Victor-Charles-Émile Dain|Victor-Charles-Émile Dain
Abhiram Sharma|अभिराम शर्मा
Abhishek Yadav|अभिषेक यादव
Anita Kumari|अनिता कुमारी
Bharat Prasad Shah|भारत प्रसाद शाह
Kaushal Kumar Yadav|कौशल कुमार यादव
Kundan Prasad Kushwaha|कुन्दन प्रसाद कुशवाहा
Ilene Marckx|Ilene Marckx
Martin Newell|मार्टिन नेवेल
Nisha Guragain|निशा गुरागाईँ
Bhintuna Joshi|भिंन्तुना जोशी
Lianne Witkin|Lianne Witkin
Teodor Rusev|Teodor Rusev
Rokas Kmieliauskas|Rokas Kmieliauskas
Marc Oliver Pritzen|Marc Oliver Pritzen
Tsveta Nesheva|Tsveta Nesheva
Doreen Weise|Doreen Weise
Nele Van Den Bossche|Nele Van Den Bossche
Sandra Degueldre|Sandra Degueldre
Claudia Marietta|Claudia Marietta
Karry Ellen Hellmuth|Karry Ellen Hellmuth
Patricia Hempel|Patricia Hempel
Ann Roegiers|Ann Roegiers
Saskia Van Duuren|Saskia Van Duuren
Marieke Haverdings|Marieke Haverdings
Luisiana Pegoraro|Luisiana Pegoraro
Erika Schertl|Erika Schertl
Deira Mari|Deira Mari
Nadia Zuccherelli|Nadia Zuccherelli
Silvia Zoller|Silvia Zoller
Elfie Kunz|Elfie Kunz
Karin Avenant|Karin Avenant
Ljudmilla Corneo|Ljudmilla Corneo
Cornelia Dreher|Cornelia Dreher
Mārtiņš Bots|Mārtiņš Bots
Detelina Marinova|Detelina Marinova
Dawn Richardson Wilson|Dawn Richardson Wilson
Mike Evelyn|Mike Evelyn
Kenny Weyh|Kenny Weyh
Joyce Echaquan|Joyce Echaquan
Jimmy Wales|जिमी वेल्स
Larry Sanger|ल्यारी स्याङ्गर
Ludwig van Beethoven|लुड्विग भान बिथोभेन
Adolf Hitler|हिटलर
Victor Hugo|भिक्टर ह्यूगो
Genghis Khan|जंगेज खाँ
Leonardo da Vinci|लियोनार्दो दा भिन्ची
Mahatma Gandhi|महात्मा गान्धी
Robert Louis Stevenson|रोबर्ट लुइस् स्टिभिन्सन
Karim Benzema|करिम बेन्जेमा
Daniel Craig|डेनियल क्राइग
Marlene Dietrich|मार्लिन डिट्रिक
Pablo Picasso|पाब्लो पिकासो
Eminem|इमिनेम
Che Guevara|चे ग्वेभारा
Emmy Noether|एमी नुथर
Alan Turing|एलेन ट्युरिङ
Ada Lovelace|एडा लभलेस
Christopher Columbus|क्रिस्टोफर कोलम्बस
Vasco da Gama|भास्को दा गामा
Irène Joliot-Curie|इरेन जोलियट क्युरी
Vladimir Putin|भ्लादिमिर पुटिन
Martin Luther King Jr.|मार्टिन लूथर किंग
Alexander the Great|अलेक्जेन्डर महान
Otto von Bismarck|ओट्टो भान बिस्मार्क
Timur|तमेरलेन
Sun Yat-sen|सन यात सेन
Simón Bolívar|साइमन बोलीवार
Walt Disney|वाल्ट डिज्नी
Thomas Alva Edison|थोमस एल्वा एडिसन
Gautama Buddha|गौतम बुद्ध
Vallabhbhai Patel|सरदार बल्लभ भाई पटेल
Harbhajan Singh|हरभजन सिंह
Rahul Gandhi|राहुल गान्धी
Pythagoras|पाइथागोरस
David Beckham|डेभिड बेक्ह्याम
Iker Casillas|इकर क्यासिलास
Kylie Minogue|काइली मिनोग
Henry Dunant|हेनरी ड्यूनेन्ट
Amy Winehouse|एमी वाइनहाउस
PSY|साई
Edmund Barton|एडमण्ड बार्टन
George H. W. Bush|जर्ज एच डब्लू बुस
Benito Mussolini|बेनितो मुसोलिनी
Shaka Zulu|शाका जूलू
Drake|ड्रेक
Marlon Brando|मार्लन ब्राण्डो
J. K. Rowling|जे. के. रोलिंग
Ava Devine|एभा डिभाइन
Aung San Suu Kyi|आङ सान सुकी
Madhubala|मधुबाला
Reema Kagti|रीमा कागती
Asha Bhosle|आशा भोसले
Ronaldinho|रोनाल्डिन्हो
Karl Benz|कार्ल बेन्ज
Demi Moore|डेमी मुर
Ellen Johnson Sirleaf|एलेन जोन्सन सरलिफ
Justin Timberlake|जस्टिन टिम्बरलेक
Benjamin Netanyahu|बेन्जामिन नेतान्याहू
John Cena|जोन सिना
Orlando Bloom|ओर्ल्याण्डो ब्लूम
Antara Mali|अन्तरा माली
Rupert Murdoch|रुपर्ट मर्डोक
Shyam Benegal|श्याम बेनेगल
Oprah Winfrey|ओपरा विनफ्रे
Kim Jong-un|किम जोङ्ग उन
Maria Goeppert Mayer|मारिया गिउपर्ट
Jhala Nath Khanal|झलनाथ खनाल
S. M. Krishna|एस एम कृष्णा
Clara Zetkin|क्लारा जेटकिन
Mary Wollstonecraft|म्यारी वुलस्टोनक्राफ्ट
M. G. Ramachandran|मरुदुर गोपाला रामचन्द्रन
Michaëlle Jean|मिशेल जीन
Hugh Jackman|ह्यु ज्याकम्यान
George Eliot|जर्ज इलियट
Naomi Watts|नाओमी वाट्स
Haruki Murakami|हारुकी मुराकामी
Radamel Falcao|राडामेल फाल्काओ
Miriam Makeba|मिरियम माकेबा
Nutan Bahl|नूतन
David De Gea|डेभिड डे जेया
Svetlana Savitskaya|स्वेतलाना सवित्सकाया
Monica Mayhem|मोनिका मेहेम
Naomie Harris|नेओमी हेरिस
Deepika Padukone|दीपिका पादुकोण
David Silva|डेभिड सिल्भा
Javier Mascherano|ज्याभिअर मासेरानो
Paul Garder Allen|पल एलन
Sergio Leone|सर्जियो लियोन
Liv Tyler|लिभ टाईलर
Eva Mendes|इभा मेन्डीज
Cafu|काफु
Henry Hudson|हेनरी हडसन
Christina Ricci|क्रिस्टिना रिक्की
Michelle Rodrigue|मिशेल रोड्रिग्ज
Amanda Seyfried|अमेन्डा सेफ्रेड
Zendaya|जेन्डेया
Rajendra Prasad|राजेन्द्र प्रसाद
Victoria Justice|भिक्टोरिया जस्टिस
Cobie Smulders|कोबी स्मल्डर्स
Brian Lara|ब्रायन लारा
M.I.A.|एमआइए
Gerty Cori|गर्टी कोरी
Bella Thorne|बेल्ला थ्रोन
Álvaro Negredo|अल्भारो नेग्रेडो
Adam Levine|एडम लेभिन
Girija Prasad Koirala|गिरिजा प्रसाद कोइराला
Patrick Modiano|प्याट्रिक मोदियानो
Marisa Miller|मेरिसा मिल्लर
Kate Mara|केट मरा
Azra Akın|अजरा अकिन
Asa Akira|आशा अकिरा
Traci Lords|ट्रयासी लर्ड्स
Rita Faltoyano|रिटा फाल्टोयानो
Akshay Kumar|अक्षय कुमार
Bree Olson|ब्रि ओल्सन
Devon|डेभोन
Maiara Walsh|मायरा वाल्श
Daisy Marie|डेइजी मारिया
Inka Grings|इन्का ग्रिङ्गस
Diana Doll|डायना डल
Gracie Glam|ग्रासी ग्लाम
Lacie Heart|ल्यासी हर्ट
Kelly Madison|केली म्याडिसन
Sophie Evans|सोफी इभान्स
Dev Patel|देव पटेल
Kristina Rose|क्रिस्टिन रोज
Kinzie Kenner|किन्जी केन्नर
Annabel Chong|एनाबेल चोङ्ग
Dyanna Lauren|ड्याना लरेन
Raylene|रेलेनी
Janet Yellen|जेनेट एलन
Anita Desai|अनिता देसाई
Shilpa Shetty|शिल्पा शेट्टी
Lisa Sparks|लिजा स्पार्क्स
Érika Cristiano dos Santos|एरिका
Agbani Darego|अगबानी डरेगो
Karlie Kloss|कार्ली क्लोस
Shriya Saran|श्रिया सरन
Mario Draghi|मारियो द्रागी
Liaquat Ali Khan|लियाकत अली खान
Jenny Hendrix|जेन्नी हेन्ड्रिक्स
Amrita Rao|अमृता राव
Abby Erceg|एबी अर्सेज
Nathuram Godse|नाथूराम विनायक गोडसे
Fred|फ्रेड
Imran Khan|इमरान खान
Mahendra of Nepal|महेन्द्र वीर विक्रम शाह
Chiranjeevi|चिरञ्जीवी
Shahid Kapoor|शाहिद कपूर
Raja Ravi Varma|राजा रवि वर्मा
Hassan Rouhani|हसन रुहानी
Dustin Moskovitz|डस्टिन मोस्कोविज
C. Rajagopalachari|चक्रवर्ती राजगोपालाचारी
Brett Lee|ब्रेट ली
Syren|साइरन
Linda Friday|फ्राइडे
Alexandra Silk|एलेक्जेन्ड्रा सिल्क
Debi Diamond|डेवी डाइमन्ड
Careena Collins|करिना कोलिन्स
Sharon Mitchell|स्यारोन मिचेल
Dorothy Wordsworth|डोरोथी वोर्डस्वोर्थ
Tania Sachdev|तानिया सचदेवा
Ani Choying Drolma|आनी छोइङ डोल्मा
Angela Summers|एन्जेला समर्स
Aparna Sen|अपर्णा सेन
Katie Gold|केटी गोल्ड
Felecia|फेलेसिया
Meira Kumar|मीरा कुमार
Devon Michaels|डेभन मिचेल
Sugiura Asami|असामी सुजिउरा
Annike Krahn|एन्निके क्राहन
Irom Chanu Sharmila|इरोम चानू शर्मिला
J. R. D. Tata|जहांगीर रतनजी दादाभाई टाटा
Udit Narayan|उदित नारायण
Muhammad Ali Bogra|मोहम्मद अली बोगरा
Kishore Kumar|किशोर कुमार
Bryan Adams|ब्रायन एडम्स
Rani Mukherjee|रानी मुखर्जी
Humayun|हुमायूँ
Shyla Stylez|साइला स्टाइलेज
Angelica Bella|एन्जेलिका बेला
Jodie Moore|जोडी मूरे
Uday Chopra|उदय चोपडा
Shuji Nakamura|सुजी नाकामुरा
Fardeen Khan|फरदीन खान
Riteish Deshmukh|रितेश देशमुख
Riya Sen|रिया सेन
Lucy Pinder|लुसी पिन्डर
B. S. Yeddyurappa|बीएस येदयुरप्पा
Chaitanya Mahaprabhu|चैतन्य महाप्रभु
Prithvi of Nepal|पृथ्वी वीर विक्रम शाह
Jiiva|जीवा
Saira Banu|सायरा बानो
Harry Kane|ह्यारी केन
Purushottam Das Tandon|पुरूषोत्तम दास टंडन
Feroz Khan|फिरोज खान
Shankar|एस शङ्कर
Darashaw Nosherwan Wadia|दाराशाह नोशेरवान वाडिया
Rakesh Roshan|राकेश रोशन
V. Shantaram|वी शान्ताराम
Lala Lajpat Rai|लाला लाजपत राय
Shakti Samanta|शक्ति सामंत
Gracie Otto|ग्रेसी ओट्टो
Bridgette Monet|ब्रिजिट्टे मोनेट
Suchitra Krishnamoorthi|सुचित्रा कृष्णमूर्ति
Sergey Nikolayevich Lazarev|सर्गी निकोलाइविच लाज़ारेव
Kamla Beniwal|कमला बेनीवाल
Shailaja Acharya|शैलजा आचार्य
Marie McCray|मारिया म्याक्रे
Chinmayi Sripada|चिनमयी श्रीपदा
Urvashi Butalia|उर्वशी बुटालिया
Jaelyn Fox|जेलिन फक्स
Bir Shamsher Jang Bahadur Rana|वीर शमशेर जङ्गबहादुर राणा
Teesta Setalvad|तीस्ता सेटलवाड
Jacqueline Fernandez|ज्याकलिन फर्नान्डिज
Reema Lagoo|रीमा लागू
Quique Setién|किके सेटिया
Ju Manu Rai|जुमानु राई
Shrutakarma|श्रुतिकीर्ति
Tina Desai|टिना देसाइ
Twinkle Khanna|ट्विङ्कल खन्ना
Pandurang Vaman Kane|पाण्डुरङ्ग वामन काणे
Christie Lee|क्रिस्टी ली
Yo Yo Honey Singh|यो यो हनी सिंह
Tina Ambani|टीना अम्बानी
Kanaiyalal Maneklal Munshi|कन्हैयालाल माणिकलाल मुन्शी
Agrasena|अग्रसेन
Sunidhi Chauhan|सुनिधि चौहान
Pratap Singh I|महाराणा प्रताप
Pankaj Udhas|पंकज उधास
Rahul Bajaj|राहुल बजाज
Tillakaratne Dilshan|तिलकरत्ने दिलशान
Tusshar Kapoor|तुषार कपूर
Kirti Azad|कीर्ति आजाद
Mahendra Kapoor|महेन्द्र कपूर
Abu Bakr al-Baghdadi|अबु बक्र अल-बगदादी
Aika Miura|आइका मिउरा
Anandi Gopal Joshi|आनन्दीबाई जोशी
Liliane Tiger|लिलिएन टाइगर
Bidhan Chandra Roy|बिधन चंद्र रय
Salim Ali|सालिम अली
Britt Morgan|ब्रिट मोर्गन
Charlotte Stokely|कार्लोट स्टक्ली
Sharon Wild|स्यारोन वाइल्ड
Parineeti Chopra|परिनिती चोपडा
Vasundhara Raje|वसुन्धरा राजे सिन्धिया
Emraan Hashmi|इमरान हाशमी
Loona Luxx|लुना लक्स
Hrishitaa Bhatt|ऋशिता भट्ट
Roxanne Hall|रोक्साना हल
Upendra Yadav|उपेन्द्र यादव
Jennifer Dark|जेनिफर डार्क
Prabhas|प्रभास
Shikha Uberoi|शिखा ओबराय
Suresh Wadkar|सुरेश वाडकर
Saya Misaki|साया मिसाकी
Ashok Gehlot|अशोक गहलोत
Daniel Vettori|डेनियल विट्टोरी
Mohammad Rafique|महोम्मद रफिक
Kalpana Datta|कल्पना दत्त
Kuvempu|कुप्पाली वी गौड़ा पुटप्पा
Marlon Samuels|मार्लोन स्यामुएल्स
Kanan Devi|कानन देवी
Younus Khan|युनिस खान
Julia Alexandratou|जुलिया एलेक्जेन्ड्राट
Prem Chopra|प्रेम चोपडा
Kailash Satyarthi|कैलाश सत्यार्थी
Sherlyn Chopra|शर्लिन चोपडा
Sidharth Malhotra|सिद्धार्थ मल्होत्रा
Rajpal Yadav|राजपाल यादव
Kunal Khemu|कुणाल खेमु
Rabri Devi|राबडी देवी
Mamta Kulkarni|ममता कुलकर्णी
Dinesh Karthik|दिनेश कार्तिक
Ambati Rayudu|अम्बाती रायडु
Vasudev Balwant Phadke|वासुदेव बलवन्त फडके
S. S. Rajamouli|एसएस राजामौली
Jhulan Goswami|झूलन गोस्वामी
Archana|अर्चना
Karthik Siva kumar|कार्ति
Bhagyashree Patwardhan|भाग्यश्री
Allanah Starr|अल्लाना स्टार
Asrani|असरानी
Sarika|सारिका
Abhirami|अभिरामी
Riyaz Khan|रियाज खान
Ila Arun|ईला अरुण
Padmini Kolhapure|पद्मिनी कोल्हापुरी
Shiv Kumar Batalvi|शिव कुमार बटालवी
Subhash Chandra|सुभाष चन्द्र
Ghanshyam Das Birla|घनश्याम दास बिडला
Sachin|सचिन
Jhamak Ghimire|झमक घिमिरे
Mika Singh|मीका सिंह
Prashant Tamang|प्रशान्त तामाङ
Sulakshana Pandit|सुलक्षणा पण्डित
Sajid Nadiadwala|साजिद नाडियाडवाला
Ali Zafar|अलि जफर
Mala Sinha|माला सिन्हा
Deepak Dobriyal|दीपक डोबरियाल
Chitra Bahadur K.C.|चित्रबहादुर केसी
Collette McCallum|कलेट्टे म्याकल्लम
Gurdas Maan|गुरदास मान
Megan Coleman|मेगान कोलम्यान
Riley Reid|रिले रेड
Rana Jang Pande|रणजंग पाँडे
Katie Stevens|Katie Stevens
Glenn Maxwell|ग्लेन म्याक्सवेल
Shraddha Das|श्रद्धा दास
Heidi Mayne|हेइडी मेने
Ashley Renee|एश्ली रेनी
Aanchal Kumar|आंचल कुमार
Adriaen Cornelisz Beeldemaker|Adriaen Cornelisz Beeldemaker
Ahana Deol|अहाना देओल
Aiza Khan|आयेजा खान
Ali Asgar|अली असगर
Amruta Khanvilkar|अमृता खानविलकर
Anil Mandal|अनिल मण्डल
Anjana Sukhani|अञ्जना सुखानी
Anju Panta Koirala|अञ्जु पन्त
Anna Chandy|अन्ना चान्डी
Annie Khalid|एन्नी खालिद
Anupama Aura Gurung|अनुपमा गुरुङ
Anurita Jha|अनुरिता झा
Asha Sachdev|आशा सचदेव
Ashwini Kalsekar|अश्विनी कलसेकर
Baji Rao II|बाजीराव द्वितीय
Brooke Hunter|ब्रुक हन्टर
Caroline Dean|कैरोलीन डीन
Chhavi Pandey|छवि पाण्डे
Deepraj Rana|दीपराज राणा
Diamond Shumshere Rana|डायमण्ड शमशेर राणा
Diljit Dosanjh|दिलजीत दोसांझ
Dipendra Chaudhary|दिपेन्द्र चौधरी
Donna Air|डोन्ना एयर
Esha Gupta|इशा गुप्ता
Evelyn Sharma|एवलिन शर्मा
Fallon|फलोन
Gajendra Thakur|गजेन्द्र ठाकुर
Indraneil Sengupta|इन्द्रनील सेनगुप्ता
Sharda|शारदा राजन अयङ्गर
Jamuna Gurung|जमुना गुरुङ
Jeet Ganguly|जीत गांगुली
Jharana Thapa|झरना थापा
Julia Hills|जूलिया हिल्स
Kalpana Mohan|कल्पना मोहन
Kapil Sharma|कपिल शर्मा
Kerry Butler|केरी बटलर
Ketki Dave|केतकी दवे
Shri Krishna Sinha|कृष्ण सिंह
Marchant de Lange|मरकान्ट डी लाङ्ग
Monali Thakur|मोनाली ठाकुर
Monica Dogra|मोनिका डोगरा
Mouni Roy|मौनी राय
Mukesh Rishi|मुकेश ऋषि
Nani|नानी
Nauheed Cyrusi|नौहीद सेरुसी
Neelesh Misra|नीलेश मिश्रा
Neeta Lulla|नीता लुल्ला
Nikhil Paul George|निखिल पौल जर्ज
Nivin Pauly|निविन पौली
Omi Vaidya|ओमी वैद्य
Osborne Smith|ओसबोर्न स्मिथ
Payal Shakya|पायल शाक्य
Poulomi Ghatak|पौलोमी घटक
Prakash Man Singh|प्रकाश मान सिंह
Preetika Rao|प्रीतिका राव
Purnima Choudhary|पूर्णिमा चौधरी
Ragini Khanna|रागिनी खन्ना
Ram Krishna Dhakal|रामकृष्ण ढकाल
Ravi Teja|रवि तेजा
Rhea Kapoor|रिया कपूर
Runa Basu|रुना बासु
Sadashiv Amrapurkar|सदाशिव अमरापुरकर
Sanduk Ruit|सन्दुक रूइत
Satya Nadella|सत्य नडेला
Shabbir Ahluwalhia|शब्बीर अहलूवालिया
Shikhar Dhawan|शिखर धवन
Subhash Ghisingh|सुवास घिसिङ
Sunil Grover|सुनील ग्रोवर
Sunita Singh|सुनिता सिंह
Surveen Chawla|सुरवीन चावला
Susan Itticheria|सुसान इट्टिचेरिया
Tina Dutta|टीना दत्ता
Toral Rasputra|तोरल रसपुत्र
Urvashi Rautela|उर्वशी रौटेला
Vasundhara Kashyap|वसुन्धरा कश्यप
Zaheera|जहीर
Yuba Raj Khatiwada|युवराज खतिवडा
Shreya Dhital|श्रेया धिताल
Hiroshi Amano|हिरोसी अमानो
Isha Sharvani|ईशा शरवानी
Tej Sapru|तेज सप्रू
Shakti Mohan|शक्ति मोहन
Mathabar Singh Thapa|माथवरसिंह थापा
Tilak Bahadur Rawal|तिलक बहादुर रावल
Puspa Thapa|पुष्प थापा
|प्रदीप रिमाल
Mangala Devi Singh|मंगलादेवी सिंह
Rabindra Mishra|रवीन्द्र मिश्र
Rohini Bhate|रोहिणी भाटे
Nikitin Dheer|निकितिन धीर
Vaani Kapoor|वाणी कपूर
Rohit|रोहित
Sarita Lamichhane|सरिता लामिछाने
Ishani Shrestha|इशानी श्रेष्ठ
Vikas Bahl|विकास बहल
Purnima Sinha|पूर्णिमा सिन्हा
Anup Baral|अनुप बराल
Malini Awasthi|मालिनी अवस्थी
Rinku Ghosh|रिंकु घोष
Varun Sharma|वरुण शर्मा
Raghav Juyal|राघव जुयाल
Jyotiraditya Scindia|ज्योतिरादित्य सिन्धिया
Daisy Shah|डेजी शाह
Smriti Mandhana|स्मृति मंधाना
Komal Jha|कोमल झा
Chirag Paswan|चिराग पासवान
Mausami Gurung|मौसमी गुरुङ
Priya Banerjee|प्रिया बनर्जी
Dayahang Rai|दयाहाङ राई
Roopa Unnikrishnan|रूपा उन्नीकृष्णन
Thomas Velley|Thomas Velley
Bhuwan Karki|भुवन कार्की
Siddhant Lohani|सिद्धान्त लोहनी
Shila Mehta|शिला मेहता
Wasudev Waman Patankar|वासुदेव वामन पाटणकर
Tejaswi Madivada|तेजस्वि मादीवाडा
|ललिता सहरावत
Shefali Razdan Duggal|शेफाली राजदान दुग्गल
Dipak Rai|दिपक राई
Atanu Das|अतानु दास
Dinesh D.C.|दिनेश डिसी
Aashish Rana|लाउरे
Sonam Bajwa|सोनम बाजवा
Rajesh Pulami|राजेश पुलामी
Nora Fatehi|नोरा फतेही
Rukhsaar Rehman|रुख्सार रहमान
Federico Valverde|फेडरिकाे भल्भर्डे
Dharanidhar Koirala|धरणीधर कोइराला
|रेजिना उप्रेती
Shanti Maskey|शान्ति मास्के
|श्रीशा कार्की
Gabriel Jesus|ग्यब्रिएल जेसुस
Sumina Ghimire|सुमिना घिमिरे
Apoorva Arora|अपूर्वा अरोडा
Keertinarayana Mishra|कीर्तिनारायण मिश्र
|दिनेश कुमार मिश्र
|प्रबोध नारायण सिंह
|बाबू साहेब चौधरी
|महेन्द्र नारायण झा
|शिव कुमार झा
|श्याम चन्द्र
|संजय झा
|सुरेन्द्र झा 'सुमन'
|सुरेन्द्र लाभ
Prakreeti Shrestha|प्रकृति श्रेष्ठ
Ananta Tamang|अनन्त तामाङ
Akanksha Puri|आकांक्षा पुरी
Ikka Singh|इक्का सिंह
Kylian Mbappé|काइलियन एम्बाप्पे
Taj Wali|ताज वाली
Mehreen Pirzada|मेहरीन पिरजादा
Asmi Shrestha|अस्मी श्रेष्ठ
Isha Ambani|इशा अम्बानी
Aruna Budda Reddy|अरुणा रेड्डी
Gopal Gurung|गोपाल गुरुङ
Megha Akash|मेघा आकाश
Najir Hussain|नाजिर हुसेन
Rubina Chhetri|रुबिना क्षेत्री
Dipendra K Khanal|दिपेन्द्र के. खनाल
Mishu Shrestha|मिशु श्रेष्ठ
Lopamudra Raut|लोपामुद्रा राउत
Ritika Singh|रितिका सिंह
|नरेन्द्र नन्चल
Ram Krishna Kunwar|रामकृष्ण कुँवर
Deepa Shree Niraula|दीपा श्री निरौला
Mansi Joshi|मानसी जोशी
Sabitra Bhandari|साबित्रा भण्डारी
|शिवराज आचार्य कौण्डिन्न्यायन
Gopal Dhakal|गोपाल ढकाल
Sunil Dhamala|सुनिल धमला
Pablo Pintado|Pablo Pintado
Alisha Rai|एलिशा राई
|अञ्जुकुमारी बिष्ट
Kamal Das|कमल दास
Sagarmoy Ghosh|सागरमय घोष
Nadir Alvarez|Nadir Alvarez
Frank Hauenschild|Frank Hauenschild
Gyanu Devi Gaire|ज्ञानुदेवी गैरे
Jay Dev Joshi|जय देव जोश
Dilli Bahadur Chaudhary|डिल्ली बहादुर चौधरी
Dimple Kumari Jha|डिम्पल कुमारी झा
Ram Singh Yadav|राम सिंह यादव
Ranjit Karn|रंजित कर्ण
Usha Gurung|उषा गुरुङ्ग
Jitendra Narayan Dev|जितेन्द्र नारायण देव
Prabha Debi Bajracharya|प्रभा देबी बज्राचार्य
Chandra Bahadur Gurung|चन्द्र बहादुर गुरुङ्ग
Ram Chandra Yadav|राम चन्द्र यादव
Ramhari Khatiwada|रामहरि खतिवडा
Lalendra Kumar Mandal|लालेन्द्र कुमार मण्डल
Rita Shahi|रीता शाही
Ishwori Neupane|ईश्वरी न्यौपाने
Nawaraj Sharma|नबराज शर्मा
Laxmi Devi Bhandari|लक्ष्मी देवी भण्डारी
Om Devi Malla|ओमदेवी मल्ल
Lila Koirala|लिला कोइराला
Lokmani Dhakal|लोकमणी ढकाल
Kamal Bishowkarma|कमला विश्वकमा
Bidur Prasad Sapkota|विदुर प्रसाद सापकोटा
Kashi Nath Adhikari|काशी नाथ अधिकारी
Shiva Lal Thapa|शिव लाल थापा
Bir Bahadur Balayar|विर वहादुर वलायर
Biraj Bista|विराज विष्ट
Keshab Thapa|केशव थापा
Bishram Prasad Chaudhary|विश्राम प्रसाद चौधरी
Kripasur Sherpa|कृपासुर शेर्पा
Sita Devi Yadav|सिता देवी यादव
Prem Bahadur Singh|पे्रम बहादुर सिंह
Shyam Prasad Dhakal|श्यामप्रसाद ढकाल
Gopal Dahit|गोपाल दहित
Gopalman Shrestha|गोपालमान श्रेष्ठ
Shail Kumar Devi|शैल कुमारी देवी
Parbhu Shah|प्रभु साह
Gangadevi Dangi|गंगादेवी डाँगी
Pemba Lama|पेम्बा लामा
Chandreshwor Jha|चन्द्रेश्वर झा
Chandra Mohan Yadab|प्रा. डा. चन्द्र मोहन यादव
Bal Bahadur Mahat|बल बहादुर महत
Surendra Prasad Chaudhary|सुरेन्द्र प्रसाद चौधरी
Bhim Sharki|भिम शार्की
Amar Singh Routela|अमर सिंह रौटेला
Sumit Jha|सुमित झा
Dev Shah|देव शाह
Kushal Bhurtel|कुसल भुर्तेल
Shankar Rana|शंकर राना
Pawan Sarraf|पवन सरफ
Saurabh Khanal|सौरभ खनाल
|जेन्ना फाइन
Niveditha Arjun|निवेदिता अर्जुन
Rohit Kumar|रोहित कुमार पौडेल
Reshma Bhandari|रेश्मा भण्डारी
Goma Dhungel|गोमा ढुंगेल
Manadevi Chalise|मनदेवी चालिसे
Shrinkhala Khatiwada|श्रृंखला खतिवडा
Ayush Rijal|आयुश रिजाल
Sara Ali Khan|सारा अली खान
Dil Singh Khadka|दिर्ग सिं खड्का
Paramita Rajya Laxmi Rana|परमिता राणा
Sylvia Hoffman|Sylvia Hoffman
|देवी ढकाल
Raveena Desraj Shrestha|रवीना देसराज श्रेष्ठ
Pearl Doles Bell|पर्ल डोल्स बेल
Roshan Bikram Thakuri|रोशन विक्रम ठकुरी
Roger Hallam|रोजर हालाम
Birendra Prasad Singh|बिरेन्द्र प्रसाद सिंह
Nilam Devi Bhumiharani|निलम देवी भुमिहारनी
|प्रिया गिल
Maithili Thakur|मैथिली ठाकुर
Babita Kumari|बबिता कुमारी
Hasima Khatun|हसिमा खातुन
Janat Ansari|जनत अन्सारी
Sarah Myhre|साराह मेहर
CarryMinati|अजय नागर
Vishma Raj Dhungana|भिष्मराज ढुंगाना
Raghunandan Das|रघुनन्दन दास
Liam Christie|Liam Christie
Keaan Van Venrooij|Keaan Van Venrooij
Cristina Michelle Mata Pitti|Cristina Michelle Mata Pitti
Nikola Levkov|Nikola Levkov
Virag Buzsaki|Virag Buzsaki
Jennifer Manefield|Jennifer Manefield
Caroline Payot-Podevin|Caroline Payot-Podevin
Rhonda Quick|Rhonda Quick
Letizia Giardinelli|Letizia Giardinelli
Valentina Poli|Valentina Poli
Maya Escolar|Maya Escolar
Simone Trafelet|Simone Trafelet
Tara Mulder|Tara Mulder
Cindy Bauwens|Cindy Bauwens
Gitana Gruodyte|Gitana Gruodyte
Ruth Ellway|Ruth Ellway
Moira Tarraran|Moira Tarraran
Carolyn Maxwell|Carolyn Maxwell
Juri Gatt|Juri Gatt
Ionuț Șișcanu|Ionuț Șișcanu
Natalia Jamróz|Natalia Jamróz
Sebastian Mitterer|Sebastian Mitterer
Phil Harres|Phil Harres
Jannis Maul|Jannis Maul
Barack Obama|बाराक ओबामा
Napoleon|नेपोलियन बोनापार्ट
Louis Pasteur|लोइस पास्चर
Joseph Stalin|जोसेफ स्टालिन
Jawaharlal Nehru|जवाहरलाल नेहरू
Charles de Gaulle|चार्ल्स द गल
Arnold Schwarzenegger|अर्नोल्ड स्वार्जनेगर
Michael Jackson|माइकल ज्याक्सन
Claire Holt|क्लेर होल्ट
Miley Cyrus|माइली साइरस
Confucius|कन्फुसियस
Larry Page|लेरी पेज
Bill Gates|बिल गेट्स
Snoop Dogg|स्नूप डग
Hernán Cortés|हर्नान कोर्टस
Franklin Delano Roosevelt|फ्रान्क्लिन रुजवेल्ट
Henry Ford|हेनरी फोर्ड
Voltaire|भोल्टेर
Immanuel Kant|इम्मानुएल कांट
Adam Smith|एडम स्मिथ
Dwayne Johnson|ड्वेन जोनसन
Tiger Woods|टाइगर वुड्स
Cristiano Ronaldo|क्रिस्टियानो रोनाल्डो
Venus Williams|वीनस विलियम्स
John Adams|जोन एडम्स
Tina Fey|टिना फे
Ernest Hemingway|अर्नेस्ट हेमिङ्वे
Andrew Garfield|एन्ड्र्यु गारफिल्ड
Iago Aspas|इयागो आसपास
Luis Suárez|लुइस स्वारेज
Tera Patrick|टेरा प्याट्रिक
Linus Torvalds|लिनस टोरभाल्ड्स
Benazir Bhutto|बेनजिर भुट्टो
Shakira|सकिरा
Ashton Moore|एस्टन मूरे
Jane Austen|जेन अस्टिन
David Johnston|डेविड जोनस्टन
Anuradha Paudwal|अनुराधा पौडवाल
H. G. Wells|एच. जी. वेल्स
Thomas Müller|थोमस मुलर
Dave Bautista|डेभ बाटिस्टा
Valentina Tereshkova|भ्यालेन्तिना तेरेस्कोभा
Gauri Khan|गौरी खान
Chetan Bhagat|चेतन भगत
Aishwarya Rai|ऐश्वर्या राय बच्चन
Nadine Gordimer|नदिनि गर्दिमर
Pratibha Patil|प्रतिभा पाटिल
Bobby Deol|बबी देओल
Susan Kilrain|सुसान किलरेन
Patrick Conley|प्याट्रिक कोन्ले
Rambhadracharya|रामभद्राचार्य
Susan Wazowski|सुसन वोज्सिकी
Sujata Koirala|सुजाता कोइराला
Riley Steele|रिले स्टील
Prachi Desai|प्राची देसाई
Anna Kendrick|अन्ना केनड्रिक
Brooklyn Lee|ब्रुक्लिन ली
George E. Smith|जॉर्ज ई स्मिथ
John Keats|जोन किट्स
Stefan Hell|स्टिफन हेल
Ravi Shankar|रवि शंकर
Leymah Gbowee|लेमाह बोवी
Carrie Fisher|क्यारी फिसर
Vanessa Hudgens|वेनेसा हजेंस
Angie Savage|एन्जी साभेज
Shirin Ebadi|शिरिन एबादी
Ajinkya Rahane|अजिंक्य रहाने
David Copperfield|डेभिड कपरभिल्ड
Amrita Sher-Gil|अमृता शेरगिल
Taťána Gregor Brzobohatá|ताताना कुचारोभा
Manna Dey|मन्ना डे
Juhi Chawla|जुही चावला
Birendra of Nepal|वीरेन्द्र वीर विक्रम शाह
Blake Lively|ब्लेक लाइभ्ली
Sonia Gandhi|सोनिया गान्धी
William Makepeace Thackeray|विलियम मेकपीस थैकरे
Elliot Page|एलेन पेज
Samuel Colt|स्याम्युल कोल्ट
Abhishek Bachchan|अभिषेक बच्चन
Lakshmi Mittal|लक्ष्मी मित्तल
Eva Green|एभा ग्रीन
Ludacris|लुडाकृस
Ne-Yo|नियो
Olivia Wilde|ओलिभिया वाइल्ड
Spiros Louis|स्पिरिडिन लुई
Carrie-Anne Moss|केरी-एन्नी मस
Sophia Bush|सोफिया बुश
Shannen Doherty|श्यान्नेन डोहर्टी
Taslima Nasrin|तसलीमा नसरीन
William Holman Hunt|विलियम हन्ट
Kate Moss|केट मोस
Paul Walker|पल वाल्कर
Morarji Desai|मोरारजी देसाई
T-Pain|टी–पेन
Dayananda Saraswati|स्वामी दयानन्द सरस्वती
Melissa Leo|मेलिस्सा लियो
Paola Suárez|पाओला स्वारेज
Brittany Snow|ब्रिटानी स्नो
Rosamund Pike|रोजमण्ड पाइक
Rebecca Hall|रेबेक्का हल
Minka Kelly|मिन्का केल्ली
Nina Hartley|नीना हार्टले
Jolene Blalock|जोलेन ब्लालक
Sasha Cohen|सासा कोहेन
Britt Robertson|ब्रिट रोबर्ट्सन
Vandana Shiva|वन्दना शिवा
Gianna Michaels|जियान्ना मिचेल
Ana Beatriz Barros|एना बिटरिज बर्रोस
Bobbi Eden|बबी एडेन
Vicky Vette|विक्की भेट्टे
Vanessa Hessler|भेनेस्सा हेस्सलर
Naomi Scott|नाओमी स्कट
Koneru Humpy|हम्पी कोनेरु
Lori Singer|लोरी सिङ्गर
Jeanna Fine|जिना फाइन
Karen Lancaume|करेन लन्काउमी
Debbie Reynolds|डेबी रेनल्ड्स
Ameesha Patel|अमीषा पटेल
P. V. Narasimha Rao|पिभी नरसिंह राव
Erica Boyer|एरिका बोयर
Ramdev|रामदेव
Megan Park|मेगन पार्क
Lisa Ray|लीसा रे
Ana Botín|एना बोटिन
Lolo Ferrari|लोलो फरारी
Bal Gangadhar Tilak|बाल गंगाधर तिलक
Anil Kapoor|अनिल कपूर
Vishwanath Pratap Singh|विश्वनाथ प्रताप सिंह
Elon Musk|इलोन मस्क
Abigail Johnson|एबिगेल जोनसन
Tim Sweeney|टिम स्विनी
Helen Mirren|हेलेन मिर्रेन
Aditya Chopra|आदित्य चोपडा
Sanath Jayasuriya|सनथ जयसूर्या
Krishna Prasad Bhattarai|कृष्णप्रसाद भट्टराई
Narayan Gopal|नारायण गोपाल
Alana Evans|एलाना इभान्स
Nyomi Banxxx|न्योमी बेन्क्स
India Summer|इण्डिया समर
John Peters Humphrey|जोन पिटर्स हमफ्री
Tyla Wynn|टाइला वाइन
Brooke Ashley|ब्रुक एश्ली
Haley Paige|हेले पाइज
Celeste|सेलेस्टे
Janet Jacme|जेनेट ज्याक्मी
Taylor Wane|टेलर वान
Felicia Fox|फेलिसिया फक्स
Olivia Del Rio|ओलिभिया डेल रियो
Jaya Bachchan|जया बच्चन
Kyah Simon|क्याह सिमोन
Parveen Babi|परवीन बबी
Helen|हेलन
Karanam Malleswari|कर्णम मल्लेश्वरी
Rama Dasgupta|सुचित्रा सेन
Karan Johar|करण जोहर
Kim Sharma|किम शर्मा
Stoya|स्टोया
Rahul Dravid|राहुल द्रविड
Pepe|पेपे
Bachendri Pal|बछेन्द्री पाल
Kumaraswami Kamaraj|के. कामराज
Teigen Allen|टेइजेन एलेन
Lauren Phoenix|लरेन फोनिक्स
Asia Carrera|एशिया क्यारेरा
Simi Garewal|सिमी गरेवाल
Gail Force|गेल फोर्स
Babul Supriyo|बाबुल सुप्रियो
Kapil Dev|कपिल देव
Sourav Ganguly|सौरभ गांगुली
Anthony Fauci|एन्थोनी एस. फाउकी
Gianna Lynn|जिएन्ना लिन
Araniko|अरनिको
Sanjay Leela Bhansali|सञ्जय लीला भन्साली
Siddharth Anand|सिद्धार्थ आनन्द
Ernst Stojaspal|Ernst Stojaspal
Masayoshi Son|मसायोशी सोन
Babur|बाबर
Boman Irani|बोमन इरानी
Sonu Kakkar|सोनू कक्कड़
Sunil Shetty|सुनील शेट्टी
Johnny Lever|जोनी लिवर
Geeta Phogat|गीता फोगाट
Bhim Shamsher Jang Bahadur Rana|भिम शमशेर जङ्गबहादुर राणा
Prabhu Deva|प्रभु देवा
Divyanka Tripathi|दिव्यंका त्रिपाठी
Sharman Joshi|शर्मन जोशी
Prakash Padukone|प्रकाश पादुकोण
Sushma Swaraj|सुषमा स्वराज
Najma Heptulla|नजमा हेपतुल्ला
Raveena Tandon|रवीना टन्डन
Bhuvneshwar Kumar|भुवनेश्वर कुमार
K. S. Chithra|के॰ एस॰ चित्रा
Sana Saeed|साना सईद
Richard Lee Steele|राभन रिले
Shiv Chowrasia|शिव चौरसिया
Durvasa|दुर्वासा
Carmel Moore|कार्मेल मूरे
Olivia Palermo|ओलिभिया पलेर्मो
Tristram Stuart|ट्रिसट्रयाम स्टुअर्ट
Hari Khadka|हरि खड्का
Zoe Voss|जो वोश
Mahima Chaudhry|महिमा चौधरी
Nicole Faria|निकोल फारिया
Anil Gurung|अनिल गुरुङ
Amrita Singh|अमृता सिंह
Gul Panag|गुल पनाग
Keeani Lei|कियानी लेइ
Erika Bella|एरिका बेला
Ankita Lokhande|अंकिता लोखन्डे
Romila Thapar|रोमिला थापर
Peaches|पिचेज
Alok Nath|आलोक नाथ
Anurag Kashyap|अनुराग कश्यप
Casey Parker|क्यासी पार्कर
Jagat Gosain|जगत गोसाई
Michelle Maylene|मिचेल्ले मेलेन
Lexie Marie|लेक्सी मारिया
Dasha|दशा
Deepak Tijori|दीपक तिजोरी
Udita Goswami|उदिता गोस्वामी
Jun Kusanagi|जुन कुसानगी
Leena Khamis|लिना खामिस
Kazuko Shirakawa|काजुको शिराकावा
Jessica Bangkok|जेसिका ब्याङ्कक
Alenush Terian|एलेनुस तेरियन
Tyler Faith|टेलर फेथ
Eva Vortex|इभा भर्टेक्स
Peggy Oki|पेगी ओकी
Juan de Arespacochaga|Juan de Arespacochaga
Rajendra Mahato|राजेन्द्र महतो
Bala|बाला
Sundar Pichai|सुन्दर पिचाई
Ramya Krishnan|रम्या कृष्णन
Raman Singh|रमन सिंह
Rajdeep Sardesai|राजदीप सरदेसाई
Anuradha Koirala|अनुराधा कोइराला
Ramesh Pokhriyal|रमेश पोखरियाल
Richa Gangopadhyay|रिचा गंगोपाध्याय
Vishal|विशाल
Neetu Chandra|नीतू चन्द्रा
Lucky Ali|लकी अली
Shatrughan Sinha|शत्रुघ्न सिन्हा
Ashish Vidyarthi|आशीष विद्यार्थी
Gautami Tadimalla|गौतमी
Charmy Kaur|चार्मी कौर
Bethany Benz|बेथानी बेन्ज
Renu Khator|रेणु खाटोर
Shriram Lagoo|श्रीराम लागू
Shruti Seth|श्रुति सेठ
Elīza Tīruma|Elīza Tīruma
Shweta Bhardwaj|स्वेता भारद्वाज
Aarthi Aggarwal|आरती अग्रवाल
Kayla Carerra|कायला क्यारेरा
Pranitha Subhash|प्रणिता सुभाष
Fatte Jang Shah|फत्तेजंग शाह
Amara|अमारा
Veronica Avluv|भेरोनिका अभ्लभ
Aamir Ali|आमिर अली
Acharya Mahasharman|महाश्रमण
Aditya Jha|आदित्य झा
Aditya Narayan|आदित्य नारायण
Ali Abbas Zafar|अली अब्बास जफर
Aman Verma|अमन वर्मा
Amy Sky|एमी स्काई
Arjun Karki|अर्जुन कार्की
Baburam Acharya|बाबुराम आचार्य
Basanta Regmi|बसन्त रेग्मी
Bimal Jalan|बिमल जालान
Dada Lekhraj|दादा लेखराज
Dee|डी
Dilras Banu Begum|दिलरस बानो बेगम
Ek Nath Dhakal|एक नाथ ढकाल
Gautam Gulati|गौतम गुलाटी
Gopal Yonjan|गोपाल योञ्जन
Heena Sidhu|हिना सिद्धू
Mufti Mohammad Sayeed|मुफ्ती मोहम्मद सईद
Jagjit Shrestha|जगजित श्रेष्ठ
James Braid Taylor|जेम्स ब्रेड टेलर
Jasmin Bhasin|जैस्मिन भसीन
Ram Dulari Sinha|राम दुलारी सिन्हा
Kabir Khan|कबीर खान
Kamya Panjabi|काम्या पंजाबी
Kayla Marie|कायला मारिया
Kristina Akheeva|क्रिस्टिना अखिवा
Leila Seth|लीला सेठ
Leilani Leeane|लेलानी लीयन
Lisa Haydon|लिजा हेडन
Manini Mishra|मानिणी मिश्रा
May-Britt Moser|मे ब्रिट मोजर
Meera Shankar|मीरा शङ्कर
Mehbooba Mufti|महबुबा मुफ्ती
Melina Manandhar|मेलिना मानन्धर
Mukti Mohan|मुक्ति मोहन
Nandamuri Balakrishna|नन्दमुरी बालकृष्ण
Neha Pendse|नेहा पेन्डसे
Sarah McLaughlin|सराह म्याकलग्लिन
Nisha Adhikari|निशा अधिकारी
Nitin|नितिन
Om Birla|ओम बिड़ला
P. C. Bhattacharya|पिसी भट्टाचार्य
Parvathy Thiruvothu|पार्वती थिरुवोथु
Preeti Shenoy|प्रीति शिनोय
Priyanka Bassi|प्रियङ्का बस्सी
Queen Tripurasundari|ललित त्रिपुरा सुन्दरी
Rabin Shrestha|रविन श्रेष्ठ
Rambriksh Benipuri|रामवृक्ष बेनीपुरी
Ravi Dubey|रवि दुबे
Ravish Kumar|रवीश कुमार
Rubina Dilaik|रुबिना दीलैक
Upendra|उपेन्द्र
Saadhika Randhawa|साधिका रंधावा
Salim Khan|सलीम खान
Sarbananda Sonowal|सर्बानन्दा सोनवाल
Sharad Vesawkar|शरद भेसवाकर
Shivani Surve|शिवानी सुर्वे
Shobha Kapoor|शोभा कपूर
Shoma Chaudhury|शोमा चौधरी
Simran Kaur Mundi|सिमरन कौर मुन्डी
Sofia Hayat|सोफिया हयात
Sudha Shah|सुधा शाह
Sundeep Kishan|सन्दीप किशन
Sunil Narine|सुनिल नारायण
Swaroop Sampat|स्वरूप सम्पत
Tasha Reign|ताशा रेगन
Sabrina Ho|सबरिना हो
Urvashi Sharma|उर्वशी शर्मा
Usha Kiran|ऊषा किरण
Usha Nadkarni|उषा नाडकर्णी
Vishnu Manchu|मान्चू विष्णु
Yashpal Sharma|यशपाल शर्मा
Yasir Shah|यासिर शाह
Sujoy Ghosh|सुजोय घोश
Manish Pandey|मनीष पाण्डे
Heather Lynn|हिथर लेन
Bonnie Rotten|बोंनी रोटन
Deepika Samson|दीपिका स्यामसन
Kabir Suman|कबीर सुमन
Malouma|मलौमा
Kamran Mirza|कामरान मिर्जा
Jeahangir Ghandy|जहाँगीर घांडी
Zeba Bakhtiar|जेबा बख्तियार
Poola Tirupati Raju|पूला तिरुपति राजु
Manoj Joshi|मनोज जोशी
Bhupatindra Malla|भूपतीन्द्र मल्ल
Bhairav Aryal|भैरव अर्याल
Mahanth Thakur|महन्थ ठाकुर
Jiwan Luitel|जीवन लुइटेल
Pedrito Martinez|Pedrito Martínez
Beena Banerjee|बीना बनर्जी
Rolene Strauss|रोलेन स्ट्राउस
Banira Giri|बानिरा गिरी
Methil Devika|मेथिल देविका
Sasha Agha|साशा आगा
Harsimrat Kaur Badal|हरसिमरत कौर बादल
Bidya Devi Bhandari|विद्या देवी भण्डारी
Neelam Saxena Chandra|नीलम सक्सेना चन्द्रा
Urvashi Chaudhary|उर्वशी चौधरी
Ragini Nandwani|रागिनी नन्दवानी
Fatima Sana Shaikh|फातिमा सना शेख
Ravish Desai|रविश देसाई
Resham Tipnis|रेशम टिपनिस
Divya Khosla Kumar|दिव्या खोसला कुमार
Gunn Kansara|गुण कन्सरा
Sompal Kami|सोमपाल कामी
Surbhi Jyoti|सुरभि ज्योति
Usha Kiran Khan|उषा किरण खान
Susanna Amatuni|सुजेना अमातुनी
Umang Jain|उमङ्ग जैन
Neeta Dhungana|नीता ढुङगाना
Hem Bahadur Singh|हेमबहादुर सिंह
Gautami Kapoor|गौतमी कपूर
Saugat Malla|सौगात मल्ल
Keki Adhikari|केकी अधिकारी
Garima Panta|गरिमा पन्त
Praneet Bhat|प्रनीत भट्ट
Abhi Subedi|अभि सुवेदी
Amaal Mallik|अमाल मलिक
Ranu Devi Adhikari|रानुदेवी अधिकारी
Bhumi Pednekar|भूमि पेडनेकर
Aastha Pokharel|आस्था पोखरेल
Bacchu Kailash|बच्चु कैलाश
Heman Yatri|हेमन यात्री
Aditi Arya|अदिति आर्य
Anupama Parameswaran|अनुपमा परमेस्वरन
|उदय नारायण सिंह नचिकेता
Umanath Jha|उमानाथ झा
Mahendar Misir|महेंदर मिसिर
Yashodhar Jha|यशोधर झा
|रमेश नारायण
|रमेश रंजन
|राम दयाल राकेश
Shephalika Varma|शेफालिका वर्मा
|श्वेता झा चौधरी
Ishita Dutta|इशिता दत्ता
Dhir Shamsher Rana|धीर शमशेर राणा
Tika Bhandari|टीका भण्डारी
Avani Modi|अवानी मोदी
Piya Sengupta|पिया सेनगुप्ता
Prince Narula|प्रिन्स नरूला
Ashishma Nakarmi|अशिष्मा नकर्मी
Nikola Tvrtković|Nikola Tvrtković
Akhil Akkineni|अखिल अक्किनेनी
Arpan Thapa|अर्पण थापा
Nadia Murad Basee|नाडिया मुराद
Nawayug Shrestha|नवयुग श्रेष्ठ
Satarupa Pyne|सतरुपा पायने
Janhvi Kapoor|जाह्नवी कपूर
Jubin Nautiyal|जुबिन नौटियाल
Manoj Muntashir|मनोज मुन्ताशिर
Raj Tarun|राज तरुण
Gaurika Singh|गौरिका सिंह
José María Mendoza Ussía|José María Mendoza Ussía
Nivetha Pethuraj|निवेथा पेथुराज
Trivendra Singh Rawat|त्रिवेन्द्र सिंह रावत
Dharti Bhatt|धर्ती भट्ट
Peter Schuchert|Peter Schuchert
Shama Bhate|शमा भाटे
|संयम पुरी
|रीया श्रेष्ठ
|रिस्ता वस्नेत
|सुशील सिटौला
Ayyasamy Dharun|अय्यासामी धरुण
Kheta Ram|खेता राम
Niti Shah|नीति शाह
Kul Man Ghising|कुल मान घिसिङ्ग
Narayan Rayamajhi|नारायण रायमाझी
Neri Thapa|नेरी थापा
José López Zanón|José López Zanón
Juan de Haro Piñar|Juan de Haro Piñar
Heman Gurung|हेमन गुरुङ
Bhuvan Bam|भुवन बाम
Radharaman Mitra|राधारमण मित्र
Bikram Bahadur Thapa|विक्रम बहादुर थापा
Binod Shrestha|विनोद श्रेष्ठ
Shanno Devi|शन्नो देवी
Chand Usmani|चाँद उस्मानी
Giovanni Battista Tocci|Giovanni Battista Tocci
Gaston Lecreux|Gaston Lecreux
Rodrygo|रोजड्रिगो सिल्वा डे गो
Anjana Tamli|अञ्जना ताम्ली
Urmila Devi Sah|उर्मिला देवी शाह
Tara Kant Chaudhary|तारा कान्त चौधरी
Ramani Ram|रमणी राम
Krishna Kumari|कृष्णा कुमारी
Ranajana Kumari Sarkar|रन्जना कुमारी सरकार
Ram Janam Chaudhary|राम जनम चौधरी
Lalbabu Prasad Yadhav|लालवावु प्रसाद यादव
Parbart Gurung|पार्वत गुरुङ
Asha B. K.|आशा वि. क.
Kamala Kumari Ghimire|कमला कुमारी घिमिर
Rekha Sharma|रेखा शर्मा
Nar Bahadur Chand|नर बहादुर चन्द
Nagendra Prasad Tharu|नागेन्द्र प्रसाद थारु
Lal Bahadur Rawal|लाल बहादुर रावल
Pawan Kunwar Saradaa|पवन कुमार शारडा
Puskar Acharya|पुष्कर आचार्य
Sarada Kumari Bishwakarma|शारदा कुमारी विश्वकर्मा
Laharkyal Lama|डा. ल्हारक्याल लामा
Babina Moktan Lawati|वविना मोक्तान लावती
Kunti Kumari Shahi|कुन्ती कुमारी शाही
Sushil Koirala|शुसिल कोइराला
Sushila Chaudhari|शुसिला चौधरी
Sushila Nepal|शुसिला नेपाल
Keshab Kumar Budhathoki|केशब कुमार बुढाथोकी
Keshari Gharti Magar|केशरी घर्ति मगर
Sita Gurung|सिता गुरुङ्ग
Sitaram Bhandari|सीताराम भण्डारी
Krishna Bhakta Pokhrel|कृष्णभक्त पोख्रेल
Krishna Dhital|कृष्ण धिताल
Gokul Prasad Gharti|गोकुल प्रसाद घर्ती
Pemba Gurung|पेम्बा गुरुङ्ग (भोटे)
Chandra Bhndari|चन्द्र भण्डारी
Sita Nepali|सीता नेपाली
Sita Luitel|सीता लुइटेल (ज्ञवाली)
Buddhi Sagar Chaudhari|बुद्धी सागर चौधरी
Aakash Thapa|आकाश थापा
Samshad Sheikh|सम्षद शेख
Sonu Tamang|सोनु तामाङ
Kishor Mahato|किशोर महतो
Bikram Sob|बिक्रम सोब
Sarita Magar|सरिता  मगर
Sita Magar|सिता मगर
Mamta Thapa|ममता थापा
Shreya Khadka|श्रेया खड्का
Nebika Chaudhary|नेबिका चौधरी
Manju Gurung|मंजु गुरुङ
Chuda Kumari Khadka|चुडा कुमारी खड्का
Elnaaz Norouzi|एलनाज नोरौजी
Suhana Thapa|सुहाना थापा
Jagadhiswor Narsignh K.C|जगदिश्वर नरसिंह के.सी
Gail Bradbrook|गाएल ब्राडब्रुक
Trishala Gurung|त्रिशला गुरुङ
Tulsi Bhagat|तुलसी भगत
Lucy Gray|लुसी ग्रे
Pratima Sherpa|प्रतिमा शेर्पा
Gauri Narayan Shah Teli|गौरी नारायण साह तेली
Hima Devi Joshi|हिमा देवी जोशी
Asiya Devi Tharuni|असिया देवी थरुनी
Paras Prasad Shah|पारस प्रसाद शाह
Pramila Devi Das|प्रमिला देवी दास
Noga Levy-Rapoport|नोगा लेभी-रापोपोर्ट
Licypriya Kangujam|लिसीप्रिया कानगुजाम
Bonita Sharma|बोनिता शर्मा
Santoshi Shrestha|सन्तोषी श्रेष्ठ
Li Wenliang|ली वेन लियाङ्
Garima Chaurasia|गरिमा चौरासिया
Luciano Méndez|Luciano Méndez
Prem Man Chitrakar|प्रेममान चित्रकार
Alekss Krasts|Alekss Krasts
Panagiotis Christopoulos-Cheller|Panagiotis Christopoulos-Cheller
Anastasios Kourmpetis|Anastasios Kourmpetis
Neftali Martinez|Neftali Martinez
Julie Hutsebaut|Julie Hutsebaut
Marina Khodchenkova|Marina Khodchenkova
Clarissa Breuer|Clarissa Breuer
Alena Popadova|Alena Popadova
Caroline Orens|Caroline Orens
Elisa Neri|Elisa Neri
Negringa Raudonite|Negringa Raudonite
Laurence Restoin|Laurence Restoin
Deborah Geentjens|Deborah Geentjens
Delphine Deschamps|Delphine Deschamps
Marie Kolarikova|Marie Kolarikova
Natascha Klewitz|Natascha Klewitz
Jozef Hušla|Jozef Hušla
Krists Lindenblats|Krists Lindenblats
Jung Hyun-woo|Jung Hyun-woo
Dominic Meinel|Dominic Meinel
