George Washington|जार्ज वाशिंगटन
George W. Bush|जार्ज डबल्यु बुश
Nicolaus Copernicus|निकोलस् कपरनिकस्
Plato|प्लातोन्
Narendra Modi|नरेन्द्र मोदी
Indira Gandhi|इन्दिरा गान्धिः
Kofi Annan|कोफी अन्नान
Osama bin Laden|ओसामा बिन् लाडेन्
Jacques Chirac|ज्याक शिराक
Wilhelm II|कैसर विल्हेम द्वितीय
Mao Zedong|माओ त्से-तुंग
Hebe Camargo|हेबे कामार्हो
Marie Curie|मेरी क्युरी
Sophocles|सोफोक्लेस
Dorothy Hodgkin|डारोति क्रोफट् हाज्किन्
Ingmar Bergman|इंगमार बर्गमान
Constantine the Great|कान्स्टण्टैन १
Peter the Great|पीटर महान
Archimedes|आर्किमिडीस्
Augustin-Louis Cauchy|कोषि अगस्टीन् लूयी
Muhammad|मुहम्मद्
A. P. J. Abdul Kalam|अब्दुल् कलामः
Salman Rashid Khan|सलमान खान
Martin Luther|मार्टिन लूथर
Harivansh Rai Bachchan|हरिवंश राय बच्चन
Tom Cleverley|टॉम क्लेवेर्ली
Thomas Jefferson|थामस् जेफरसन्
Émile Durkheim|ईमिली डर्खीम
Steve Jobs|स्टीव जाब्स
Hayam Wuruk|हयाम वुरुक
Malala Yousafzai|मलाला युसुफजई
Alexander Graham Bell|अलेग्झाण्डर् ग्रहां बेल्
Benjamin Franklin|बेंजामिन फ्रैंकलिन
Alexander Fleming|सर् अलेक्साण्डर् प्लेमिङ्ग्
Robert Koch|राबर्ट् कोख्
Helen Keller|हेलेन केलर
Edward Jenner|एड्वर्ड् जेन्नर्
Eva Perón|एवा पेरोन
Martin Scorsese|मार्टिन स्कोर्सेसे
Rosa Parks|रोजा पार्क्स
Ivan Pavlov|इवान् पेत्रोविच् पाव्लोव्
Antoni van Leeuwenhoek|अन्तोन् वान् ल्यूवेन् वोक्
Sitting Bull|बैठा बैल
Rudolf Mössbauer|रुडोल्फ मोसबेउर
Hans Christian Ørsted|हान्स कृस्टियन ओर्स्टेड
Behramji Malabari|बेहरामजी मलबारी
Robert Hooke|राबर्ट् हुक्
Leni Riefenstahl|लेनी रीफेन्स्टाल
Shreedhar Swami|श्रीधरस्वामिनः
Max von Laue|माक्स भोन् लु
Milarepa|मिलरेप
Caspar Friedrich Wolff|फ्रेडरिक क्यास्पर् वुल्फ्
Ajmal Kasab|अज्मल् कसब्
Abdurrahman Wahid|अब्दुर्रहमान वाहिद
J. Hans D. Jensen|जे हान्स डी जेन्सेन
Madhu Sudan|मधु सूदन
Luci van Org|लुसि वन् ओर्ग्
Mirza Ghalib|मिर्जा गालिब
Anne of Great Britain|एन
Krishnadevaraya|कृष्णदेवरायः
Charles II of England|चार्ल्स २
Charles Édouard Guillaume|चार्ल्स एडुआर्ड गुइल्लौमे
Steve Irwin|Steve irwin
Albert A. Michelson|अल्बर्ट ए मिकेल्सन
George II of Great Britain|जार्ज २
Sania Mirza|सानिया मिर्ज़ा
Nawaz Sharif|नवाझ् शरीफ्
James V of Scotland|जेम्स ५
Zacharias melotocas|जकारियस् जान्सन्
Norman Borlaug|नार्मन् बोर्लाग्
Louis Néel|लुइ नील
Eugene Wigner|यूजीन विग्नर
Russell Alan Hulse|रसेल ए हल्से
Kirron Kher|किरण खेर
John Napier|जाह्न नापियर्
Edward Gibbon|एडवार्ड गिबन
Lady Jane Grey|जेन
William Shockley|विलियम शाक्ली
Javier Hernández|जेवियर् हर्नाण्डेज्
Carl David Anderson|कार्ल डी एन्डरसन
Andreas Vesalius|आण्ड्रियेस् वेसेलियस्
Bāṇabhaṭṭa|बाणभट्टः
Pyotr Kapitsa|प्योट्र कापिट्सा
Ramakrishna|श्रीरामकृष्णपरमहंसः
Edward Mills Purcell|इ एम पर्सेल
Walter Houser Brattain|वाल्टर एच ब्राट्टेन
Jerome Isaac Friedman|जेरोम आइ फ्रीदमन
Danny Welbeck|डैनी वेल्बेक
Kenneth G. Wilson|केनेथ जी विल्सन
Hariprasad Chaurasia|हरिप्रसादः चौरासिया
René Laennec|आर् लेनेक् मानारल्
Bhimrao Ramji Ambedkar|बि.आर्.अम्बेड्करः
Madhuri Dixit|माधुरी दीक्षित्
Atal Bihari Vajpayee|अटलबिहारीवाजपेयी
Elizabeth Blackwell|एलिजबेत् ब्ल्याक्वेल्
Lal Bahadur Shastri|लालबहादुरशास्त्री
Anders Lindegaard|ऐन्डर्स लिनडेगार्ड
Kasturba Gandhi|कस्तूरबा
Tirumalai Krishnamacharya|टी.के.वी. देसिकाचार
Charaka|चरकः
Dharamvir Bharati|धर्मवीर भारती
Bimbisara|बिम्बिसारः
Fakhruddin Ali Ahmed|फखरुद्दीन अली अहमद
Jamsetji Tata|जमशेतजी टाटा
Atisha Dipankara|अतिश
Abhimanyu|अभिमन्युः
Satish Dhawan|सतीश धवन
Mary Kom|मेरी कोम्
Shruti Haasan|श्रुति हासन
Nazrul Islam|काजी नज़रुल् इस्लाम्
Lokaksema|Lokakṣema
Motilal Nehru|मोतीलालनेहेरुः
Azim Premji|अजीम प्रेमजी
Mangal Pandey|मङ्गल पाण्डेयः
Akshaye Khanna|अक्षयखन्ना
Guru Amar Das|गरु अमर दास
Candrakīrti|Candrakīrti
Saina Nehwal|सैना नेह्वाल्
Mahadevi Varma|महादेवी वर्मा
Noor Jehan|नूरजहान्
Vijay Amritraj|विजय् अमृत् राज्
Ali Akbar Khan|अलि अक्बर् खानः
Karunanidhi|करुणानिधिः
Edward Balliol|एडवर्ड बालियोल
Anthony Mackie|एंथनी मैकी
Muna AbuSulayman|ंउन आबुशुलय्मन्
Śāntarakṣita|Śāntarakṣita
B. K. S. Iyengar|बी.के.एस. अयंगार
M. F. Husain|मकबूल फिदा हुसेन
Edward VIII|एडवर्ड ८
Pulakeshin II|द्वितीयपुलिकेशिः
U. R. Ananthamurthy|यु.आर्.अनन्तमूर्तिः
Prince Rahotep|राजकुमार रहोटेप
Chandragupta II|द्वितीयः चन्द्रगुप्तः
Peter Stern|पीटर स्टर्नः
Parameshvara|परमेश्वर
Ramesh Krishnan|रमेशकृष्णन्
Chintamani Nagesa Ramachandra Rao|सि एन् आर् राव्
Jayachamarajendra Wadiyar|महाराज जयचामराजेन्द्र वडियर्
Yajnavalkya|याज्ञवल्क्यः
Hyder Ali|हैदर अली
Sugriva|सुग्रीवः
Rohini Devi|रोहिणी
Rik Janssen|रिक् जन्सेन् दच्च राजकारिणः वार्तिकः च आसीत्
Tom Holland|टॉम हॉलेंड
P. Susheela|पि. सुशीला
Manoj Kumar|मनोजकुमारः
Vallabha Acharya|वल्लभाचार्यः
Bhavyaviveka|Bhavyaviveka
Mukesh|मुकेशः
Sangamitta|सङ्गमित्रा
Baji Rao I|बाजीराव
John Coape Sherbrooke|जोह्न् कोपे षेर्ब्रोओके
Bharatendu Harishchandra|भारतेन्दु हरिश्चन्द्र
Śuka|शुकमुनिः
Ashtavakra|अष्टावक्रः
Hemachandra|हेमचन्द्रः
Narsinh Mehta|नरसिंहमहेता
Kalapi|कलापी
Sambhaji Bhosale|सम्भाजी
Domingo Ram y Lanaja|दोमिङ्गो  राम  य  लनज
Tribhuvandas Kishibhai Patel|त्रिभुवनदास् पटेल्
Deepakbhai P. Mehta|दीपकभाई प्र महेता
M. Balamuralikrishna|बालमुरलीकृष्णः
Bodhisena|बोधिसेन
Karim Findi|करीम फेंडी
Somadeva|सोमदेवः
Danny Cuomo|देन्नि कुओमो
Danny Dhondt|देन्नि धोन्ड्ट्
Debendranath Tagore|देवेन्द्रनाथ ठाकुरः
Paresh Rawal|परेश रावल
Shivraj Singh Chauhan|शिवराज सिंह चौहान
Kshemaraja|क्षेमराज
Ashok Chavan|अशोक चव्हाण
Nārāyaṇa Bhaṭṭa|भट्ट्नारायणः
Benegal Rama Rau|बेनगल् रामरावः
Nagarjun|नागार्जुनः
Saroj Khan|सरोज खान
Soundarya|सौन्दर्या
Nitin Gadkari|नितीनगडकरी
Arun Shourie|अरुण शौरी
Sucheta Kripalani|सुचेता कृपलाणी
Mohan Bhagwat|मोहनरावभागवत
Mirabehn|मेडलीन स्लेड
Irawati Karve|इरावती कर्वे
Dattopant Thengadi|दत्तोपन्त ठेङ्गड़ी
Sri Lal Sukla|श्रीलाल शुक्ल
Balaji Baji Rao|बाजीराव
Krishna Sobti|कृष्णा सोबती
Rajeev Srinivasan|राजीव श्रीनिवासन्
Kapila Vatsyayan|कपिला वात्स्यायनः
Kalyan Singh|कल्याणसिंह
Elene Akhvlediani|एलिन् अख्वेलेदानी
Malik Ayaz|मलिक  आयश्
Kshemendra|क्षेमेन्द्रः
|बुद्धगुप्तनाथ
Ravindra Prabhat|रवीन्द्रप्रभातः
Mukunda Goswami|मुकुन्द गोस्वामी
Ebrahim Alkazi|इब्रहिम् अल्काज़्ई
Abhijit Mukherjee|अभिजीत मुखर्जी
Akhandanand|स्वामी अखण्डानन्द सरस्वती
Alia Bhatt|आलिया भट्ट
B. Sriramulu|बी॰ श्रीरामुलु
Badarayana|बादरायणः
Bishnu Pada Ray|विष्णु पद राय
Chandrakant Raghunath Patil|सी आर पाटिल
Chinna Jeeyar Swamy|चिन्नजीयरः स्वामी
Narasimhagupta|नरसिंहगुप्तः बालादित्यः
Deepika Chikhalia|दीपिका चिखलिया
Dewang Mehta|देवांग मेहता
Bhatt Mathuranath Shastri|भट्ट मथुरानाथशास्त्री
Gubbi Veeranna|गुब्बिवीरण्णः
Har Dayal|लाला हरदयालः
Ram Vilas Paswan|रामविलास पासवान
Maha Sawa|महासवा
Rudravarman I|रुद्रवर्मन् १
Jayshreeben Patel|पटेल जयश्रीबेन कनुभाई
Jitendra Singh|जितेन्द्र सिंह
K. Kavitha|कलवाकुन्ट्ल कविता
K. N. Ramchandran|के॰एन॰ तिरु रामचन्द्रन
Kamla Devi Patle|कमला देवी पटले
Keshav Das|keshav das
Kristappa Nimmala|क्रिस्टप्पा निम्मला
Cūḍa-panthaka|Cūḍapanthaka
M. Thambi Durai|एम॰ तंबीदुरै
Madhu Sapre|मधु सप्रे
Mahīdhara|महीधरः
Mohan Kundariya|मोहन कुन्दरिया
Mugdha Godse|मुग्धा गोडसे
Narendra Singh Tomar|नरेन्द्र सिंह तोमर
Om Prakash|ओम प्रकाश
Ponnusamy Venugopal|पी॰ वेणुगोपाल
Panangkaran|पनङ्गकरण
Pappu Yadav|पप्पू यादव
Pashupati Nath Singh|पशुपतिनाथ सिंह
Raghunath Anant Mashelkar|रघुनाथ अनंत माशेलकर
Rangasami L. Kashyap|रङ्गस्वामी कश्यपः
Yamini Krishnamurthy|यामिनी कृष्णमूर्तिः
Sanjay Shamrao Dhotre|संजय शामराव धोत्रे
Sarala Devi Chaudhurani|सरलादेवी चौधरी
Sona Ram|कर्नल सोनाराम
Sudarshan Bhagat|सुदर्शन भगत
Tathagata Satapathy|तथागत सत्पथी
Thangso Baite|थांगसो बाइते
Thokchom Meinya|डॉ. थोकचोम मेइन्या
Udit Raj|उदित राज
Usman Harooni|उस्मान हारूनी
Venkatamakhin|वेङ्कटमखी
Viswanatha Kaviraja|विश्वनाथः
S. V. Ranganna|एस्.वी.रङ्गण्णः
K. N. Ezhuthachan|के।एन्।एषुत्तच्छन
|Uruvela-Kassapa
Gayaa-Kassapa|Gayaa-Kassapa
|हरिवर्मन्
Jaya Sinhavarman II|जयसिंहवर्मन् २
|डेविड १
P. C. Mohan|पी. सी. मोहन
Rudravarman II|रुद्रवर्मन् २
Balkrishna Sama|बालकृष्ण सम
A. T. Patil|अशोक तापीराम पाटील
Rani Velu Nachiyar|वेलु नाच्चियार्
Rama Devi|रमा देवी
|जयंत नारळीकर
Asaga|यावत्सञ्जायते किञ्चित्...
|स्वामी हीरादासः
Kirit Premjibhai Solanki|किरीट प्रेमजीभाई सोलंकी
Ram Shankar Katheria|राम शंकर
Kriti Sanon|कृति सैनॉन
Laxman Giluwa|लक्ष्मण गिलुवा
Chintaman Vanaga|चिंतामन वनगा
G. Nagesh|जी॰ नागेश
Upendra Kushwaha|उपेन्द्र कुशवाहा
Narendra Keshav Sawaikar|नरेंद्र केशव सवाइकर
Ramdas Tadas|रामदास तडस
Pusapati Ashok Gajapati Raju|अशोक गजपति राजू पूसपाटि
Joice George|जोइस जॉर्ज
Mahesh Sharma|महेश शर्मा
A. P. Jithender Reddy|एपी जितेन्दर रेड्डी
Balka Suman|बाल्का सुमन
Butta Renuka|बुट्टा रेणुका
Ch Malla Reddy|च मल्ला रेड्डी
Dharambir|धरमबीर
K C Patel|के॰सी॰ पटेल
Kapil Krishna Thakur|कपिल कृष्ण ठाकुर
Konda Vishweshwar Reddy|कोंडा विश्वेश्वर रेड्डी
Arka Keshari Deo|अरका केशरी देव
Radheshyam Biswas|राधेश्याम बिस्वास
Rammohan Naidu Kinjarapu|राममोहन एन किंजरपु
Hemendra Chandra Singh|हेमेन्द्र चन्द्र सिंह
Badaruddoza Khan|बद्रुद्दोज़ा खान
Daddan Mishra|दद्दन मिश्रा
Pushpendra Singh Chandel|कुंवर पुष्पेन्द्र सिंह चंदेल
Rahul Kaswan|राहुल कासवान
Rajesh Pandey|राजेश पाण्डे
Ramcharan Bohara|रामचरण बोहरा
Ravindra Kushawaha|रविन्द्र कुशवाहा
Chandra Prakash Joshi|चन्द्रप्रकाश जोशी
Shrikant Shinde|श्रीकांत शिंदे
Krupal Tumane|कृपाल तुमाने
Umakant Gundecha|उमाकांत गुंडेचा
V. Pannerselvam|वी॰ पन्नीरसेल्वम
R. Gopalkrishnan|आर॰ गोपालकृष्णन
K. Parasuraman|के॰ परसुरमन
S. Rajendran|एस॰ राजेन्द्रन
N. Ranganatha Sharma|रङ्गनाथशर्मा
Sharad Tripathi|शरद त्रिपाठी
Mahesh Sanskrit Gurukul|महेश संस्कृत गुरुकुल
Villy Aellen|Villy Aellen
Rasika Dugal|रसिका दुग्गल
Shyam Lal Gupta|श्यामलालगुप्ता
Manuel Martínez Chumillas|Manuel Martínez Chumillas
Ángel Cadarso del Pueyo|Ángel Cadarso del Pueyo
Bijay Biswaal|बिजय बिश्वाल
Anjali Raghav|अंजली राघव
Akshobhya Tirtha|अक्षोभ्यतीर्थः
Shilabhattarika|शीला भट्टारिका
Max Müller|माक्स् मुल्लरः
Orso Orsini|Orso Orsini
Abhinandan Varthaman|अभिनन्दनः वर्धमानः
Manjulata Mandal|मंजुलता मण्डल
Bharadwaaja|भरद्वाजः
Vallabbhadeva|वल्लभदेवः
Fanny Vaucher|Fanny Vaucher
Kate Sayer|Kate Sayer
Anna Kulikova|Anna Kulikova
Jean-Pierre Lloyd|Jean-Pierre Lloyd
Areke Hassink|Areke Hassink
Paula Fedirchuk|Paula Fedirchuk
Claudia Migliorini|Claudia Migliorini
Sylvia Debboudt|Sylvia Debboudt
Miranda De Permentier|Miranda De Permentier
Aurélie Anaise|Aurélie Anaise
Gulnara Fatkullina|Gulnara Fatkullina
Mirza Nikolajev|Mirza Nikolajev
Elīna Ieva Vītola|Elīna Ieva Vītola
Kyle Murray|Kyle Murray
Stefan Kiefer|Stefan Kiefer
Prashant Mohapatra|प्रशांत महापात्र
Socrates|सुकरात
Rajiv Gandhi|राजीवगान्धिः
Hippocrates|हिप्पाक्रटीस्
Novak Djokovic|नोवाक् जोकोविक्
Kalidasa|कालिदासः
Rosa Luxemburg|रोजा लक्जेम्बर्ग
Darshan Ranganathan|दर्शन् रङ्गनाथन्
Akbar|अक्बरः
Kwame Nkrumah|क्वामे एन्क्रूमाह
Johannes Gutenberg|योहान गुटेनबर्ग
Max Planck|माक्स प्लान्क
Thomas Aquinas|थामस एक्विनास
Ronald Reagan|रोनाल्द रेगन
Rafael Nadal|राफेल् नडाल्
Harry S. Truman|हैरी ट्रूमन
Stephen Hawking|स्टीफन् हाकिङ्ग्
Herodotos|हेरोडोटस
Bhavabhūti|भवभूतिः
Hema Malini|हेमा मालिनी
Hammurabi|हाम्मुरबी
Attila|अटिला
William the Conqueror|विलियम १
Gregor Mendel|ग्रिगोर् जान् मेण्डेल्
Richard Feynman|रिचार्ड फैनमन
Averroes|आवेरोस्
Hendrik Lorentz|हेण्ड्रिक लारेन्ज़
Bernhard Riemann|बर्न्हार्ड रीमन
Salman Rushdie|सलमान रश्दी
Pierre-Simon Laplace|पियर सिमों लाप्लास
Suharto|सुहार्तो
Satyendra Nath Bose|सत्येन्द्रनाथ बसु
Swami Vivekananda|स्वामी विवेकानन्दः
Euripides|युरिपिडीस
Park Ji-sung|जी-सुंग पार्क
Philipp Lenard|फिलिप लेनार्ड
Ferdinand Braun|कार्ल् फर्डिनाण्ड् ब्रौन्
Johannes Stark|जोहन्नेस स्टार्क
Rajinikanth|रजनिकान्तः
Bal Thackeray|बालासाहव ठाकरे
Bacharuddin Jusuf Habibie|यूसुफ हबीबी
Wolfgang Ketterle|वुल्फगांग केट्टेर्ले
Guru Nanak|गुरुनानकः
Paracelsus|पारासेल्सस्
Subhash Kak|सुभाषकाकः
Francis William Aston|आस्टन् फ्रान्सिस् विलियम्
Aage Niels Bohr|आजे एन बोह्र
Vitaly Ginzburg|वितली गिन्ज़बर्ग
Frank Wilczek|फ्रान्क विल्चेक
George I of Great Britain|जार्ज १
Maria Theresa of Austria|मारिया टेरेसा
Satsvarupa dasa Goswami|सत्स्वरूप दास गोस्वामी
George Carlin|जार्ज् कार्लिन्
Hans Bethe|हान्स बेथे
Lata Mangeshkar|लता मङ्गेशकरः
Samuel Hahnemann|साम्युयेल् हानिमन्
Dara Singh|दारासिङ्गः
Owen Willans Richardson|ओवेन विलेन्स् रिचार्डसन
O. Henry|ऒ हेन्री
Emilio G. Segrè|एमिलियो सेग्र
Gabriele Falloppio|गाब्रियोलो फालोपियस्
Jiddu Krishnamurti|जिद्दु कृष्णमूर्ति
George F. Smoot|जोर्ज एफ स्मूट
Gerard 't Hooft|गेरार्डस 'टी हूफ्ट
Chandragupta Maurya|चन्द्रगुप्तमौर्यः
Nicolaas Bloembergen|निकोलास ब्लोम्बर्गन
Charles Barkley|चार्ल्स बार्क्ले
Robert Coleman Richardson|रोबर्ट कोलमन रिचार्डसन
Richard E. Taylor|रिचार्ड इ टेलर
Saif al-Islam al-Gaddafi|मु अम्मर् गडाफ़ि
Shivaji Bhonsle I|शिवाजिः
Maharishi Mahesh Yogi|महर्षि महेश योगी
I. K. Gujral|इन्द्र कुमार गुजरालः
Theresa May|थेरेसा मे
Wayne Rooney|वेन रूनी
Milkha Singh|मिल्खा सिंह
James II of Scotland|जेम्स २
Vesto Slipher|वेस्टो मेल्विन् सिल्फर्
Tulsidas|तुलसीदासः
Jagadish Chandra Bose|जगदीशचन्द्रबोसः
Vikram Sarabhai|विक्रम साराभाई
Homi Jehangir Bhabha|होमी जहाँगीर भाभा
Mahākāśyapa|Mahākāśyapa
James|जेम्स वान
Bankim Chandra Chattopadhyay|बङ्किमचन्द्रचटर्जी
Meghnad Saha|मेघनाथ साहा
Guru Hargobind|गुरु हरगोविंद
Sheila Dikshit|शीलादीक्षितः
Ela Bhatt|इलाबेन भट्ट
Vinayak Damodar Savarkar|विनायकदामोदरसावरकरः
Pingala|पिङ्गलः
Prithviraj Chauhan|भारतेश्वरः पृथ्वीराजः
Sonakshi Sinha|सोनाक्षी सिन्हा
Abanindranath Tagore|अबनिन्द्रनाथठाकुरः
M. Visvesvaraya|मोक्षगुण्डं विश्वेश्वरय्यः
Mahadev Desai|महादेवभाई देसाई
Bhagwan Das|भगवान् दासः
Leon Abbett|लेओन् अब्बेत्त्
Brihaspati|बृहस्पति
Rajyavardhan Rathore|राज्यवर्धन सिंह राठौड़
Manilal Gandhi|मणिलाल गान्धी
Vācaspati Miśra|वाचस्पतिमिश्रः
Emil Holst|एमिल् होल्स्त्
Adikavi Pampa|पम्पः
Khushwant Singh|खुशवन्त सिंहः
Pratibha Ray|प्रतिभा राय्
Kausalya|कौसल्या
Rajkumar Santoshi|राजकुमार संतोषी
Pururavas|पुरूरवाः
Dashrath Manjhi|दशरथमाँझिः
Vallathol Narayana Menon|वळ्ळत्तोळ् नारायणमेनोन्
Vidyapati|vidyapati
Mandavi|माण्डवी
Sukhdev Thapar|सुखदेवः
Kiran Bedi|about kiran bedi in skt
Asaram|संत श्री आसारामजी बापू
Maneka Gandhi|मेनका गांधी
Vishnu Sharma|विष्णुशर्मा
Felton Jarvis|फेल्तोन् जर्विस्
|बालगङ्गाधर तिलकः
|भिक्षु अखण्डानन्द
Bhikaiji Cama|भीखाइजी कामा
Labhshankar Thakar|लाभशंकर ठाकर
Mandhatri|मान्धातृ
Monobaz I|मोनोबाज़् १
Danny Dulieu|डन्नि डुलिएउ
Pran|प्राण् किशन् सिकन्द्
Swami Brahmananda|स्वामी ब्रह्मानन्दः
P. T. Usha|पीटीउषा
Syama Prasad Mukherjee|श्यामाप्रसाद मुखोपाध्याय
Prakash Jha|प्रकाश झा
Syama Sastri|श्यामाशास्त्री
N. V. Krishna Warrier|एन.वी.कृष्ण वारियर
Mahavir Prasad Dwivedi|महावीर प्रसाद द्विवेदी
Raghavendra Tirtha|राघवेन्द्रस्वामी
Sukanya|सुकन्‍या
Jyeṣṭhadeva|ज्येष्ठदेव
Wahiduddin Khan|मौलाना वहिदुद्दिन् खान्
Swami Rama Tirtha|स्वामी रामतीर्थः
Lagadha|लगध
Rajiv Pratap Rudy|राजीव प्रताप रूडी
Fakir Mohan Senapati|Fakir Mohan Senapati
Keladi Chennamma|केळदि चेन्नम्मा
Acharya Bhikshu|भिक्षुः आचार्यः
Adriaan van der Willigen|Adriaan van der Willigen
Adriaan van der Willigen Pz.|Adriaan van der Willigen Pz.
Adriaen Foly|Adriaen Foly
Ananth Kumar Hegde|अनंत कुमार हेगड़े
B. M. Srikantaiah|बि. यम्. श्रीकण्ठय्यः
Balaji Vishwanath|बालाजी विश्वनाथ
Basavaraj Rajguru|बसवराज राजगुरुः
C. L. Ruala|सी॰ एल॰ रुआला
Chilarai|चिलारायः
Chimaji Appa|चिमाजी अप्पा
Darshan Thoogudeepa|दर्शनः
Deepender Singh Hooda|दीपेंद्र सिंह हुड्डा
Diganth|दिगन्तः
Divodasa|दिवोदास
Ganesh Damodar Savarkar|गणेश दामोदर सावरकर
Gururao Deshpande|गुरुरावदेशपाण्डे
Innocent|इनोसेंट
Jose K. Mani|जोस के॰ मणि
Kalikesh Narayan Singh Deo|कलिकेश सिंह देव
Kanaka Dasa|कनकदासः
Kodikunnil Suresh|कोडिकुन्नील सुरेश
Kuntaka|कुन्तकः
M. K. Raghavan|एम॰के॰ राघवन
Mahavir Tyagi|महावीरत्यागी
N. S. Ramanuja Tatacharya|डा। एन् एस् रामानुजताताचार्यः
Nandi Yellaiah|नंदी येल्लयाह
P. Kumar|पी॰ कुमार
Poonam Mahajan Rao|पूनम महाजन राव
Prabhatsinh Pratapsinh Chauhan|प्रभातसिंह प्रतापसिंह चौहान
Prataprao Ganpatrao Jadhav|प्रतापराव गणपतराव जाधव
Rajen Gohain|राजेन गोहेन
Raju Shetti|राजू शेट्टी
Ramesh Bais|रमेश बैस
Ratna De|रत्ना डे
S. R. Bommai|एस्. आर्. बोम्मायी
Sanwar Lal Jat|सांवर लाल जाट
Shridhar Bhaskar Warnekar|श्रीधर
Siddhanta Mahapatra|सिद्धांत महापात्रा
Sri Ponna|पोन्नः
Supriya Sule|सुप्रिया सुले
Tanjore Ramachandra Anantharaman|टि. आर्. अनन्तरामु
Thupstan Chhewang|थुप्सतान छेवांग
Uvaṭa|उव्वटः
Varadarāja|व्
Vincent Pala|विन्सेंट पाला
Vishnu Deo Sai|विष्णु देव साई
Kanharpadharma|कन्दर्पवर्मन्
Wolfgang Palm|वुल्फगांग पल
Saṃghavarman|सँघवर्मन्
Jaya Indravarman VI|जय इन्द्रवर्मन् १०
|पृथिवीन्द्रवर्मन्
Mahesh Elkunchwar|महेश् यल्कुण्च्वर्
Vijaya|यंपुकु विजय श्री
Sujatha Singh|सुजाता सिङ्ग्
Kanhopatra|कान्होपात्रा
Urjit Patel|उर्जित पटेल
Meenakshi Lekhi|मीनाक्षी लेखी
Sarla Behn|सरलाबेन
Surinderjeet Singh Ahluwalia|एस॰एस॰ अहलूवालिया
Prabhākara|प्रभाकरः
|योहान वोल्फ़गांक वॉन गोटे
Hukmdev Narayan Yadav|हुकुमदेव नारायण यादव
Dina Vakil|दीना वकील
Bahadur Singh Koli|बहादुर सिंह कोली
Subhash Chandra Baheria|सुभाष बहेड़िया
Kaushalendra Kumar|कौशलेन्द्र कुमार
Heera Saraniya|नाबा कुमार सरणिया (हीरा)
Maheish Girri|महेश गिरी
Raghav Lakhanpal|राघव लखनपाल
Bharti Shiyal|भारती शियाल
Devji M Patel|देवजी पटेल
Rajesh Chudasama|राजेश चुडासमा
Dhananjay Mahadik|धनंजय महादिक
Poonamben Madam|पूनमबेन मादाम
Mahant Chand Nath|महंत चांदनाथ
Ashok Nete|अशोक महादेवराव नेते
Nanabhau Patole|नानाभाऊ पटोले
Niranjan Jyoti|निरंजन ज्योति
Sanjaykaka Patil|संजयकाका पाटिल
Naipal Singh|नेपाल सिंह
Janardan Singh Sigriwal|जनार्दन सिंह सिग्रीवाल
Azmeera Seetaram Naik|अज़मीरा सीताराम नायक
Fatepara Devajibhai Govindbhai|देवजीभाई गोविंदभाई फतेपारा
Kamakhya Prasad Tasa|कामाख्या प्रसाद तासा
Krishan Pal|कृष्ण पाल
Pandula Ravindra Babu|पंदुल रविन्द्र बाबू
Ram Kumar Sharma|राम कुमार शर्मा
Ramesh Chander|रमेश चन्द्र
Renuka Sinha|रेणुका सिन्हा
Sunil Kumar Mandal|सुनील कुमार मंडल
Thota Narasimham|तोटा नरसिम्हम
Ajay Kumar Mishra|अजय कुमार
Ashok Kumar Doharey|अशोक कुमार दोहरे
Bhagwanth Khuba|भगवंत खुबा
Hari Om Pandey|हरिओम पाण्डेय
Krishna Pratap|कृष्ण प्रताप
Mahendra Nath Pandey|महेन्द्र नाथ पाण्डेय
Sakshi Maharaj|स्वामी सच्चिदानंद हरि साक्षी
B B Patil|बी॰बी॰ पाटिल
David Joyner|David Joyner
Sadashiv Lokhande|सदाशिव लोखंडे
Maganti Venkateswara Rao|मागण्टि वेंकटेश्वर राव
Sathyabama V|वी॰ सत्यभामा
Gopalakrishnan Chinnaraj|सी॰ गोपालकृष्णन
Muddahanumegowda S. P.|मुदाहानुमेगौडा एस॰पी॰
T. Radhakrishnan|टी॰ राधाकृष्णन
S. R. Vijayakumar|एस॰आर॰ विजयकुमार
Devendra Singh|देवेन्द्र सिंह
Gunadhya|गुणाढ्यः
|Kapalapa
|Acinta
Jan Pawlowski|Jan Pawlowski
Lionel Cavin|Lionel Cavin
Jean-Philippe Anstett|Jean-Philippe Anstett
Francisco Alonso Martos|Francisco Alonso Martos
Jesús Martínez Verón|Jesús Martínez Verón
Joaquín de la Concha Alcalde|Joaquín de la Concha Alcalde
Felipe Medina Benjumea|Felipe Medina Benjumea
Leela Row|लीला राव
Konstantina Sintzaniki|Konstantina Syntzanaki
Sadanandayati|सदानन्दयतिः
V. Seetharamaiah|वि सीतारामय्य
Gjergj Zefi|Gjergj Zefi
Linus Kvist|Linus Kvist
Erki Laanemäe|Erki Laanemäe
Ingram Cuff|Ingram Cuff
Nikita Stenkovoy|Nikita Stenkovoy
Maria Ögn Gudmundsdottir|Maria Ögn Gudmundsdottir
Cornelia Cyrus|Cornelia Cyrus
Ioulia Eremeeva|Ioulia Eremeeva
Julia Bradley|Julia Bradley
Simona Wagnerova|Simona Wagnerova
Sara Savino|Sara Savino
Florian Auer|Florian Auer
Emīls Cipulis|Emīls Cipulis
Marián Skupek|Marián Skupek
Adam Dobeš|Adam Dobeš
Mara Morell|Mara Morell
Dylan Sorensen|Dylan Sorensen
Jonas Oehmichen|Jonas Oehmichen
Abraham Lincoln|अब्राहम लिन्कन
Michelle Bachelet|मिशेल बाचेलेत
Julius Caesar|जुलियस कैसर
Usain Bolt|उसैन् बोल्ट्
Vladimir Lenin|व्लाडिमिर लेनिन
Corbin Bleu|कॉर्बीन ब्लेऊ
Lord Byron|जार्ज बैरन
Johann Wolfgang von Goethe|जोहान वुल्फगांग गेटे
Elizabeth I of England|एलिजाबेथ
Kamala Sohonie|कमला सोहोनी
Rosalind Franklin|रोसलिन्द् फ़्रङ्क्लिन्
Leonhard Euler|लियोनार्ड ओइलर
Akira Kurosawa|अकिरा कुरोसावा
Avicenna|अविसेन्न
Nelson Mandela|नेल्सन् मण्डेल
Saladin|सलाउद्दीन
Enrico Fermi|एन्रीको फर्मी
Satyajit Ray|सत्यजित राय
Steven Spielberg|स्टीवन स्पीलबर्ग
John Maynard Keynes|जोन मेनार्ड केन्स
Aamir Khan|Aamir khan
Pelé|पेले
Donald Trump|डॉनल्ड ट्रम्प
Agnimitra|अग्निमित्र
Casimir Funk|कासिमिर फन्क
Chris Smalling|क्रिस स्मालिंग
Yash Chopra|यश चोप्रा
Hirohito|हिरोहितो
Wilhelm Röntgen|विल्हेल्म् कार्नार्ड् रोण्ट्जेन्
Pol Pot|पोल पॉट
Werner Heisenberg|वर्नर हाइजेनबर्ग
Aeschylus|एशिलस
Rumi|रूमि
Michel Foucault|माइकल फोका
V. S. Naipaul|विद्याधर सूरजप्रसाद नैपाल
Susilo Bambang Yudhoyono|सुशीलो बम्बंग युधोयोनो
Hans Lippershay|हान्स् लिप्पर्शे
William Wallace|विलियम वालेस
H.J. Muller|हर्मन् जोसेफ् म्यूल्लर्
Jahangir|जहाङ्गीरः
Simon van der Meer|सिमोन वान डर मीर
Sheldon Lee Glashow|शेल्डन ग्लास्हौ
Bhimsen Joshi|भीमसेन जोशी
Malcolm IV of Scotland|माल्कम ४
Francis Crick|फ्रान्सिस् एच् सि क्रिक्
Robert A. Millikan|रोबर्ट ए मिल्लिकन्
William Henry Bragg|विलियम हेन्री ब्राग
George Paget Thomson|जार्ज पेजेट थामसन
Jean Perrin|जां बाप्टिस्टे पेरिन
Subrahmanyan Chandrasekhar|सुब्रह्मण्यन् चन्द्रशेखरः
Igor Tamm|इगोर वाइ टाम
Masatoshi Koshiba|मासातोशी कोशिबा
Hideki Yukawa|हिदेकी युकावा
Sarvepalli Radhakrishnan|सर्वपल्ली राधाकृष्णन्
Charles Thomson Rees Wilson|सी टी आर विल्सन
Ernest Lawrence|अर्नेस्ट लारेन्स
Nagarjuna|नागार्जुन
Arno Allan Penzias|आर्नो पेन्जियस
Premchand|प्रेमचन्दः
Verghese Kurien|वर्गिस् कुरियन्
Mahathir Mohamad|महाथिर मोहमद
Rani Lakshmibai|झांसी लक्ष्मीबाई
Kareena Kapoor|करीना कपूर
Martin Ryle|मार्टिन राइल
Francis Galton|फ्रान्सिस् गाल्टन्
Aurobindo Ghosh|श्री अरविन्दः
Arundhati Roy|अरुंधति राय
Anna Hazare|अन्नाहजारे
A. C. Bhaktivedanta Swami Prabhupada|भक्तिवेदान्तस्वामी प्रभुपादः
Ruth Prawer Jhabvala|रुत् प्रवर् जब्वाला
Vasishtha|वसिष्ठः
Sushmita Sen|सुष्मिता सेन
Subramanya Bharathi|सुब्रह्मण्य भारती
George VI|जार्ज ६
George Washington Carver|जार्ज् वाशिङ्ग्टन् कार्वर्
R. Venkataraman|रामस्वामी वेङ्कटरामन्
Ben Amos|बेन अमोस
Robert II of Scotland|राबर्ट २
Dev Anand|देवानन्दः
Amrish Puri|अमरीश पुरी
Madhvacharya|मध्वाचार्यः
Jarnail Singh Bhindranwale|जरनैल सिंह भिण्डरांवाले
Kamal Haasan|कमलहसनः
Sarat Chandra Chattopadhyay|शरत् चन्द्र चट्टोपाध्याय
Shantideva|शान्तीदेव
Amaru|अमरुः
Sivananda Saraswati|स्वामी शिवानन्दसरस्वती
Mamata Banerjee|ममता ब्यानर्जी
Anju Bobby George|अंजूबाबीजार्ज
Anushka Sharma|अनुष्का शर्मा
Meera|मीराबाई
Guru Har Krishan|गुरु हरकिशन
Tukaram|साधुः तुकारामः
Aurangzeb|औरङ्गजेबः
Shekhar Kapur|शेखरकपूरः
Jacqueline Cramer|जक्क़्उएलिने क्र्मेर्
Anish Giri|अनिश गिरी
D. R. Kaprekar|दत्‍तात्रेय रामचंद्र कापरेकर
Ravel Morrison|रावेल मॉरिसन
Henry VII|हेन्री ७
Bipin Chandra Pal|विपिनचन्द्र पालः
Bharadwaja|भरद्वाजमहर्षिः
Valmiki|वाल्मीकिः
Bhupen Hazarika|भुपेन हजारिका
Shreeram Shankar Abhyankar|biography
Paramartha|परमार्थ
M. S. Swaminathan|एम् एस् स्वामिनाथन्
Krishan Kant|किशन कान्त
Dharmakṣema|Dharmakṣema
Samudragupta|समुद्रगुप्तः
Subhuti|सुभूति
Skandagupta|स्कन्दगुप्तः
Surdas|surdas
Manohar Parrikar|मनोहरः परिक्करः
Rang Avadhoot|रङ्ग अवधूत महाराज
Kalhana|कल्हणः
Ramanathan Krishnan|रामनाथन् कृष्णन्
Manish Malhotra|मनीष मल्होत्रा
Amrita Pritam|अमृता प्रीतम
Kirpal Singh|kumbamela
Pullela Gopichand|गोपीचंद
Rajaraja I|राजाराज चोळ
Sister Nivedita|मार्गरेट् एलीजाबेथ् नॉबल्
Vajrasattva|वज्रसत्त्व
Nimbarka|निम्बार्काचार्यः
Jos van der Kolk|जोस् वन् देर् कोल्क्
Murli Manohar Joshi|मुरली मनोहर जोशी
Sayajirao Gaekwad III|सयाजीराव गायकवाड
Khudiram Bose|खुदीराम बोस
Amol Palekar|अमोल पालेकर
Mammootty|मम्मूट्टि
Śabara|शबरस्वामी
Govind Ballabh Pant|गोविन्दवल्लभः पन्तः
Amjad Ali Khan|अमज़द अली खान्
Devanand Swami|देवानन्दस्वामी
|महाराजा भगवत सिंह
Muktanand Swami|मुक्तानंद स्वामी
Vishvamitra|विश्वामित्रः
Ugrasena|उग्रसेनः
Danny Brough|देन्नि ब्रोघ्
Uma Bharti|उमा भारती
Mahapadma Nanda|महापद्मनन्दः
Siddhidas Mahaju|सिद्धिदास महाजु
K. B. Hedgewar|केशव बलिराम हेडगेवार
N. T. Rama Rao Jr.|जूनियर् एन् टि आर्
Dhanraj Pillay|धनराज पिल्लै
Afzal Guru|अफजल् गुरुः
Karaikkal Ammeiyar|कारैक्काल् अम्बा
Mahendravarman I|महेन्द्रवर्मन्(पल्लवः)
Purushottam Laxman Deshpande|पुरुषोत्तम लक्ष्मण देशपांडे
M. J. Akbar|एम जे अकबर
E. Ahamed|ई अहमद
Kodungallur Kunjikkuttan Thampuran|कॊडुङ्ङल्लूर् कुञ्ञिक्कुट्टन् तम्पुरान्
Balagangadharanatha Swamiji|बालगङ्गाधरनाथस्वामी
Ravi Shankar Prasad|रवि शङ्कर प्रसाद
Raghuvir Sahay|रघुवीर सहाय
Subhadra Kumari Chauhan|सुभद्राकुमारी चौहान
Chamu Krishna Shastry|च मू कृष्ण शास्त्री
Chintaman Dwarkanath Deshmukh|चिन्तामण् द्वारकानाथ देशमुख्
Vishakhadatta|विशाखदत्तः
Suhita|सुहित
Mallinātha Sūri|मल्लिनाथसूरिः
Satyendra Dubey|सत्येन्द्र-दुबे
Rana Bhagwandas|राणा भगवानदास
A. Ayyappan|म्म्
Abhaya Simha|अभयसिंहः
Gyansagar|आचार्यज्ञानसागरः
Sung Jae-gi|सङ जेगी
Arjun Charan Sethi|अर्जुन चरण सेठी
Arjun Ram Meghwal|अर्जुन राम मेघवाल
Atreya|आत्रेयी
Boora Narsaiah Goud|बुर्रा नरसय्या
Ram Nath Kak|राम नाथ काक
D. V. Gundappa|डी वी जी
Darshana Jardosh|दर्शन जारदोश
Deepak Adhikari|देव (दीपक अधिकारी)
Dirghatamas|दीर्घतमाः
G. P. Rajarathnam|जी. पी.राजरत्नम्
Ganesh|गणेश् (चलच्चित्रनायकः)
Haribhadra|Haribhadra
Dilip Patel|दिलीप पटेल
Jyoti Dhurve|ज्योति धुर्वे
Kirti Vardhan Singh|कीर्तिवर्धन सिंह
Kumara Vyasa|कुमारव्यासजयन्ती
Kunwar Sarvesh Kumar Singh|कुंवर सर्वेश कुमार
Lekhnath Paudyal|लेखनाथ पौड्यालः
Luipa|Luipa
M. B. Rajesh|एम॰बी॰ राजेश
M. N. Srinivas|एम एन श्रीनिवासः
Madhavrao II|सवाई माधवराव
Malladihalli Sri Raghavendra Swamiji|मल्लाडिहळ्ळि राघावेन्द्रस्वामी
Matangini Hazra|मातङ्गिनी हाझरा
Mehboob Ali Kaiser|चौधरी महबूब अली कैसर
Naranbhai Kachhadia|कछाड़िया नारनभाई भीखाभाई
Om Prakash Yadav|ओम प्रकाश यादव
Prem Singh Chandumajra|प्रेम सिंह चन्दूमाजरा
Radha Mohan Singh|राधा मोहन सिंह
Rajendra Singh|राजेन्द्र सिंह
Sampurnanand|डा सम्पूर्णानन्दः
Kishkindhakanda|किष्किन्धाकाण्डम्
Shivaji Adhalrao Patil|अधलराव शिवाजी दत्तात्रेय
Smriti Irani|स्मृति इरानी
Subrata Bakshi|सुब्रत बक्शी
Subrata Roy|सुब्रत राय
Sumitra Mahajan|सुमित्रा महाजन
Vijay Rupani|विजय रूपाणी
Prabhasadharma|भासधर्म
Yami Gautam|यामी गौतम
Indravarman III|इन्द्रवर्मन् ३
Sangolli Rayanna|संगोल्लि रायण्णः
Maha Kali|महा काली
Kātyāyanīputra|Kātyāyanīputra
Indulal Yagnik|इन्दुलाल याज्ञिक
|सत्यवर्मन्
|केनेथ १
|केनेथ ३
Kaiyat|कैय्यटः
Jaisingha Verman|जयसिंहवर्मन्
|दिलीप १
|सरोजिनी काक
N. K. Premachandran|एन॰के॰ प्रेमचन्द्रन
Santosh Ahlawat|संतोंश अहलावत
|मार्टिन लुथर
Ramesh Bidhuri|रमेश बिधूड़ी
Udayanraje Bhosale|उदयनराजे भोसले
D. K. Suresh|डी॰के॰ सुरेश
|स्वामी ब्रुहदाचार्य:
Sanjay Haribhau Jadhav|संजय हरिभाऊ जाधव
Savitri Bai Phule|सावित्री बाई फुले
Bhola Singh|भोला सिंह
Rameswar Teli|रामेश्वर तेली
Kanwar Singh Tanwar|कँवर सिंह तंवर
Arpita Ghosh|अर्पिता घोष
Bidyut Baran Mahato|बिद्युत बरन महतो
Bijoy Chandra Barman|बिजय चन्द्र बर्मन
Harinder Singh Khalsa|हरिंदर सिंह खालसा
Idris Ali|इदरिस अली
Janak Ram|जनक राम
Kothapalli Geetha|कोत्तपल्ली गीता‎
Mamtaz Sanghamita|ममताज़ संघमिता
Sirajuddin Ajmal|सिराजुद्दीन अजमल
Tasleem Uddin|तस्लीमुद्दीन
Alok Sanjar|आलोक संजर
Manohar Untwal|मनोहर उंटवाल
Manshankar Ninama|मानशंकर निनामा
Rama Chandra Hansdah|राम चन्द्र हंसदा
Subhash Patel|सुभाष पटेल
Rabindra Kumar Jena|रबिन्द्र कुमार जेना
V. Elumalai|वी॰ एलुमलै
B. Senguttuvan|बी॰ सेनगुट्टुवन
Ramakant Gundecha|रमाकांत गुंडेचा
P Nagarajan|पी॰ नागराजन
Pratap Chandra Sarangi|प्रतापचन्द्रसारङ्गी
A. Anwhar Raajhaa|ए॰अनवर राजा
R. K. Bharathi Mohan|भारती मोहन आर॰के॰
Nagendra Singh|नागेन्द्र सिंह
Virendra Singh|वीरेन्द्र सिंह
Vinod Kumar Sonkar|विनोद कुमार सोनकर
Dasrath Tirkey|दसरथ टिर्की
|Kanakhala
Badri Datt Pandey|बद्रीदत्तपाण्डेयः
Sumaira Abdulali|सुमैरा अब्दुलअली
Vojtech H. Lindtner|Vojtech H. Lindtner
Philipp Wobeto|Philipp Wobeto
Sonia Fisch-Muller|Sonia Fisch-Muller
Laurent Vallotton|Laurent Vallotton
John Hollier|John Hollier
Rahulabhadra|Rāhulabhadra
Dionisio García Cortázar|Dionisio García Cortázar
Máximo Cánovas del Castillo|Máximo Cánovas del Castillo
Giridhar Sharma Chaturvedi|गिरधर शर्मा चतुर्वेदी
Anu Menon|अनु मेनन
Vijja|विज्जिका
Ramchandra Rath|रामचन्द्र रथ्
Jaiyyata|जैय्यटः
Vanessa Mark|Vanessa Mark
Alexander Bernardi|Alexander Bernardi
Olivia Araujo|Olivia Araujo
Victor Povzner|Victor Povzner
Mantas Januskevicius|Mantas Januskevicius
Bolivar Espinosa|Bolivar Espinosa
Mattija Lojen|Mattija Lojen
Joanne Cavill|Joanne Cavill
Beata Jasińska|Beata Jasińska
Olga Mikhailoyskaia|Olga Mikhailoyskaia
Els Bauden|Els Bauden
Sabrina Arhab|Sabrina Arhab
Cecilia Bäckstedt|Cecilia Bäckstedt
Rabi Mishra|रबि मिश्र
Iulian Oprea|Iulian Oprea
Leon Felderer|Leon Felderer
Cezara Curmei|Cezara Curmei
Roberts Plūme|Roberts Plūme
Erica Voss|Erica Voss
Julia Słupecka|Julia Słupecka
Eric Fantazzini|Eric Fantazzini
Arnis Bebrišs|Arnis Bebrišs
Taylor Lawrence|Taylor Lawrence
Cédric Follador|Cédric Follador
Prajñākaragupta|प्रज्ञाकरगुप्त
Erik Schmidt|Erik Schmidt
William Shakespeare|विलियम शेक्सपीयर
Aristotle|अरिस्टाटल्
Carl Linnaeus|केरोलस् लीनियस्
Saddam Hussein|सद्दाम हुसेन्
Gerhard Schröder|गेर्हार्ड श्रोडर
Charlemagne|शार्लेमन्य
Mohamed Morsi|मोहम्मदमुर्शी
Niels Bohr|नील्स बोह्र
Rabindranath Tagore|रवीन्द्रनाथ ठाकुरः
Margaret Thatcher|मार्गरेट थाचर
Ashoka|अशोकः
Chanakya|चाणक्यः
Karl Marx|कार्ल मार्क्स
James Clerk Maxwell|जेम्स क्लर्क माक्सवेल
Queen Victoria|विक्टोरिया
Aryabhata|आर्यभटः
Wilhelm Ostwald|आस्ट्टाल्ट् फ्रिडरिक् विल्हेल्म्
Auguste Comte|आगस्ट् कम्ट् महोदयः
Vinoba Bhave|विनोबा भावे
Shrimad Rajchandra|श्रीमद् राजचन्द्र
Alfred Nobel|अल्फ्रेड नोबेल
Mother Teresa|मदर टेरेसा
K. Chandrashekar Rao|कल्वाकुंतला चंद्रशेखर राव
Henry VIII of England|हेनरी ८
Pervez Musharraf|परवेज़ मुशर्रफ़
Kurt Gödel|कर्ट गोडेल
Manmohan Singh|मनमोहनसिंहः
Anwar Sadat|अन्वर् अल्-सादात्
Archduke Franz Ferdinand|फ़्रान्ज़ फर्डिनान्ड
Oliver Cromwell|आलिवर क्रामवेल
Dennis M. Ritchie|डेनिस रिची
William Alfred Fowler|विलियम ए फोलर
Sudha Chandran|सुधा चन्द्रन्
Raj Kapoor|राजकपूरः
Wilhelm Wien|विल्हेम वेन
Ram Baran Yadav|डा. राम वरण यादवः
Sukarno|सुकर्णो
Otto Warburg|ओट्टो हेन्रिक् वार्बर्ग्
Heinrich Caro|केरो हेन्रिज्
Pavel Cherenkov|पावेल शेरेन्कोव
Alexander II of Russia|अलेक्ज़ांडर २
Karl Landsteiner|कार्ल् लाण्ड्स्टैनर्
Harriet Tubman|हेरिएट टबमान
Germaine Greer|जेर्मेन ग्रीर
Menander|मेनांदर
Kumar Gandharva|कुमार गन्धर्वः
George III of Great Britain|जार्ज ३
Paul Pogba|पॉल पोग्बा
George IV of the United Kingdom|जार्ज ४
Henry Cavendish|क्यावेण्डिष् हेन्रि
Clinton Davisson|क्लिन्टन डविसन
Gabriel Lippmann|गेब्रियल् लिपमन्
John Logie Baird|जोन लोगी बेर्ड
Ajay Devgn|अजयदेवगन्
Robert Brown|राबर्ट् ब्रौन्
J.B.S. Haldane|जे. बि. एस्. हाल्डेन्
Mohammed Rafi|मोहम्मद रफी
Theophrastus|थियोफ्रास्टस्
Isidor Isaac Rabi|इसिडोर ऐज़क रबि
Dimitar Berbatov|डिमीटार बरबाटोव
Georges Cuvier|जार्ज् क्युव्ये
Darren Fletcher|डैरेन फ्लेचर
Louis Rosier|लोउइस् रोसिएर्
Luis Walter Alvarez|लुइ अल्वारेज़
Jayant Vishnu Narlikar|डा. जयन्त नारळीकरः
Ernest Walton|अर्नेस्ट टी एस वाल्टन
Melvin Schwartz|मेल्विन श्वार्ट्ज
Claude Cohen-Tannoudji|क्लाउड कोहेन-टन्नौजी
Lucrezia Borgia|लुक्रेजिया बोर्गिया
James Cronin|जेम्स क्रोनिन
Bharata Muni|भरतमुनिः
Federico Macheda|फेडेरिको माकेडा
Virat Kohli|विराट् कॊह्लि
James III of Scotland|जेम्स ३
Kajal Aggarwal|काजल् अगरवाल्
Padmasambhava|पद्मसंभव
Markandeya|मार्कण्डेयः
Mayawati|मायावती
William Jones|वैदिकवाङ्गमये पाश्चात्यानां योगदानम्
Emilia Plater|एमिलिया प्लेटर
Pedanius Dioscorides|डयोस्कोरिडीस्
Kanishka|कनिष्क
Ratan Tata|ratan naval tata
Masanobu Fukuoka|मसानबु फ़ुकोका
Bhartṛhari|भर्तृहरिः
Sooraj R. Barjatya|सूरज बड़जात्या
Amara Sinha|अमरसिंहः
Guru Angad Dev|गुरु अंगद देव
Dilip Kumar|दिलीपकुमारः
Rajendra K. Pachauri|राजेन्द्रकुमारः पचौरि
Dhyan Chand|ध्यानचंद
Sushruta|सुश्रुतः
Albert Calmette|काल्मेट् लियान् चारल्स् आल्बर्ट्
Amar Bose|अमर गोपाल बोस
Dharmakirti|धर्मकीर्ति
Jayalalitha Jayaram|जयललिता
Lal Krishna Advani|लालकृष्ण अडवाणी
James Young Simpson|सर् जेम्स् सिम्सन्
Nani|लुईस नानी
V. O. Chidambaram Billai|व.उ.चिदम्बरम् पिळ्ळै
Zeki Fryers|एज़िकील फ्रैएर्स
Dasaratha Maurya|दशरथ मौर्यः
Basappa Danappa Jatti|बसप्पा दानप्पा जत्ती
Mohammad Hidayatullah|मुहम्मद हिदायतुल्लाह
Buddhabhadra|Buddhabhadra
Narayan Pandit|नारायण पण्डित
Asaf Ali|आसफ़् अली
Vinod Khosla|विनोद खोसला
Raghuram Rajan|रघुराम राजन्
Ramakrishna Hegde|रामकृष्ण हेगडे
Robert Llewellyn Bradshaw|रोबर्ट् ल्लेवलिन् ब्रॅड्षॉ
Ian Nelson|ईअन्  नेल्सोन
Dr. Rajkumar|राजकुमारः
Claude Eatherly|क्लव्डी ईदर्ली
Hanumappa Sudarshan|हनुमप्प सुदर्शन्
Vikramaditya|विक्रमादित्यः
Kamal Nath|कमल नाथ
Prakash Raj|प्रकाश् राज्
Emil Hochreiter|एमिल् होच्रेइतेर्
N. R. Narayana Murthy|एन आर नारायणमूर्ति
Jnanagupta|Jñānagupta
Neminatha|नेमिनाथः
Bhāsa|भासः
Gauri Shankar Kalita|गौरी शंकर कलिता
Vinod Khanna|विनोद खन्ना
Vani Jairam|वाणी जयरामः
Mahesh Babu|महेश बाबु
Nek Chand Saini|नेकचन्दः
Robert Jones|Robert Jones
Lakshman Sen|लक्ष्मणसेनः
Bhanubhakta Acharya|भानुभक्त आचार्य
Jiva Goswami|जीवगोस्वामी
Parashara|पराशरऋषिः
Birbal Sahni|बीरबल साहनी
Ilaiyaraaja|Ilaiyaraja
Gijubhai Badheka|गिजुभाई बधेका
Bhaṭṭoji Dīkṣita|भट्टोजिदीक्षितः
Rupa Goswami|रूपगोस्वामी
Danny Buderus|देन्नि ब्यूडरस्
George Fernandes|जार्ज् फर्नान्डिस्
Humayun Abdulali|हुमायून् अब्दुलअली
Samaratungga|समरतुङ्गः
José Luis Álvarez Álvarez|José Luis Álvarez
D. R. Bendre|दत्तात्रेय रामचन्द्र बेन्द्रे
Prafulla Chandra Ray|प्रफुल्लचन्द्ररायः
Kariamanickam Srinivasa Krishnan|कृष्णन् के एस्
Shiva Naipaul|शिव नैपाल
Ajitanatha|अजितनाथः
Geet Sethi|गीत सेठी
Kelucharan Mohapatra|केलुचरण महापात्रः
Tenali Ramakrishna|Tenali Ramakrishna
Subramanian Swamy|सुब्रह्मण्यन्-स्वामी
Bhamaha|भामहः
Shanti Swaroop Bhatnagar|डा. शान्तिस्वरूप भट्नागरः
Sawai Gandharva|सवायी गन्धर्वः
Bhoja|भोजदेवः
Tribhuwana Wijayatunggadewi|त्रिभुवन विजयतुंगदेवी
Manu Bhandari|मन्नू भंडारी
Sarangadeva|शार्ङ्गदेवः
Kamala Nehru|कमलानेहरुः
Gopinath Munde|गोपीनाथ पांडुरंग मुंडे
Udayana|उदयनाचार्यः
Gangesha Upadhyaya|गङ्गेशोपाध्यायः
Jatin Das|जतिन दास
Rajendra Yadav|राजेन्द्र यादव
Harishankar Parsai|हरिशंकर परसाई
Adhir Ranjan Chowdhury|अधीर रंजन चौधरी
Budhagupta|बुधगुप्तः
Anandrao Vithoba Adsul|आनंदराव विठोबा अडसुल
Anant Geete|अनंत गंगाराम गीते
Ananth Kumar|अनंत कुमार
Anjolie Ela Menon|अञ्‍जलि एला मेनन
Anto Antony|एंटो एंटनी
Anurag Thakur|अनुराग सिंह ठाकुर
Arnab Ranjan Goswami|अर्णवगोस्वामी
Bhagat Singh Koshiyari|भगत सिंह कोश्यारी
Bhavana Pundlikrao Gawali|भावना पुंडलिकराव गवली
Bijjala II|बिज्जलः-२
Biren Singh Engti|बीरेन सिंह एंगती
Dushyant Singh|दुष्यंत सिंह
G. V. Iyer|जि वि अय्यर्
Gangadevi|गङ्गदेवी
Gopalakrishna Adiga|गोपालकृष्ण अडिग
Haqiqat Rai|हकीकतरायः
Hari Manjhi|हरी मांझी
J. H. Patel|जे. एच्. पटेलः
Jayadev Galla|जयदेव गल्ला
Kiren Rijiju|किरेन रीजूजु
Kriti Kharbanda|कृतिखरबन्दा
M.R. Srinivasan|M.R. Srinivasan
Makhanlal Chaturvedi|माखनलाल चतुर्वेदी
Man Singh Tomar|मानसिंह तोमर
Nellie Sengupta|नेली सेनगुप्ता
P. C. Gaddigoudar|पी.सी.गड्डीगौडार
Parayamparanbil Kuttappan Biju|पी॰के॰ बीजू
Piara Singh Gill|प्यारासिंह गिल
Pon Radhakrishnan|पोन राधाकृष्णन
Raghavanka|राघवाङ्कः
Raghubar Das|रघुवर दास
Raghunathrao|रघुनाथराव
Rajaram I|राजाराम
Rajendra Agrawal|राजेंद्र अग्रवाल
Ram Kripal Yadav|रामकृपाल यादव
Ramachandra Dattatrya Ranade|रामचंद्र दत्तात्रेय रानडे
Ranna|रन्नः
Yogaraj Bhat|योगराज भट्
Shantaveri Gopala Gowda|शान्तवेरी गोपालगौडः
Sisir Adhikari|शिशिर कुमार अधिकारी
Sri Prakasa|श्रीप्रकाशः
Sudip Bandyopadhyay|सुदीप बंदोपाध्याय
Suvendu Adhikari|सुवेन्दु अधिकारी
Tariq Anwar|तारिक़ अनवर
Udaykumar|उदयकुमारः
Virender Kashyap|वीरेंद्र कश्यप
Virendra Kumar Khatik|वीरेंद्र कुमार
Bhadresvaravarman|भद्रेश्वरवर्मन्
Maha Kaya|महा काय
Vikrantavarman I|विक्रान्तवर्मन् १
Ayodhya Prasad Upadhyay|अयोध्यासिंह उपाध्याय 'हरिऔध'
|केनेथ २
Harivarman II|विजय श्री हरिवर्मन् २
|श्री ईशानः तुङ्गविजयः
Sai Paranjpye|सई परांजपे
Someshvara (Chahamana dynasty)|सोमेश्वर चौहान
Harsh Vardhan|हर्षवर्धन
Sarla Thakral|सरला ठकराल
|कृष्‍णयजुर्वेद:
|त्रिविक्रमभट्टः
|बाबा कल्याणदासः
|लक्ष्मी प्रसाद देवकोटा
|विद्याधरः
Amyra Dastur|अमायरा दस्तूर
Gopal Shetty|गोपाल शेट्टी
Satyapal Singh|सत्यपाल सिंह
Sher Singh Ghubaya|शेर सिंह घुबाया
Pijush Ganguly|पीयुष गांगुली
Raj Kumar Saini|राज कुमार
Ram Prasad Sharma|राम प्रसाद शर्मा
Savitri Thakur|सावित्री ठाकुर
Rajan Vichare|राजन विचारे
Harinarayan Rajbhar|हरिनारायण राजभर
Rajveer Singh|राजवीर सिंह
Ajay Nishad|अजय निषाद
Dharamvir Gandhi|धर्मवीर गांधी
Dipsinh Shankarsinh Rathod|दीपसिंह शंकरसिंह राठोड
Hariom Singh Rathore|हरिओम सिंह राठौड़
J. C. Diwakar Reddy|जे॰सी॰ दिवाकर रेड्डी
Kambhampati Hari Babu|कम्भम्पाटि हरिबाबू
Lakhan Lal Sahu|लखन लाल साहू
Muttamsetti Srinivasa Rao|मुत्तमसेट्टी श्रीनिवास राव (अवंति श्रीनिवास)
Sushmita Dev|सुष्मिता देव
Vasava Parbhubhai Nagarbhai|वसावा परभुभाई नागरभाई
Y. S. Avinash Reddy|वाई॰एस॰ अविनाष रेड्डी
Janardan Mishra|जनार्दन मिश्रा
Laxmi Narayan Yadav|लक्ष्मी नारायण यादव
Raksha Khadase|रक्षा खडसे
Tapas Mandal|तापस मंडल
Rodmal Nagar|रोडमल नागर
Prabhas Kumar Singh|प्रभास कुमार सिंह
Charanjeet Singh Rori|चरणजीत सिंह रोड़ी
K. Kamaraj|डॉ॰ के॰ कामराज
K. Gopal|के॰ गोपाल
Yashwant Singh|यशवंत सिंह
Suman Pokhrel|सुमन पोखरेल
Uma Nehru|उमा नेहरुः
Prashastapada|प्रशस्तपादः
Saṃghabhadra|Saṃghabhadra
|वेंकटमाधवः
Friederike Spitzenberger|Friederike Spitzenberger
Neeraj Chopra|नीरज चोपडा
Bulusu Venkateswarlu|बुलुसु वेंकटेश्वर्लु
Claude Vaucher|Claude Vaucher
Bertrand Devouard|Bertrand Devouard
J Sai Deepak|जे. साइ दीपक
Raghuttama Tirtha|रघूत्तमतीर्थः
Dharam Bir Singh|धरमबीर
|यूक्लिड्
Ananya Raje Scindia|अनन्या राजे सिंधिया
Christian Hammers|Christian Hammers
Gert Kivistik|Gert Kivistik
Ilia Cota|Ilia Cota
Carlo Jurisevic|Carlo Jurisevic
Birkir Snaer Ingvason|Birkir Snaer Ingvason
Barbora Svrckova|Barbora Svrckova
Wendy Ducruex|Wendy Ducruex
Tatiana Droujinina|Tatiana Droujinina
Tatiana Bossak|Tatiana Bossak
Chantalle Gehrig|Chantalle Gehrig
Séverine Villance|Séverine Villance
Lada Koslikova|Lada Koslikova
Samanta Loschi|Samanta Loschi
Darnelle Moore|Darnelle Moore
Rachel Leroux|Rachel Leroux
Šárka Chmurová|Šárka Chmurová
Sarah Wimmer|Sarah Wimmer
Jinendrabuddhi|जिनेन्द्रबुद्धि
Riccardo Schöpf|Riccardo Schöpf
Eduard Crăciun|Eduard Crăciun
Irina Strebel|Irina Strebel
Sara Villani|Sara Villani
Andreas Haas|Andreas Haas
Joseph Williamson|Joseph Williamson
Saṅghadāsa|सङ्घदासगणि
Joyeeta Roy|जयिता राय
Mika Schneider|Mika Schneider
Daniel Berlinski|Daniel Berlinski
Cleopatra|क्लियोपैत्रा
Albert Einstein|अल्बर्ट ऐन्स्टायिन्
Augustus|आगस्टस कैसर
Subhas Chandra Bose|नेताजी सुभाषचन्द्रबोसः
Günter Grass|गुंटर ग्रास
Alfred Hitchcock|एल्फ़्रेड हिचकॉक
Andre Agassi|आण्ड्रे अगास्सि
Asima Chatterjee|असीमा च्याटार्जी
Winston Churchill|विन्स्टन चर्चिल
Galen|गेलेन्
Al-Khwarizmi|मुहम्मद इब्न् मूसा अल्-ख्वारिज्मी
Erwin Schrödinger|अर्विन श्रोडिन्गर
Laozi|लाओझी:
Shah Rukh Khan|शाह् रूख् खान्
Katrina Kaif|कैटरीना कैफ
Elizabeth II|एलिज़बेथ २
Silvio Berlusconi|सिल्विओ बर्लुस्कोनी
Giovanni Domenico Cassini|कासनी जियावानि डोमिनिको
Jiang Zemin|जियांग झेमिन:
Jonny Evans|जोनी एवंस
Michael Carrick|माइकल कैरिक
Mikhail Gorbachev|मिखाइल गोर्बाचोफ
Leon Trotsky|त्रोत्स्की
Hannibal|हान्निबल
Florence Nightingale|फ्लोरेन्स नैटिन्गेल
Nefertiti|नेफेरतिति
David Hilbert|डेविड हिल्बर्ट
Aristophanes|आरिस्तोफनेस
Katyayana|कात्यायन
Charles Babbage|charles babbage
Sheikh Hasina|शेख् हसीना
Gustav Ludwig Hertz|गुस्टाफ हर्ज़
Pranab Mukherjee|प्रणब् मुखर्जि
Arvind Kejriwal|अरविन्दकेजरीवालः
August Weismann|अगस्ट् वीस्मान्
Eleanor Roosevelt|एलेनोर रोज़वेल्ट
Shah Jahan|शाहजहानः
Avinash Kak|अविनाश काक
Pandita Ramabai|pandita ramabai
Ronald Ross|सर् रोनाल्ड् रास्
Jagjit Singh|जगजीत सिंहः
Rajesh Khanna|राजेश् खन्ना
Har Gobind Khorana|हरगोविन्द खुराना
Ramon Magsaysay|रमोन् मेग्सेसे
Pushyamitra Sunga|Puṣyamitra Śuṅga
James II of England|जेम्स ७
Mary II|मेरी २
James IV of Scotland|जेम्स ४
Edward Victor Appleton|एडवार्ड वी एप्पलटन
Joseph Lister, 1st Baron Lister|जोसेफ् लिस्टर्
Priyanka Chopra|प्रियाङ्का चोपडा
Nemanja Vidić|निमेन्या विडिच
Robert Wilson|रोबर्ट वूड्रो विल्सन
Steven Chu|स्टीवन चू
Murray Gell-Mann|मरे गेलमन
Chinmayananda Saraswati|स्वामी चिन्मयानन्दः
Raymond Davis Jr.|रेमन्ड डेविस जुनियर
Thomas Hunt Morgan|थामस् हण्ट् मार्गन्
C. F. Powell|सेसिल पावेल
Leo Esaki|लीयो एसाकी
Brian David Josephson|ब्रायन जोसेफसन
John James Audubon|आडुबान् जान् जेम्स्
Owen Chamberlain|ओवेन चेम्बेर्लैन
Riccardo Giacconi|रिक्कर्डो गियाकोनी
Robert I of Scotland|राबर्ट १
Nevill Francis Mott|नेविल एफ मोट्ट
Shashi Tharoor|शशी तरूर
Abul Kalam Azad|मौलाना अबुल् कलाम् आजाद्
Jamnalal Bajaj|जमनालाल बजाज
Patanjali|पतञ्जलिः
K. R. Narayanan|कोचेरिल रामन नारायणन्
Susan Hayward|सूसन् हेवर्ड्
Madan Lal Dhingra|मदनलाल ढीङ्गरा
George V|जार्ज ५
Sridevi|श्रीदेवी
Lara Dutta|लारा दत्ता
Leander Paes|लियाण्डर् पेस्
Khan Abdul Ghaffar Khan|खान् अब्दुल् गफार् खान्
Guru Gobind Singh|गुरुगोविन्दसिंहः
Alan Silvestri|एलन सिल्वेस्ट्री
Shankar Dayal Sharma|शङ्कर दयाल शर्मा
Luther Burbank|लूथर् बर्ब्याङ्क्
Bhaichung Bhutia|बाइचिंग भूटिया
Kumārajīva|कुमारजीव
Donald III of Scotland|डानल्ड ३
Adoor Gopalakrishnan|अदूर गोपालकृष्णन्
Bhagat Singh|भगत सिंहः
H. D. Deve Gowda|एच्. डी. देवे गौडा
Dharmendra|धर्मेन्द्र
Asanga|असङ्ग
P. V. Sindhu|पि.वि सिन्धुः
Noor Inayat Khan|नूर इनायत ख़ान
Vijaya Lakshmi Pandit|विजयलक्ष्मी पण्डित
Dia Mirza|दीया मिर्ज़ा
Aruna Asaf Ali|अरुणा असफ् अलि
Tomasz Kuszczak|थोमस् कूसजैक्
Anderson|एनडरसन
Dadasaheb Phalke|दादा साहेब फाळके
Raghu Vira|रघुवीरः
Anupam Kher|अनुपम खेर
Janamejaya|जनमेजयः
Ashoke Sen|अशोक सेन
Jayaprakash Narayan|जयप्रकाशनारायणः
Gopinath Bordoloi|गोपिनाथ बोर्डोलोयि
Basava|बसवेश्वरः
Badruddin Ajmal|बदरुद्दीन अजमल
Chandragupta I|चन्द्रगुप्तः
Swaminarayan|स्वामी नारायणः
Nana Sahib|नाना साहेब्
Ishwar Chandra Vidyasagar|ईश्वरचन्द्र विद्यासागर
Chidambaram Subramaniam|चिदम्बरम् सुब्रह्मण्यम्
Henri-Émile Bazin|हेन्री ईमिले बजिन
Albert Brenner|आल्बेरट्  ब्रेन्नेर
Jaya Simhavarman III|जयसिंहवर्मन् ४
Chandrakanta|चन्द्रकान्ता
Phanishwar Nath 'Renu'|फणीश्वर नाथ रेणु
Nanalal Dalpatram Kavi|न्हानालाल
Daṇḍin|दण्डी
Maithili Sharan Gupt|मैथिलीशरण गुप्तः
Dwarkanath Tagore|द्वारकानाथट्यागोरः
Emil Holz|एमिले होल्स्त्
Emil Honegger|एमिल होनेग्गर्
Anbumani Ramadoss|अंबुमणि रामदॉस
Gautama Maharishi|गौतमः
Harish-Chandra|हरीश चंद्र
Moon Moon Sen|मुनमुन सेन
Bharavi|भारविः
John III of Nassau-Beilstein|जान् ३ नाम्नः नस्सौ बैल्स्तटैन् वम्शे जातः आसीत्
Melpathur Narayana Bhattathiri|mepathur narayanan
Shreya Ghoshal|श्रेया घोषाल्
K. J. Yesudas|के. जे. येसुदासः
Rameshwari Nehru|रामेश्वरी नेहरू
Thiruvalluvar|तिरुवळ्ळुवरदिनम्
Pritilata Waddedar|प्रीतलता वादेदार
Subhash Ghai|सुभाष घई
Anandavardhana|आनन्दवर्धनः
Otto Eugen Schulz|ओत्तो एउगेन् स्चुल्ज़्
Savitribai Phule|सावित्री
Satya Vrat Shastri|सत्यव्रतशास्त्री
Adil Mansuri|आदिल मन्सुरी
Gargi Vachaknavi|गार्गी
Hemant Kumar|हेमन्तकुमारः
Johan De Groot|जोहान् दे ग्रोओत्
P. A. Sangma|पी.ए. संगमा
Ram Manohar Lohia|राममनोहरलोहिया
Dula Bhaya Kag|दुला भाया काग
Nishkulanand Swami|निष्कुळानन्दस्वामी
Punit Maharaj|महात्मा पुनितः
Makarand Dave|मकरन्द दवे
Dannette Young|देन्नेट्टे यङ्ग्-स्टोन्
Danny Bois|देन्नि बोइस्
Vagbhata|वाग्भटः
Shakuntala Devi|शकुन्तला देवी
Khadga Prasad Oli|केपी ओली
Mohammad Amir|मोहम्मद् अमीर्
Sarada Devi|शारदा देवी
Anuruddha|अनिरुद्ध
Yellapragada Subbarow|यल्लाप्रगडसुब्बरावः
Rahul Dev Burman|राहुल देव बर्मन
Puneeth Rajkumar|पुनीत-राजकुमारः
Girish Karnad|गिरीश कार्नाडः
Dhondo Keshav Karve|धोण्डो केशव कर्वे
Suryakant Tripathi 'Nirala'|सूर्यकान्त त्रिपाठी निराला
Neiphiu Rio|नेफियू रियो
Sarekoppa Bangarappa|एस्. बङ्गारप्पः
Tallapaka Annamacharya|अन्नमाचार्यः
M. Govinda Pai|मञ्जेश्वर गोविन्द पै
Vararuchi|वररुचिः
Kamleshwar|कमलेश्वरः
Mohan Rakesh|मोहन राकेश
Mohan Lal|मोहन लाल
Bhimsen Thapa|भीमसेन थापा
Shurasena|शूरसेनः
|लोमश
Chekitana|चेकितानः
Hanuman Prasad Poddar|हनुमानप्रसाद पोद्दार
Sriharsha|श्रीहर्षः
Sri Gupta|श्रीगुप्तः
Abhishek Banerjee|अभिषेक बनर्जी
Anupriya Patel|अनुप्रिया पटेल
Baijayant Panda|बैजयंत पांडा
Bhanu Pratap Singh Verma|भानु प्रताप सिंह वर्मा
Maitreyi|मैत्रेयी
Chandrakant Khaire|चंद्रकांत भाऊराव खैरे
Chandraprakash Dwivedi|चन्द्रप्रकाश द्विवेदी
Channappa Uttangi|उत्तङ्गि चन्नप्पः
Choudhury Mohan Jatua|चौधरी मोहन जटुया
Devdutt Pattanaik|देवदत्तः पटनायकः
Dimple Yadav|डिम्पल यादव
Durgawati Devi|दुर्गावती देवी
Eddie Myers|एद्दि मय्र्स्
Fasih Mohammed|फासिह् मोहम्मदः
H. R. Vishwasa|विश्वासः हेच् आर्
Harischandra Devram Chavan|हरिश्चंद्र देवराम चव्हाण
Jagdambika Pal|जगदंबिका पाल
Kengal Hanumanthaiah|केङ्गल् हनुमन्तय्यः
Kirit Somaiya|किरीट सोमैया
M. V. Seetharamiah|वि.सीतारामय्यः
Maitreyi Pushpa|मैत्रेयी पुष्पा
Malati Dasi|मालती दासी
Mallikarjun Kharge|मल्लिकार्जुन खडगे
Mandavya|माण्डव्यः
Manoj Tiwari|मनोज तिवारी
Mausam Noor|मौसम नूर
Mohammed Salim|मोहम्मद सलीम
Murali Mohan|मुरली मोहन
Muzaffar Hussain Baig|मुजफ्फर हुसैन बेग
Natubhai Gomanbhai Patel|नाटुभाई गोमनभाई पटेल
Neeraj Shekhar|नीरजशेखरः
P. Karunakaran|पी॰ करुणाकरण
Pooja Hegde|पूजा हेगड़े
R. Dhruvanarayana|आर. ध्रुवनारायणराव
Raghubir Yadav|रघुवीर यादव
Rani Rampal|रानी रामपाल
Rao Inderjit Singh|राव इंद्रजीत सिंह
Ravneet Singh|रवनीत सिंह बिट्टू
Sudeep|सुदीपः
Santosh Gangwar|संतोष गंगवार
Saugata Roy|सौगत रॉय
Shatavadhani Ganesh|शतावधानी डा. आर्. गणेशः
Shyama Charan Gupta|श्याम चरण गुप्ता
Sri Chand|श्रीचन्द्रभगवान्
Sugata Bose|सुगत बोस
Suravaram Pratapareddy|सुरवरम् प्रतापरेड्डी
Tapas Paul|तापस पाल
Thomas Joseph Thorp|टॉम थोर्प
Trevor Beattie|Trevor Beattie
Vijay Kumar Singh|विजय कुमार सिंह
Jaya Rudravarman III|रुद्रवर्मन् ३
Sambhuvarman|शंभुवर्मन्
Indravarman II|इन्द्रवर्मन् २
Maija Vijaya|महा विजय
Vikrantavarman III|विक्रान्तवर्मन् ३
Girindrawardhana|ब्रविजय ६
Bhatta Narayana|भट्ट्नारायणः
Bhadravarman III|भद्रवर्मन् २
|रेने डेस्कार्टे
Wikramawardhana|विक्रमवर्धन
|सती सावित्री
M. I. Shanavas|एम॰आई॰ शानवास
Narhar Ambadas Kurundkar|नरहर अंबादास कुरुंदकर
Allama Prabhu|अल्लमप्रभुजयन्ती
Prakash Babanna Hukkeri|प्रकाश हुक्केरी
Shraddha Kapoor|श्रद्धा कपूर
Pravesh Verma|प्रवेश वर्मा
Nimrat Kaur|निम्रत कौर
Pratap Simha|प्रताप सिम्हा
|अम्बिकादत्तव्यासः
Ram Tahal Choudhary|राम टहल चौधरी
Anil Shirole|अनिल शिरोले
R. K. Singh|राज कुमार सिंह
Prasun Banerjee|प्रसून बनर्जी
Mansukhbhai Vasava|मनसुखभाई वासव
Vytis Vidūnas|वीति: विदून​:
Ashwini Kumar Choubey|अश्विनी कुमार चौबे
DJ Snake|डीजे स्नेक
Satish Chandra Dubey|सतीश चन्द्र दुबे
Devendra Fadnavis|देवेन्द्र फडणवीस
Nityanand Rai|नित्यानंद राय
Krishna Raj|कृष्णा राज
Ram Swaroop Sharma|राम स्वरूप शर्मा
Vinayak Raut|विनायक राउत
Ajay Tamta|अजय टम्टा
Vikram Usendi|विक्रम उसेंडी
Veena Devi|वीणा देवी
Natasja Nobels|Natasja Nobels
Ram Nath Kovind|रामनाथः कोविन्दः
Aparupa Poddar|अपरूपा पोदार
Banshilal Mahto|बंशीलाल महतो
Jasvantsinh Sumanbhai Bhabhor|जसवंतसिंह सुमनभाई भाभोर
Santokh Singh Chaudhary|संतोख सिंह चौधरी
Sunil Kumar Singh|सुनील कुमार सिंह
Tariq Hameed Karra|तारिक़ हमीद कर्रा
Akshay Yadav|अक्षय यादव
Chhotelal|छोटेलाल
Chintamani Malviya|चिंतामणि मालवीय
Mukesh Rajput|मुकेश राजपूत
Heena Gavit|हिना गावित
Ladu Kishore Swain|लादू किशोर स्वाइन
Sanjeev Balyan|संजीव कुमार बालयान
Jeyasingh Thiyagaraj Natterjee|जे॰ जयसिंह थियागराज नत्तेर्जी
Rita Tarai|रीता तराई
Sakuntala Laguri|शकुंतला लागुरी
Gajendrasingh Shekhawat|गजेन्द्र सिंह शेखावत
Vasanthi M|एम॰ वसंती
Arunmozhithevan A|अरुनमोज़ितेवन ए॰
Udhayakumar M|उदय कुमार एम॰
B. V. Nayak|बी॰वी॰ नायक
K. R. P. Prabakaran|के॰आर॰पी॰ प्रभाकरन
Kumaradasa|कुमारदासः
Mayurbhatta|सूर्यशतकम्
|जयादित्यः
Ashok Kumar Walia|अशोक कुमार वालिया
Jayasimha Siddharaja|सिद्धराज जयसिंह
Y. V. Subba Reddy|वाई॰वी॰ सुब्बा रेड्डी
Kailasavadivoo Sivan|कैलासवटिवुशिवन्
Disha Patani|दिशा पटानी
Miguel López González|Miguel López González
Rodrigo Medina Benjumea|Rodrigo Medina Benjumea
Alfonso Toro Buiza|Alfonso Toro Buiza
José Jiménez Jimena|José Jiménez Jimena
Giacomo Tocci|Giacomo Tocci
Rahibai Soma Popere|राहीबाई सोमा पोपेरे
Prem Raj P.|प्रें राज् पु
Fabienne Lupo Magnaudet|Fabienne Lupo Magnaudet
Kelly Vedovelli|Kelly Vedovelli
Yanina Kuskova|Yanina Kuskova
Greta Karasiovaite|Greta Karasiovaite
Joseph Samudio|Joseph Samudio
Dimitrios Christakos|Dimitrios Christakos
Muhammad Shahmir Aiman Abdul Halim|Muhammad Shahmir Aiman Abdul Halim
Sakchai Phodingam|Sakchai Phodingam
Karina Louise Sørensen|Karina Louise Sørensen
Mira Peeters|Mira Peeters
Cybil Di Guistini|Cybil Di Guistini
Anna-Sophia Czilwik|Anna-Sophia Czilwik
Myriam Desrosiers|Myriam Desrosiers
Adéla Vlnova|Adéla Vlnova
Monika Richterova|Monika Richterova
Nicholas Timmings|Nicholas Timmings
Ruth Demeijer|Ruth Demeijer
Chantal Polansky|Chantal Polansky
Liliano Leenknegi|Liliano Leenknegi
Kim Van Gastel|Kim Van Gastel
Nicole Peitzmeier|Nicole Peitzmeier
Jonathan Eric Gustafson|Jonathan Eric Gustafson
Dominik Hufschmid|Dominik Hufschmid
Lorenz Hollenbach|Lorenz Hollenbach
Matthias Grahé|Matthias Grahé
Bruno Schiemann|Bruno Schiemann
Justin Jacob|Justin Jacob
Rasiklal Narsinhdas Parikh|रसिकलाल नरसिंहदास परीख
Tribhuvan vyas|त्रिभुवन व्यास
Wolfgang Amadeus Mozart|वोल्फगांग आमाडेउस मोझार्ट
Ichiro Suzuki|इचिरो सुजुकी
Isaac Newton|ऐसाक् न्यूटन्
John Bardeen|जोह्न बार्डीन
Charles Darwin|चार्ल्स् डार्विन्
Ernest Rutherford|अर्नेस्ट रदरफोर्ड
René Descartes|रने देकार्त
Mahavira|महावीरः
Sachin Tendulkar|सचिनतेण्डुलकरः
Tony Blair|टोनी ब्लेयर
Amitabh Bachchan|अमिताभ बच्चन्
Diana, Princess of Wales|डायना राजकुमारी
Ryan Giggs|रायन गिग्स
Fidel Castro|फिदेल कास्ट्रो
Diego Maradona|डियेगो माराडोना
Muammar Gaddafi|गद्दाफी
Duncan I of Scotland|डंकन १
Ho Chi Minh|हो चि मिन्ह
Tycho Brahe|टैको ब्राहे
T. S. Eliot|टी. एस. एलियट
George Lucas|ज्योर्ज लुकास
Christiaan Huygens|क्रिस्टियन हुगेन्स
William Wordsworth|विलियम वर्ड्सवर्थ
Prem Das Rai|प्रेम दास राई
Ralph Waldo Emerson|राल्फ वाल्डो एमरसन
Linus Pauling|लिनस् पॉलिङ्ग
M. Night Shyamalan|मनोज श्‍यामलन्‌
Edwin Moses|एड्विन् मोसेस्
Sunita Williams|सुनीता विलियम्स्
Samarth Ramdas|समर्थ गुरु रामदास
James Franck|जेम्स फ्रान्क
Otto Stern|आटो स्टर्न
Paul Ehrlich|पाल् एर्लख्
Venkatraman Ramakrishnan|वेङ्कटरामन् रामकृष्णन्
C. V. Raman|चन्द्रशेखर वेङ्कटरामन्
Emma Goldman|एमा गोल्डमन
James Chadwick|जेम्स् चाडविक
Charles I of England|चार्ल्स १
Jean-Baptiste de Lamarck|जीन् ब्याप्टिस्ट् लामार्क्
Mary I of England|मेरी १
Alexander Prokhorov|अलेक्सान्द्र एम प्रोखोरोफ
Buckminster Fuller|बकमिन्स्टर फुलर
Alexander III of Russia|अलेक्ज़ांडर ३
Heinrich Rohrer|हैन्रिक रोह्रेर
John, King of England|जाह्न
Lee Kuan Yew|ली क्वान यु
Henry V of England|हेनरी ५
Amartya Sen|अमर्त्यसेनः
Richard III of England|रिचर्ड ३
Zakir Hussain|जाकिर हुसेन
Guru Dutt|गुरु दत्त
Edward IV of England|एडवर्ड ४
Gustaf Dalén|गुस्टाफ डेलेन
Edward V of England|एडवर्ड ५
Antonio Valencia|अंटोनियो वालेंसिया
Mani Ratnam|मणिरत्‍नम्‌
Chen-ning Yang|चेन निंग यांग
Thomas Henry Huxley|थामस् हेन्रि हक्स्लि
Sin-Itiro Tomonaga|सिन-इतिरो तोमोनागा
Willis Lamb|विलिस इ लाम्ब
Alexei Abrikosov|अलेक्सी ए एबृकोसोफ
Robert B. Laughlin|रोबेर्ट बी लाफलिन
Arthur Leonard Schawlow|आर्थर एल शालो
James Rainwater|जेम्स रेनवाटर
Anthony James Leggett|ए जे लेगेट
Barbara McClintock|बार्बर मेक्लिन्टाक्
Richard Cromwell|रिचर्ड क्रामवेल
Phil Jones|फिल जोन्स
Bhāskara II|भास्कराचार्यः
Arthur Eddington|एड्डिङ्गटन् सर् अर्थर् स्ट्यान्ले
Kalpana Chawla|कल्पना चावला
Macbeth|माकबेथ
Sarojini Naidu|सरोजिनी नायडु
Mallika Sherawat|मल्लिका शेरावत
Marius Manolache|मरियस् मनोलशे
John of Scotland|जाह्न बालियोल
Paramahansa Yogananda|परमहंसयोगानन्‍दः
Kabir|कबीरदासः
Mahesh Bhupathi|महेशभूपतिः
V. V. Giri|वि.वि.गिरिः
John Abraham|जान अब्राहम
Gopal Krishna Gokhale|गोपालकृष्ण गोखले
Bindusara|बिन्दुसारः
Gulzarilal Nanda|गुल्जारीलालनन्दा
Charan Singh|चरणसिंहः
Abhinavagupta|अभिनवगुप्तः
Vyasa|वेदव्यासः
R. K. Narayan|आर. के. नारायणन्
Chandra Shekhar|चन्द्रशेखरः
Ram Mohan Roy|राजा राममोहन राय
Guru Ram Das|गुरु राम दास
Neelam Sanjiva Reddy|नीलम सञ्जीव रेड्डी
Sunil Dutt|सुनील दत्त
Donald II of Scotland|डोनल्ड २
Bismillah Khan|बिस्मिल्ला खानः
Vātsyāyana|वात्स्यायनः
Sushil Koirala|सुशील कोइराला
Andal|आण्डाळ्
M. S. Subbulakshmi|एम्. एस्. सुब्बुलक्ष्मीः
Razia Sultana|सुल्ताना ऱसीया
Dhirubhai Ambani|धीरूभाई अम्बाणी
Bhairon Singh Shekhawat|भैरोंसिंह शेखावत
Naseeruddin Shah|नसीरुद्दीन शाह
Baba Amte|बाबा आमटे
Geeta Dutt|गीता दत्त
MS Dhoni|महेन्द्र सिंह धोनी
Rio Ferdinand|रियो फरडीनेंड
Muhammad Iqbal|मुहम्मद इकबाल
Angiras|अङ्गिराः
Chittaranjan Das|चित्तरञ्जन दास
Lalu Prasad VYadav|लालूप्रसाद यादव
Kapila|कपिलः
Udaya Kumar|उदय कुमार धर्मलिङ्गम्
Chandra Shekhar Azad|चन्द्रशेखर आजादः
Jean Fernel|जीन् फ्रान्स्व फर्नेल्
Reece Brown|रीस ब्राउन
T. P. Kailasam|टी पी कैलासम्
Jaggi Vasudev|सद्गुरु जग्गी वासुदेव
Hamilton Castner|क्यासनर् ह्यामिल्टन् यङ्ग्
Maha Sajan|महा साजन
Charles Sutherland Elton|चार्ल्स् एल्टन्
Yashpal|यशपाल
Viola Paulitz|Viola Müller-Paulitz
Mondino de Liuzzi|माण्डिनो डि लूज्जि
Jagadish Shettar|जगदीशशेट्टर्
Ramanuja|रामानुजाचार्यः
Luíz Filho Jairo|लुश् फिलहो जिरो
Pankaj Advani|पङ्कजाड्वानी
Tyagaraja|त्यागराजः
S. P. Balasubrahmanyam|एस्. पि.बालसुब्रह्मण्यम्
Swami Nithyananda|स्वामी नित्यानन्दः
Kamsa|कंसः
Vishnuvardhan|विष्णुवर्धनः
Nilakantha Somayaji|नीलकण्ठ सोमयाजि
Kirill Ikonnikov|किरिल्ल् इकोन्निकोव
Y Sa Lo|वै सा लो
N. T. Rama Rao|नन्दमूरि तारक रामारावः
Madan Mohan Malaviya|पन्डितमदनमॊहनमालवीयः
Shivaram Rajguru|राजगुरुः
Ahilyabai Holkar|अहिल्याबाई होल्कर
Chandrashekarendra Saraswati|चंद्रशेखरेंद्र सरस्वती
Hazari Prasad Dwivedi|हजारी प्रसाद द्विवेदी
Vijay Merchant|विजय मर्चन्ट
Birju Maharaj|बिर्जू महाराजः
Harihara I|हरिहररायः
Vidyaranya|विद्यारण्य
Gangasati|गङ्गासती
Mulayam Singh Yadav|मुलायम् सिंह यादव्
Kangana Ranaut|कंगना राणावत
Ranjitsinhji|रणजीतसिंहः
Jivraj Narayan Mehta|जीवराज महेता
Anil Kumble|अनिलकुंबले
Ramdhari Singh Dinkar|रामधारी सिंह दिनकर
Suriya|सूर्या
Baudhayana|बोधायनः
Rajnath Singh|राजनाथसिंहः
Akka Mahadevi|अक्कमहादेवी
Mallika Sarabhai Shah|मल्लिका साराभाय्
Sam Pitroda|सेम पित्रोडा
Sudha Murthy|सुधा मूर्ती
Samantha Akkineni|समन्ता रुत् प्रभु
Dinesh Trivedi|दिनेश त्रिवेदी
Kittur Chennamma|कित्तूरु चेन्नम्मा
Vaman Shivram Apte|वामनशिवराम-आप्टे
Sunderlal Bahuguna|सुन्दरलाल बहुगुणा
Madhukar Dattatraya Deoras|मधुकर दत्तात्रेय देवरस
C. Narayana Reddy|सि नारयणरेड्डि
V. K. Gokak|वि.कृ.गोकाकः
Sakthibhadran|शक्तिभद्रः
Laxmi Prasad Devkota|लक्ष्मीप्रसाद देवकोटा
Arun Jaitley|अरुण जेटली
Bhisham Sahni|भीष्म साहनी
Ramchandra Shukla|रामचन्द्र शुक्ल
Amarinder Singh|अमरिंदर सिंह
Rayapati Sambasiva Rao|रायपती सांबशिव राव
Vyasatirtha|व्यासरायः
Bruna Abdullah|ब्रुना अब्दुल्लाह
A. Sampath|ए॰ सम्पत्त
Yogi Adityanath|योगी आदित्यनाथ
Adriaen Honich|Adriaen Honich
Aluru Venkata Rao|आलूरु वेङकटरावः
Anandiben Patel|आनन्दीबेन पटेल
Veerendra Heggade|वीरेन्द्र हेग्गडे
Janaki Ammal|जानकी अम्माल्
Bhagwant Maan|भगवंत मान
Brij Bhushan Sharan Singh|ब्रिज भूषन कारण सिंह
Dalpat Singh Paraste|दलपतसिंह परस्ते
S. L. Bhyrappa|एस्. एल्. भैरप्पः
Dharmendra Yadav|धर्मेन्द्र यादव
Dileep Singh Bhuria|दिलीप सिंह भूरिया
E. T. Mohammed Basheer|इ॰टी॰ मुहम्मद बशीर
Maha Saya|महा शय
Gajanan Kirtikar|गजानन कीर्तिकर
Ganesh Singh|गणेश सिंह
Ganga Das|गङ्गादासः
Govind Ballal Deval|गोविंद बल्लाळ देवल
Madhavrao I|माधवराव पेशवा
Pawan Kalyan|पवनकल्याणः
Vijayavarman|विजयवर्मन्
Jay Prakash Narayan Yadav|जय प्रकाश नारायण यादव
Jual Oram|जुएल उरांव
Kyasamballi Chengaluraya Reddy|चेङ्गलराय रेड्डी
K. H. Muniyappa|के.एच. मुनीअप्पा
Kadiyam Srihari|कडियम श्रीहरी
Kuttikrishna Marar|कुट्टिकृष्णमारारः
Lalubhai Patel|लालूभाई पटेल
Nihalchand Chauhan|निहालचन्द चौहान
P. Lankesh|पी लङ्केशः
Phakirappa Gurubasappa Halakatti|फ.गु. हलकट्टिः
Pirojsha Godrej|पिरोजशाह गोदरेज
Prabhavati Devi|प्रभावती देवी
Pujya Mota|पूज्य मोटा
Puttaraj Gawai|पुट्टराज गवायी
Rajiv Satav|राजीव शंकरराव सातव
Rakul Preet Singh|रकुल प्रीत सिंह
Rallapalli Anantha Krishna Sharma|रालपल्लि अनन्तकृष्णशर्मा
Ranjeet Ranjan|रंजीत रंजन
Veene Sheshanna|वीणाविशारदः शेषण्णः
Vishnugupta|विष्णुगुप्तः
Samyukta|संयोगिता चौहान
Sannappa Parameshwar Gaonkar|सण्णाप्पा परमेश्वर गावकर
Shishunala Sharif|शिशुनाऴषरीफः
Siddharth Varadarajan|सिद्धार्थ वरदराजन्
Subhadra Joshi|सुभद्राजोशी
Sultan Ahmed|सुल्तान अहमद
TS Venkannaiah|तलुकिन वेङकण्णय्यः
Udupi Ramachandra Rao|यु.आर्.राव्
Vishnu Moreshwar Mahajani|विष्णु मोरेश्वर महाजनी
Vishpala|विश्पला
Dhana Nanda|धनानन्दः
Michael King|माइकल कीन
|इन्द्रवर्मन्
Śiksānanda|Śikṣānanda
Vaidehi|Vaidehī
Anicia Proba|Anicia Proba
|इन्द्रशैलेन्द्रः
|जयहरिवर्मन् ६
Paramabhodisatva|परमबोधिसत्त्व
Bhadravarman III|भद्रवर्मन् ३
|जय इन्द्रवर्मन् ५
Jaya Indravarman III|जय इन्द्रवर्मन् ६
Shivmangal Singh Suman|शिवमंगल सिंह 'सुमन'
G. M. Siddeswara|जी.एम. सिद्देश्वर
Papineni Sivasankar|पापिनेनि शिवशंकरः
K. C. Venugopal|के॰सी॰ वेणुगोपाल
Maharani Chakravorty|maharani chakravorty
|मेरी प्रथम
Nand Kumar Singh Chauhan|नन्द कुमार सिंह चौहान
Dinesh Kashyap|दिनेश कश्यप
Mammata Bhatta|मम्मटः
Uday Pratap Singh|उदय प्रताप सिंह
Sukhbir Singh Jaunapuria|सुखबीर सिंह जौनपुरिया
Anju Bala|अंजू बाला
Riti Pathak|रीति पाठक
Virendra Kumar Choudhary|वीरेन्द्र कुमार चौधरी
Anshul Verma|अंशुल वर्मा
Choudhary Babulal|बाबूलाल
Dushyant Chautala|दुष्यंत चौटाला
Gokaraju Ganga Raju|गोकराजू गंगा राजू
C. S. Puttaraju|सी॰एस॰ पुत्ताराजू
Jayant Sinha|जयंत सिन्हा
Kamalbhan Singh Marabi|कमलभान सिंह मरावी
Kesineni Srinivas|केशिनेनि श्रीनिवास
Balabhadra Majhi|बलभद्र माझी
Rama Kishore Singh|राम किशोर सिंह
Ranjit Singh Brahmpura|रणजीत सिंह
Ravindra Kumar Ray|रविन्द्र कुमार राय
Saumitra Khan|सौमित्र खान
Tamradhwaj Sahu|ताम्रध्वज साहू
Varaprasad Rao Velagapalli|वरप्रसाद राव वेलगपल्लि
B N Chandrappa|बी॰एन॰ चन्द्रप्पा
Bhagirath Prasad|भागीरथ प्रसाद
Keshav Prasad Maurya|केशव प्रसाद मौर्य
Lallu Singh|लल्लू सिंह
Ram Charitra Nishad|राम चरित्र निषाद
Sharad Bansode|शरद बनसोडे
Sankar Prasad Datta|शंकर प्रसाद दत्ता
G. Hari|हरि जी॰
Shrirang Barne|श्रीरंग बरने
P.R. Senthilnathan|पीआर सेंथिलनाथान
Mahendran C|सी॰ महेन्द्रन
Selvakumara Chinnayan S|सेल्वाकुमारा चिन्नयन एस॰
Kalyan Banerjee|कल्याण बनर्जी
J. Jayavardhan|जे॰ जयवर्धन
Panje Mangesh Rao|पञ्जेमङ्गेशरायः
Dainius Razauskas|दैन्युः रजौस्कः
Jürg Stäubli|Jürg Stäubli
Sadhu Singh|साधु सिंह
Alain de Chambrier|Alain de Chambrier
Eusebio Calonge Francés|Eusebio Calonge Francés
Joaquín Pla Laporta|Joaquín Pla Laporta
Shamba Joshi|शं.बा.जोशी
Basanti Devi Bisht|बसन्ती बिस्ट्
Alex Emanuel|एलेक्स इमानुएल
Mohammed Hanif Khan Shastri|महम्मद् हनीफ् खान् शास्त्री
Jacopo Orsini|Jacopo Orsini
Victor-Charles-Émile Dain|Victor-Charles-Émile Dain
Ilene Marckx|Ilene Marckx
Lianne Witkin|Lianne Witkin
Teodor Rusev|Teodor Rusev
Rokas Kmieliauskas|Rokas Kmieliauskas
Marc Oliver Pritzen|Marc Oliver Pritzen
Tsveta Nesheva|Tsveta Nesheva
Doreen Weise|Doreen Weise
Nele Van Den Bossche|Nele Van Den Bossche
Sandra Degueldre|Sandra Degueldre
Claudia Marietta|Claudia Marietta
Karry Ellen Hellmuth|Karry Ellen Hellmuth
Patricia Hempel|Patricia Hempel
Ann Roegiers|Ann Roegiers
Saskia Van Duuren|Saskia Van Duuren
Marieke Haverdings|Marieke Haverdings
Luisiana Pegoraro|Luisiana Pegoraro
Erika Schertl|Erika Schertl
Deira Mari|Deira Mari
Nadia Zuccherelli|Nadia Zuccherelli
Silvia Zoller|Silvia Zoller
Elfie Kunz|Elfie Kunz
Karin Avenant|Karin Avenant
Ljudmilla Corneo|Ljudmilla Corneo
Cornelia Dreher|Cornelia Dreher
Mārtiņš Bots|Mārtiņš Bots
Detelina Marinova|Detelina Marinova
Dawn Richardson Wilson|Dawn Richardson Wilson
Mike Evelyn|Mike Evelyn
Kenny Weyh|Kenny Weyh
Joyce Echaquan|Joyce Echaquan
Adolf Hitler|ऐडॉल्फ़ हिटलर
Victor Hugo|विक्टर ह्यूगो
Genghis Khan|चंगेज़ ख़ान
Leonardo da Vinci|लियोनार्दो दा विन्सी
Mahatma Gandhi|महात्मा गान्धिः
Patrice Evra|पाटरीस एव्रा
Huang Xianfan|सियानफ़ां हुआंग
Che Guevara|चे ग्वेएरा
Carl Friedrich Gauss|कार्ल फ्राइडरिक गास
Alan Turing|एलेन ट्यूरिंग
Vasco da Gama|वास्को ड गामा
Vladimir Putin|व्लाडिमिर पुटिन
Sergei Eisenstein|सेर्गे आइसेन्स्टाइन
Martin Luther King Jr.|मार्टिन् लूथर् किङ्ग्
Alexander the Great|सिकन्दर महान
Otto von Bismarck|ओट्टो वॉन बिस्मार्क
Timur|तैमुरलंग
Simón Bolívar|साइमन बोलीवार
Walt Disney|वाल्ट डिज्नी
Thomas Alva Edison|थॉमस एडिसन
Nikola Tesla|निकोला टेस्ला
Sigmund Freud|सिग्मण्ड् फ़्रुड्
Georg Wilhelm Friedrich Hegel|जार्ज विल्हेम फ्रेडरिच हेगेल
Gautama Buddha|गौतम बुद्धः
Vallabhbhai Patel|सरदार् वल्लभभायी पटेलः
Rahul Gandhi|राहुल् गान्धी
Dadabhai Naoroji|दादाभाई नवरोजि
Pythagoras|पैथागोरस्
Ashley Young|एश्ली यंग
Alexander I of Russia|अलेक्ज़ांडर १
Edward VII|एडवर्ड ७
Benito Mussolini|बेनितो मुसोलिनी
Shaka Zulu|शाका ज़ूलू
Ignacy Łukasiewicz|इग्नेसी ल्युकसिविक्ज
Kanada|कणादः
Aung San Suu Kyi|अङ्ग सान् सू की
Madhubala|मधुबाला
Asha Bhosle|आशा भोंसले
Karl Benz|कार्ल बेन्ज़
Henri Becquerel|हेन्री बेक्वेरल
Viswanathan Anand|विश्वनाथन् आनन्दः
Raden Wijaya|कीर्तिराजस जयवर्धनः
Shyam Benegal|श्याम बेनेगल
Maria Goeppert Mayer|मारिया गोपर्ट-मेयर
Daniel Ortega|डानियेल् ओरटेगा
S. M. Krishna|एस्. एम्. कृष्णः
Horst Ludwig Störmer|हर्स्ट एल स्टोर्मर
Megawati Sukarnoputri|मेघावती सुकर्णोपुत्री
Pieter Zeeman|पीटर ज़ीमन
Donald Arthur Glaser|डोनाल्ड ए ग्लेसर
Charles-Augustin de Coulomb|चार्ल्स् -अगस्टीन् डि कूलुम्ब
Leon Cooper|लीयों नील कूपर
Edward VI of England|एडवर्ड ६
William Harvey|विलियं हार्वे
Percy Bysshe Shelley|पर्सी बिश शेली
Rachel Carson|रेचेल कार्सन
A. R. Rahman|ए. आर्. रहमान्
Madhava of Sangamagrama|माधवः (ज्योतिर्विद्)
Lulach|लूलाक
Niels Henrik Abel|नेल्स् हेन्रिक् एबल्
M. G. Ramachandran|एम् जि रामचन्द्रन्
William III|विलियम ३
Mary, Queen of Scots|मेरी १
Nutan Bahl|नूतन
Rajneesh|रजनीशः
David De Gea|डेविड दे हेया
Deepika Padukone|दीपिका पडुकोणे
Henry VI of England|हेनरी ६
Henry IV of England|हेनरी ४
Percy Williams Bridgman|पर्सी ब्रिजमन
Steven Weinberg|स्टीवन वैनबर्ग
Patrick Blackett, Baron Blackett|पेट्रिक एम एस ब्लाकेट
Hastings Banda|हास्टिंग्स बान्डा
Michael Servetus|मिग्नेल् सर्वेटस्
Rafael Pereira da Silva|राफ़ाएल
Philip W. Anderson|फिलिप दबल्यु एन्डरसन
Leon M. Lederman|लीयोन एम लीडरमन
Rajendra Prasad|राजेन्द्रप्रसादः
Jonas Salk|जोनास् एड्वर्ड् साक्
Brahmagupta|ब्रह्मगुप्तः
Gerty Cori|जेर्टि थेरेसा कोरि
Carl Wieman|कार्ल इ वैमन
Rajendra Chola I|राजेन्द्रचोळः
Fábio Pereira da Silva|फेबियो
Harsha|हर्षवर्धनः
Léon Bourgeois|leon bourgeois
Darron Gibson|डैरेन गिब्सन
BoA|बोअ क्वोन्
Akshay Kumar|अक्षय् कुमार्
James I of Scotland|जेम्स १
Mindaugas|मिन्दौगः
H. D. Kumaraswamy|एच्. डी. कुमारस्वामी
Gurinder Chadha|गुरिन्दर चड्डा
Shilpa Shetty|शिल्पा शेट्टी
Robert III of Scotland|राबर्ट ३
Herophilos|हीरोफिलस्
Aśvaghoṣa|अश्वघोषः
Jyotirao Phule|ज्योतिबा फुले
Vasubandhu|वसुबन्भु
Girolamo Fracastoro|जिरोलावो फ्राकास्टोरो
Rakesh Sharma|राकेश शर्मा
Zail Singh|जैल सिंह
El hijoeputa más famoso|डॉनियल गोलमन्
Guru Arjan|गुरु अर्जुन दास
Annada Shankar Ray|अन्नदाशंकर राय
C. Rajagopalachari|चक्रवर्ती राजगोपालाचार्यः
D. K. Pattammal|डि. के. पट्टम्माळ्
Mata Amritanandamayi|माता अमृतानन् दमयी
J. R. D. Tata|जे.आर्.डि.टाटा
Udit Narayan|उदित नारायण
Tansen|तानसेनः
Kishore Kumar|किशोरकुमारः
Rani Mukherjee|रानी मुखर्जी
Humayun|हुमांयू
Dignāga|दिङ्नागः
Aryadeva|आर्यदेव
K. S. Sudarshan|के.एस्.सुदर्शनजी
Guru Har Rai|गुरु हर राय
Naushad|नौशादः
Gangubai Hangal|गङ्गूबायी हानगल्
Sayana|सायणः
Yash Johar|यश जौहर
Kumārila Bhaṭṭa|कुमारिल भट्ट
B. S. Yeddyurappa|बी.एस. येडियुरप्पा
Dattatreya|दत्तात्रेयः
Bhumibol Adulyadej|भूमिबलः अतुल्यतेजस्
Chaitanya Mahaprabhu|चैतन् य महाप्रभु
Purushottam Das Tandon|पुरुषोत्तमदासः टण्डन्
Hrodgaud of Friuli|फ़्रिउलिय ह्रोद्गुद्
Yāska|यास्कः
Calvin S. Brice|कॅल्विन एस् ब्रॅस्
D. V. Sadananda Gowda|डी. वी. सदानन्द गौडः
Jaishankar Prasad|जयशंकर प्रसाद
Narayana Guru|नारायणगुरुः
Śūdraka|शूद्रकः
Ram Gopal Varma|रामगोपाल वर्मा
Shivkumar Sharma|शिवकुमार शर्मा
Pingali Venkayya|पिङ्गली वेङ्कैया
Mani Madhava Chakyar|माणिमाधवचाक्यारः
Lala Lajpat Rai|लाला लाजपत राय
Sabeer Bhatia|सबीर भाटिया
Shyamji Krishna Varma|श्यामजीकृष्णवर्मा
Muthuswami Dikshitar|मुत्तुस्वामी दीक्षितः
Nirmal Verma|निर्मल वर्मा
Guru Tegh Bahadur|गुरु तेगबहादुर
Shanta Kumar|शांता कुमार
Shaunaka|शौनक
Jacqueline Fernandez|जैकलिन फर्नांडीस
Annapurna Devi|अन्नपूर्णा
Thirunalloor Karunakaran|तिरुनल्लूर करुणाकरन्
Shrutakarma|श्रुतकीर्तिः
C. Aswath|सि अश्वत्थः
Namdev|साधुः नामदेवः
Pandurang Vaman Kane|पण्डुरङ्ग वामन काणे
Ramananda|गुरु रामानन्द
Sivaya Subramuniyaswami|सत्गुरु शिवाय सुब्रमुनियस्वामी
Kanaiyalal Maneklal Munshi|कनैयालाल मुनशी
Sunidhi Chauhan|सुनिधि चौहान्
Pratap Singh I|महाराणा प्रतापसिंहः
Kirti Azad|कीर्ति आज़ाद
Varun Gandhi|वरुण गांधी
Mahendra Kapoor|महेन्द्र कपूरः
Moraridas Hariyani|मोरारी बापु
Venibhai Purohit|वेणीभाइ पुरोहीत्
Anandi Gopal Joshi|आनन्दीबाई गोपालराव जोशी
Arvind Gaur|अरविन्द गौड़
Bidhan Chandra Roy|बिधाचन्द्रः रायः
Salim Ali|डा. सालिम् अलिः
M. S. Golwalkar|माधव सदाशिवराव गोलवलकर
Danny Bilson|देन्नि बिल्सन्
Prabhas|प्रभासः
Asaduddin Owaisi|असादुदीन ओवैसी
Nagoji Bhatta|नागेशभट्टः
Kalpana Datta|कल्पना दत्त
Kuvempu|कुवेम्पु
Kumarapala|कुमारपाल
Kailash Satyarthi|कैलाश सत्यार्थी
Veerappa Moily|एम. वीरप्पा मोईली
Jadav Payeng|यादवपायेङ्ग्
Appayya Dikshita|अप्पय्यदीक्षितः
Mullappally Ramachandran|मुलापल्ली रामचंद्रन
Masti Venkatesha Iyengar|मास्ति वेङ्कटेश ऐय्यङ्गार्यः
Viswanatha Satyanarayana|विश्वनाथ सत्यनारायण
Chandrashekhara Kambara|चन्द्रशेखर कम्बारः
Talat Mahmood|तलत् महमूदः
A. R. Raja Raja Varma|आ॰ रा॰ राजराजवर्मा
Shiv Kumar Batalvi|शिव कुमार बटालवी
B. C. Khanduri|भुवन चन्द्र खण्डूरी
Ghanshyam Das Birla|घनश्याम दास बिड़ला
Govind Chandra Pande|गोविन्द चन्द्र पाण्डे
Vishnu Prabhakar|विष्णु प्रभाकर
Shamshad Begum|शमसाद बेग़म
Katie Stevens|Katie Stevens
Muddana|मुद्दणः
Bhartruhari Mahtab|भर्तुहरी महताब
Adriaen Cornelisz Beeldemaker|Adriaen Cornelisz Beeldemaker
Anna Chandy|अन्न चाण्डि
Baji Rao II|बाजीराव २
Bhadda Kapilani|Bhadrā-Kapilānī
Bijoya Chakravarty|विजय चक्रवर्ती
Chandu Lal Sahu|चंदूलाल साहू
D. Devaraj Urs|डि देवराज अरसु
Devudu Narasimha Sastri|देवुडु नरसिंहशास्त्री
Dilipkumar Mansukhlal Gandhi|दिलीपकुमार मनसुखलाल गांधी
Bhadravarman I|भद्रवर्मन् १
Hansraj Gangaram Ahir|हंसराव गंगाराम अहीर
Tulasi Munda|तुलसी मुंडा
Indravarman V|इन्द्रवर्मन् ९
Indu Jain|इंदु जैन
K. V. Thomas|के॰वी॰ थॉमस
Kakoli Ghosh Dastidar|कल्कली घोष
Kalraj Mishra|कलराज मिश्र
Konakalla Narayana Rao|कोनाकल्ला नारायण राव
Madhav Gadgil|माधव गाडगीळ
Manohar Shyam Joshi|मनोहर श्याम जोशी
Mekapati Rajamohan Reddy|एम॰ राजामोहन रेड्डी‎
Nalin Kumar Kateel|नलिन कुमार कटील
Naraharitirtha|नरहरितीर्थः
P. K. Sreemathy|पी॰के॰ श्रीमती
P. T. Narasimhachar|पु ति नरसिंहाचार्यः
Prahlad Singh Patel|प्रहलाद सिंह पटेल
Manmohan Acharya|manmohan achraya
Ramen Deka|रामेन डेका
Ravindra Kumar Pandey|रविन्द्र कुमार पाण्डेय
Ravji Patel|रावजी पटेल
Rohit Bal|रोहित बहल
S. L. Kirloskar|शांतनुराव लक्षमण्राव किर्लोस्कर
S. P. Y. Reddy|एस॰पी॰वाई॰ रेड्डी
Sandhya Roy|संध्या रॉय
Sarabjit Singh|सरब्जित् सिङ्ग्
Satya Nadella|सत्य नाडेला
Shobha Karandlaje|शोभा कारनदलाजे
Sukumar Sen|सुकुमार सेन
Suresh Angadi|अंगदि सुरेश चन्नाबसप्पा
Tirumalamba|तिरुमलाम्बा
Veerendra Patil|वीरेन्द्र पाटीलः
Vidyakara|सुभाषितरत्नकोशः
Vinod Kumar Boianapalli|विनोद कुमार बोयनापल्ली
Virendra Saxena|वीरेन्द्र सक्सेना
Vishnu Pandya|विष्णुः पण्ड्या
Devavarman|देववर्मन्
Vikrantavarman II|विक्रान्तवर्मन् २
Saṃghavarman|Saṃghavarman
Kalayasas|Kālayaśas
Gangaraja|गङ्गाराजः
Manorathavarman|मनोरथवर्मन्
|विष्णुशैलेन्द्रः
Po Saktiray Daputih|शक्तिरैदपुति
Subandhu|सुबन्धुः
Kalpana|कल्पना
R. R. Diwakar|रं.रा.दिवाकरः
Kanteerava Narasimharaja Wadiyar|श्री कण्ठीरवः नरसिंहराज ओडेयर् बहद्दूरः
Jnananjan Niyogi|ज्ञानांजनं नियोगी
Tapas Sen|तपस् सेन्
M. Kantaraj Urs|कान्तराज अरसः
|ए. आर्. गोपाल अय्यङ्गारः
Brij Basi Lal|बृजबासीलालः
Rattan Lal Kataria|रतन लाल कटारिया
Haribhai Parthibhai Chaudhary|हरिभाई चौधरी
Chhedi Paswan|छेदी पासवान
Jyotiraditya Scindia|ज्योतिरादित्य सिंधिया
Gaurav Gogoi|गौरव गोगोई
Ashwini Kumar Chopra|अश्विनी कुमार
Bodh Singh Bhagat|बोध सिंह भगत
Subhash Bhamre|सुभाष रामराव भामरे
Chirag Paswan|चिराग पासवान
Harish Meena|हरीशचन्द्र मीणा
Anoop Mishra|अनूप मिश्रा
Priyanka Singh Rawat|प्रियंका सिंह रावत
Giriraj Singh|गिरिराज सिंह
Vinodbhai Chavda|विनोद चावड़ा
Vishnu Dayal Ram|विष्णु दयाल राम
Brij Bihari Chaubey|व्रजविहारिचतुर्वेदः
Arvind Sawant|अरविंद सावंत
Devusinh Jesingbhai Chauhan|देवसिंह चौहान
P. V. Midhun Reddy|पी॰वी॰ मिधुन रेड्डी
Santosh Kumar|संतोष कुमार
Vijay Sampla|विजय सांपला
Nagendra Kumar Pradhan|नगेन्द्र कुमार प्रधान
Bharat Singh|भरत सिंह
Harish Dwivedi|हरीश द्विवेदी
Dharmendra Kashyap|धर्मेन्द्र कश्यप
Kaushal Kishore|कौशल किशोर
P P Choudhary|पी॰पी॰ चौधरी
Hemant Godse|हेमन्त गोडसे
Sumedhanand Saraswati|सुमेधानन्द सरस्वती
R.Parthipan|आर॰ पार्थीपन
Maragatham K|मरगतम के॰
Thomas Velley|Thomas Velley
Satyapal Singh Saini|सत्यपाल सिंह
Arun Kumar|अरुण कुमार
Harivansh Singh|कुँवर हरिवंश सिंह
|सियाचिन
Indumati Babuji Patankar|इंदुमती बाबूजी पाटणकर
|वीर बन्दा वैरागी
Amrut Rao|अमृतराव
Birender Singh Dhanoa|बिरेन्द्र सिम्ह धनोआ
Vigraharaja IV|विग्रहराज चौहान
Arnoraja|अर्णोराज चौहान
Pablo Pintado|Pablo Pintado
Nadir Alvarez|Nadir Alvarez
Frank Hauenschild|Frank Hauenschild
Apastamba|आपस्तम्ब
Harnath Singh Yadav|हरनाथसिंहयादवः
|Śaṅkarasvāmin
Wang Jian|वङ्ग जिअन्
Sylvia Hoffman|Sylvia Hoffman
Chandni Khan|चांदनी खान
Elattur Sundararaja Bhattacharya|एलत्तूर् सुन्दरराज भट्टाचार्यः
Liam Christie|Liam Christie
Keaan Van Venrooij|Keaan Van Venrooij
Cristina Michelle Mata Pitti|Cristina Michelle Mata Pitti
Nikola Levkov|Nikola Levkov
Virag Buzsaki|Virag Buzsaki
Jennifer Manefield|Jennifer Manefield
Caroline Payot-Podevin|Caroline Payot-Podevin
Rhonda Quick|Rhonda Quick
Letizia Giardinelli|Letizia Giardinelli
Valentina Poli|Valentina Poli
Maya Escolar|Maya Escolar
Simone Trafelet|Simone Trafelet
Tara Mulder|Tara Mulder
Cindy Bauwens|Cindy Bauwens
Gitana Gruodyte|Gitana Gruodyte
Ruth Ellway|Ruth Ellway
Moira Tarraran|Moira Tarraran
Carolyn Maxwell|Carolyn Maxwell
Juri Gatt|Juri Gatt
Ionuț Șișcanu|Ionuț Șișcanu
Natalia Jamróz|Natalia Jamróz
Sebastian Mitterer|Sebastian Mitterer
Phil Harres|Phil Harres
Jannis Maul|Jannis Maul
Barack Obama|बराक ओबामा
Lech Wałęsa|लेक वलेंसा
Napoleon|नेपोलियन बोनापार्ट
Louis Pasteur|लूयीस् पाश्चर्
Joseph Stalin|जोसेफ़ स्टालिन
Jawaharlal Nehru|जवाहरलाल नेह्रू
Charles de Gaulle|चार्ल्स द गॉल
Mustafa Kemal Atatürk|मुस्ताफ़ा केमल्
Bill Gates|बिल गेट्स
Gustav Mahler|गुस्तावः मालेरः
Richard Stallman|रिचार्ड स्टालमन
Franklin Delano Roosevelt|फ़्राँक्लिन रुज़वेल्ट
Henry Ford|हेन्री फोर्ड
Joseph Fourier|जोसेफ फोरिए
Johannes Kepler|योहानेस केप्लर्
Gottfried Wilhelm Leibniz|गाटफ्रीड लैबनिट्ज़
Immanuel Kant|इमान्युएल काण्ट
Adam Smith|एडम स्मिथ
Mame Biram Diouf|मामे बिराम दिउफ़
Raja Ramanna|राजा रामण्णा
Linus Torvalds|लाइनस टोर्वाल्ड्स
Catherine II of Russia|महारानी काथरिन
Guglielmo Marconi|गुग्लिमो मार्कोनी
Pierre Curie|पिएरे क्युरी
Aishwarya Rai|ऐश्वर्या रै
J. J. Thomson|जे जे थामसन
Wawa of Mataram|वावा
Pratibha Patil|प्रतिभा पाटिल
Rambhadracharya|जगद्गुरुरामभद्राचार्यः
Kedar Joshi|केदार जोशी
Wolfgang Pauli|वुल्फगांग पौली
Walther Bothe|वाल्थेर बोथे
Theodor Schwann|थियोडोर् स्छ्वान्
Matthias Jacob Schleiden|म्याथयास् जेकब् ष्लेडन्
Gerd Binnig|गेर्ड बिन्निग
Dharmarakṣa|Dharmarakṣa
James VI and I|जेम्स १
Joseph-Louis Lagrange|जोसेफ़ लुयि लग्राञ्जे
John Keats|जान कीट्स
Samuel Taylor Coleridge|सेम्येल टेलर कोलरिज
Srinivasa Ramanujan|श्रीनिवासरामानुजम्
Louis de Broglie|लुइस डे ब्रोग्ली
James D. Watson|जेम्स् डि व्याट्सन्
Luc Montagnier|लक मन्टेगेनियरः
Ravi Shankar|पण्डितः रविशङ्करः
Edward Calvin Kendall|एड्वर्ड् क्याल्विन् केण्डल्
William Thomson, 1st Baron Kelvin|केल्विन् विलियं थाम्सन् लार्ड्
Arthur Compton|आर्थर एच काम्पटन
Michael Owen|माइकल ओवेन
William IV|विलियम ४
Lawrence Bragg|विलियम लारेन्स ब्राग
Lev Landau|लेव लाण्डौ
Zakir Hussain|ज़ाकिर् हुसैन्
Amrita Sher-Gil|अमृता शेरगिल
Dennis Gabor|डेनिस गाबोर
Manna Dey|मन्ना डे
Zubin Mehta|जुबीन मेहता
Juhi Chawla|जूही चावला
Hugo de Vries|ह्यूगो द व्रीस्
Birendra of Nepal|नेपालस्य बीर् बिक्रम शाह देव्
Sonia Gandhi|सोनिया गान्धी
Albert Sabin|आल्बर्ट् स्याबिन्
Sumitranandan Pant|सुमित्रानन्‍दन पन्‍त
Adi Shankara|आदिशङ्कराचार्यः
Charles Hard Townes|चार्ल्स् एच् टाउन्स्
Maurice Wilkins|मारीस् एच् विल्किन्स्
Julian Schwinger|जुलियन श्विंगर
Carlo Rubbia|कार्लो रुबिया
Panini|पाणिनिः
William Daniel Phillips|विलियम डी फिलिप्स
Frederick Reines|फ्रेडेरिक रेन्स
Gaspard-Gustave de Coriolis|ग्यास्पर्डड-गुस्ताव डि कोरियोलिस
Morarji Desai|मोरारजी देसायी
Rich Swann|रिच् स्वन्न्
Dayananda Saraswati|स्वामी दयानन्दसरस्वती
Marcello Malpighi|मार्सेलो माल्पीगिः
David II of Scotland|डेविड २
P. V. Narasimha Rao|पी वी नरसिंहरावः
Ambroise Paré|आम्ब्रोस् पारे
Ramdev|बाबा रामदेवः
Ramana Maharshi|रमणमहर्षिः
Bal Gangadhar Tilak|बालगङगाधरतिलकः
Anil Kapoor|अनिलकपूरः
Vishwanath Pratap Singh|विश्वनाथ प्रतापसिंह
Christian Michelsen|क्रिस्टियन माइकेल्सेन
Jayadeva|जयदेवः
Mohammad Hamid Ansari|महम्मद हामिद आन्सारि
Erasistratus|एरासिस्ट्राटस्
Vikram Seth|विक्रम सेठ
Narayan Gopal|नारायणगोपाल गुरुवाचार्य
Annie Besant|एनी बेसन्ट्
Lakshmi Sahgal|लक्ष्मी सहगल
Kanimozhi|कनिमोऴि
Karanam Malleswari|कर्णममल्लेश्वरी
Ravi Shankar|श्री श्री रविशङ्करः
Kumaragupta I|प्रथम कुमारगुप्तः
Rahul Dravid|रहुल् द्रविड्
Bachendri Pal|बचेन्द्री पाल
Kumaraswami Kamaraj|कुमारस्वामी कामराज्
Babul Supriyo|बाबुल सुप्रियो
Kapil Dev|कपिलदेवः
Sourav Ganguly|सौरभ गाङ्गुली
Narayana Pandit|नारायण पण्डित
Kamalaśīla|Kamalaśīla
Larnell Cole|लार्नेल कोल
Ernst Stojaspal|Ernst Stojaspal
Babur|बाबर्
Varāhamihira|बृहत्संहिता
Vasudeva|वसुदेवः
Buddhapālita|Buddhapālita
Mahadev Govind Ranade|महादेवगोविन्द रानडे
Sunil Shetty|सुनील शेट्टी
Tim Thomas|तीं  थोमस
Sthiramati|Sthiramati
Vajrabodhi|Vajrabodhi
Śubhakarasiṃha|Śubhakarasiṃha
Maitreya-nātha|Maitreyanātha
Jordan Schroeder|जोर्दन् ष्रोएदेर्
Stina Martini|स्टिना मर्टिनि
O. P. Nayyar|ओ. पी. नय्यरः
Manjul Bhargava|मञ्जुल भार्गव
Naresh Mitra|नरेश मित्रा
Gopal Swarup Pathak|गोपाल स्वरूप पाठक
Sushma Swaraj|सुषमा स्वराज
Krishna Baldev Vaid|कृष्ण बलदेव वैद
Raveena Tandon|रवीना टंडन
K. S. Chithra|चित्रा
Dharmananda Damodar Kosambi|धर्मानन्द दामोदर कोसम्बी
Purandara Dasa|पुरन्दरदासः
Durvasa|DHURVASAMUNI
Magha|महाकविः माघः
Sachchidananda Vatsyayan|सच्चिदानन्द वात्स्यायन
Eknath|संत एकनाथ
Mahendravarman|महेन्द्रवर्मन्(चम्पा)
Lalleshwari|लल्लेश्वरी
Akha Bhagat|अखो
Ram Prasad Bismil|रामप्रसाद बिस्मिलः
Jaimini|जैमिनिः
Ramesh Parekh|रमेश पारेख
Danny Boudreau|ड्य्यान्नि बोउद्रेऔ
Milind Soman|मिलिंद सोमान
Ashapoorna Devi|आशापूर्णा देवी
Gaganendranath Tagore|गगनेन्द्रनाथठाकुरः
Juan de Arespacochaga|Juan de Arespacochaga
R. K. Laxman|आर् के लक्ष्मण्
Lalgudi Jayaraman|लाल्गुडि जयरामन्
Ramesh Pokhriyal|रमेश पोखरियाल
K. Shivaram Karanth|शिवराम कारन्तः
Rajasekhara|राजशेखरः
Shatrughan Sinha|शत्रुघ्न सिन्हा
Kariya Munda|करिया मुंडा
Daulat Singh Kothari|दौलतसिंह कोठारी
Suraiya|सुरैया
Shibu Soren|शिबू सोरेन
Deendayal Upadhyaya|deendayal upadhyaya
Shahu I|शाहु
Ganesh Vasudev Mavalankar|दादा साहेब माळवङ्कर
Shivakumara Swamiji|शिवकुमारस्वामी
Śrīpati|श्रीपति
Elīza Tīruma|Elīza Tīruma
Pramodhawardhani|प्रमोदवर्धिनी
Anna Mani|अण्ण मणि
Abhiraj Rajendra Mishra|अभिराज राजेन्द्र मिश्र:
Abu Hasem Khan Choudhury|अबू हसेम खान चौधरी
Anupam Hazra|अनुपम हाज़रा
Anuradha Bhat|अनुराधा नक्षत्र
Arjun Malhotra|अर्जुन मल्होत्रा
Ashutosh Mukherjee|आशुतोष मुखोपाध्यायः
Bandaru Dattatreya|बण्डारू दत्तारेय
Benjamin Peary Pal|डा. बि. पि. पाल्
C.N. Jayadevan|सी॰एन॰ जयदेवन
Faggan Singh Kulaste|फग्गन सिंह कुलस्ते
Farooq Sheikh|फारुख् शेख्
Gopalanand Swami|गोपालानंद स्वामी
Gutha Sukender Reddy|जी॰एस॰ रेड्डी
H. V. Nanjundaiah|नञ्जुण्डुय्यः
Jaya Paramesvaravarman II|जय परमेश्वरवर्मन् ४
Jayatirtha|जयतीर्थः
Jhina Hikaka|झिना हिकाका
Jijabai|िजजाऊ
K. R. Ramanathan|प्रो. के. आर्. रामनाथन्
Kamal Ranadive|कमल रणदिव
Kasturbhai Lalbhai|कस्तूर भाई
Mahendra Pratap|महेन्द्र प्रतापः
Maniben Patel|मणिबेन पटेल
Manoj Sinha|मनोज सिन्हा
Mehbooba Mufti|महबूबा मुफ़्ती
Mohammad Asrarul Haque|मुहम्मद असरारुल हक़
Naramalli Sivaprasad|नारामल्लि शिवप्रसाद
Ninong Ering|निनोंग ईरिंग
Nishikant Dubey|निशिकांत दुबे
Om Birla|ओम बिड़ला
P. R. Sundaram|पी॰आर॰ सुन्दरम
Pankaj Choudhary|पंकज
Pinaki Misra|पिनाकी मिश्र
Pralhad Joshi|प्रह्लाद जोशी
Prasanna Kumar Patasani|प्रसन्न कुमार पटसानी
Rajesh Verma|राजेश वर्मा
Rakesh Singh|राकेश सिंह
Ram Chandra Paswan|रामचन्द्र पासवान
Ramagupta|रामगुप्तः
Ramesh Chandappa Jigajinagi|रमेश चंदप्पा जिगाजिनगी
Raosaheb Dadarao Danve|रावसाहेब दादाराव दानवेपाटील
Upendra|उपेन्द्रः
Vidyabhushana|विद्याभूषणः
Rudrata|रुद्रटः
Vadiraja Tirtha|वादिराजतीर्थः
Sanjay Jaiswal|संजय जयसवाल
Sarbananda Sonowal|सर्बानन्दा सोनवाल
Satabdi Roy|शताब्दी रॉय
Shahu of Kolhapur|शाहु ४
Shivkumar Chanabasappa Udasi|शिवकुमार चनाबासप्पा उदासी
Shripad Yasso Naik|श्रीपाद येस्सो नाईक
Sindhutai Sapkal|सिन्धुतायी सप्काल्
Sridhara|श्रीधराचार्यः
Vijaysingh Mohite-Patil|विजयसिंह मोहिते-पाटील
Vitthal Radadiya|विट्ठलभाई रादरिया
Śālikanātha|शालिकनाथः
Jaya Indravarman IV|जय इन्द्रवर्मन् ८
Sharad Joshi|शरद जोशी
|Nadi-Kassapa、
|अर्जुनः
Jaya Indravarman II|जय इन्द्रवर्मन् ४
Jaya Harivarman II|जय इन्द्रवर्मन् ७
Amitabha Chowdhury|अमिताभ चौधरी
Pedrito Martinez|Pedrito Martínez
Mala Rajya Laxmi Shah|माला राज्यलक्ष्मी शाह
Annadanaiah Puranik|अन्नदानय्यः पुराणिकः
|स्वामी भगवदाचार्यः
Hukum Singh|हुकुम सिंह
Ramsinh Rathwa|रामसिंहभाई राठवा
Harsimrat Kaur Badal|हरसिमरत कौर बादल
Bidya Devi Bhandari|विद्यादेवी भण्डारी
Sushil Kumar Singh|सुशील कुमार सिंह
Kamlesh Paswan|कमलेश पासवान
Sunil Gaikwad|सुनील गायकवाड़
Rekha Verma|रेखा
Jugal Kishore Sharma|जुगल किशोर शर्मा
Bharatendra Singh|भारतेन्दु सिंह
Neelam Sonkar|नीलम सोनकर
Shankarrao Deo|शंकरराव देव
Rahul Shewale|राहुल शेवाले
Abhishek Singh|अभिषेक सिंह
Malyadri Sriram|माल्याद्री श्रीराम
Manoj Rajoria|मनोज राजोरिया
Ponguleti Srinivas Reddy|पोंगुलेटी श्रीनिवास रेड्डी
Shailesh Kumar|शैलेश कुमार (भुलो मंडल)
Uma Saren|उमा सरीन
Vijay Kumar Hansdak|विजय कुमार हंसदक
Arjunlal Meena|अर्जुन लाल मीणा
Bhairon Prasad Mishra|भैरों प्रसाद मिश्र
Chhotu Ram Chaudhary|सी॰आर॰ चौधरी
Jitendra Chaudhury|जितेंद्र चौधरी
Karadi Sanganna Amarappa|कराडी संगन्ना अमरप्पा
Mriganko Mahato|मृगंक महतो
Pratima Mondal|प्रतिमा मंडल
Rajesh Diwakar|राजेश कुमार दिवाकर
Satish Kumar Gautam|सतीश कुमार गौतम
Sudhir Gupta|सुधीर गुप्ता
Kulamani Samal|कुलमणि समल
Mohammed Faizal P. P.|पी॰पी॰ मोहम्मद फैज़ल
R. Vanaroja|आर॰ वनरोजा
Ashok Kumar K|अशोक कुमार के॰
Chandrakasi M|चन्द्रकसी एम॰
R. P. Marutharajaa|आर॰पी॰ मरुतराजा
T. G. Venkatesh Babu|वेंकटेश बाबू टी॰जी॰
Om Prakash Kohli|ओम प्रकाश कोहली
Jñānagarbha|Jñānagarbha
Nupur Sharma|नूपुर शर्मा
Damodar Raao|दामोदर राव
Acharya Dev Vrat|आचार्य देवव्रत
Atma Ram|आत्मारामः (वैज्ञानिकः)
Nikola Tvrtković|Nikola Tvrtković
José María Mendoza Ussía|José María Mendoza Ussía
Peter Schuchert|Peter Schuchert
Bhasarvajna|भासर्वज्ञः
Harekrishna Satapathy|हरेकृष्ण शतपथी
José López Zanón|José López Zanón
Juan de Haro Piñar|Juan de Haro Piñar
Rajat Kumar Kar|रजत कुमार कर
Taran Svami|संत तारण
Giovanni Battista Tocci|Giovanni Battista Tocci
Gaston Lecreux|Gaston Lecreux
|पवन् कल्याण्
Tejasvi Surya|तेजस्वी सूर्यः
Makrand Mehta|मकरंद महेता
Mankaka|मङ्खकः
Luciano Méndez|Luciano Méndez
Sangram Keshari Senapati|संग्राम केशरी सेनापति
Alekss Krasts|Alekss Krasts
Panagiotis Christopoulos-Cheller|Panagiotis Christopoulos-Cheller
Anastasios Kourmpetis|Anastasios Kourmpetis
Neftali Martinez|Neftali Martinez
Julie Hutsebaut|Julie Hutsebaut
Marina Khodchenkova|Marina Khodchenkova
Clarissa Breuer|Clarissa Breuer
Alena Popadova|Alena Popadova
Caroline Orens|Caroline Orens
Elisa Neri|Elisa Neri
Negringa Raudonite|Negringa Raudonite
Laurence Restoin|Laurence Restoin
Deborah Geentjens|Deborah Geentjens
Delphine Deschamps|Delphine Deschamps
Marie Kolarikova|Marie Kolarikova
Natascha Klewitz|Natascha Klewitz
Jozef Hušla|Jozef Hušla
Krists Lindenblats|Krists Lindenblats
Jung Hyun-woo|Jung Hyun-woo
Dominic Meinel|Dominic Meinel
