Nicolaus Copernicus|ڪوپرنيڪس
Plato|افلاطون
Narendra Modi|نريندر مودي
Indira Gandhi|اندرا گانڌي
David Bowie|David Bowie
Matsuo Bashō|باشو
Mao Zedong|مائوزي تنگ
Søren Kierkegaard|ڪيئر ڪيڪارڊ
Marie Curie|مادام ڪیوري
Archimedes|ارشميدس
Muhammad|محمد
Salman Rashid Khan|سلمان خان
Harivansh Rai Bachchan|هري ونش بچن
Muḥammad ibn Jābir al-Ḥarrānī al-Battānī|جابر بن سنان البتاني
Sappho|سئفو
Muhammad al-Jawad|محمد تقي
Malala Yousafzai|ملالہ یوسفزئي
Alexander Graham Bell|اليگزينڊر گراھم بيل
Klaus Ebner|ڪلاوس ابنر
Helen Keller|هيلن ڪيلر
Leif Erikson|ليف ايرڪسن
Abdullah of Saudi Arabia|عبدالله بن عبدالعزيز
Ali Khamenei|آيت الله خامنائي
Annemarie Schimmel|ڊاڪٽر ائينيمري شمل
John Milton|جان ملٽن
Khushal Khan Khattak|خوشحال خان خٽڪ
Mirza Ghalib|مرزا اسد الله خان غالب
Sami Solanki|سمي سولنڪي
Zulfiqar Ali Bhutto|ذوالفقار علي ڀٽو
Sania Mirza|ثانيا مرزا
Nawaz Sharif|نواز شريف
Ardeshir Cowasjee|اردشير ڪائوسجي
Aruna Irani|ارونا ايراني
Eugene Cernan|يوجين چرنان
Al-Farabi|الفارابي
T. E. Lawrence|لارنس آف عربيه
E. M. Forster|اي. ايم فاسٽر
Ayub Khan|محمد ايوب خان
Amir Khosrow|امير خسرو
Tansu Çiller|تانسو چلر
Bhimrao Ramji Ambedkar|بي آر امبيدڪر
Mumtaz Mahal|ممتاز محل
Emily VanCamp|ايملي وان ڪيمپ
Emilia Clarke|اميليا ڪلارڪ
Lal Bahadur Shastri|لال بهادر شاستري
Imam Shamil|شاھ ميل
Hina Rabbani Khar|حنا رباني کر
Hafsa bint Umar|حفصه بنت عمر
Praxilla|پراڪسيلا
Umar II|عمر دوم
Abu al-Qasim al-Zahrawi|ابو الڪسيس الزھراوي
Henry Petty-Fitzmaurice, 5th Marquess of Lansdowne|لينس ڊائون
Ibn Hawqal|ابن حوقل
Ibn Khordadbeh|ابن خردازبه
Shahid Afridi|شاهد آفريدي
Faiz Ahmad Faiz|فيض احمد فيض
Shah Waliullah|شاهه ولي الله
`Abd Allah ibn `Abbas|عبد الله بن عباس
Alexander Cunningham|اليگزينڊر ڪننگھام
Ibn Taymiyyah|ابن تيميه
Seeta Devi|سيتا ديوي (اداڪارڻ)
Nur Jahan|نورجهان
Bahadur Shah I|بھادر شاھ پھريون
Junayd of Baghdad|جنيد بغدادي
Wahb ibn 'Abd Manaf|وهب بن عبد مناف
Shah Abdul Latif Bhittai|شاهه عبداللطيف ڀٽائي
Insha Allah Khan|انشاء الله خان
Leo Varadkar|ليو ورادڪر
Mus'ab ibn al-Zubayr|مصعب بن الزبیر
Umm Kulthum bint Muhammad|ام ڪلثوم بنت محمد
Nizam-ud-din Auliya|حضرت نظام الدين اوليا
Lea T|لئا تي
Abd Manaf ibn Qusai|عبدالمناف
Alara Kalama|الارا ڪلاما
Yakub A.S in Islam|يعقوب عليہ السلام
Ibrahim ibn Adham|ابراهيم بن اڌم بلخي
Jhulelal|اڏيرو لال
Ashtavakra|اشتاوڪرا
Sarmad Kashani|سرمد ڪاشاني
Syed Shah Mardan Shah-II|سيد شاھ مردان شاھ ثاني
Sucheta Kripalani|سوچيتا ڪرپلاڻي
Rudrama Devi|رودراما ديوي
Asad Shafiq|اسد شفيق
Sarfraz Ahmed|سرفراز احمد
Malika Pukhraj|ملڪا پکراج
Barkha Dutt|برکا دت
Bushra Ansari|بشرا انصاري
Ibn-e-Safi|ابن صفي
Malik Ayaz|اياز
Agha Hashar Kashmiri|آغا حشر ڪاشميري
Talal Maddah|طلال مداح
Alexander Chekhov|اليگزينڊر چيخوف
Aarti Chhabria|آرتي ڇاٻڙيا
Abdul Wahid Aresar|عبدالواحد آريسر
Abid Ali|عابد علي (اداڪار)
Akhtar Jadoon|اختر حسين جدون
Alice Albinia|ايلائيس البينيا
Asif Farrukhi|آصف فرخي
Bashir Ahmed Qureshi|بشير احمد قريشي
Geeta Kapur|گيتا ڪپور
Hemu Kalani|هيمون ڪالاڻي
Hussain Haroon|حسين هارون
Justice Hamid Ali Mirza|حامد علي مرزا
Mahmoud Haroon|محمود ھارون
Makhdoom Muhammad Hashim Thattvi|محمد هاشم ٺٽوي
Marvi Sirmed|ماروي سرمد
Mohammad Akram|محمد اڪرم
Muhammad Usman Diplai|محمد عثمان ڏيپلائي
Nasir-ul-Mulk|ناصر الملڪ
Pir Sadardin|پير صدرالدين شاه
Pratap Singh Kairon|پرتاپ سنگھ ڪيرون
Priya Rajvansh|پريا راجونش
Shazia Khushk|شازيه خشڪ
Shraddha Arya|شرڌا آريا
Syed Sajjad Ali Shah|سيد سجاد علي شاھ
Unniyarcha|انيارچا
Zahirul Islam Abbasi|ظهير الاسلام عباسي
Zaib-un-Nissa Hamidullah|زيب النساء حميد اللّه
Zoya Khan|زويا خان
Iqbal Qasim|اقبال قاسم
Farida Arriany|فريدا ائريني
Dada J. P. Vaswani|دادا جشن واسواڻي
Arjumand Rahim|ارجمند رحيم
Mulatu Teshome|مولاٽو تشومي
Rani Velu Nachiyar|ويلو ناچيار
Ümmügülsüm Sultan|ام ڪلثوم سلطان
Rafique Ahmed Jamali|رفيق احمد جمالي
Satnam Singh Bhamara|ستنام سنگھ ڀمارا
M. H. Panhwar|محمد حسين پنهور
Villy Aellen|Villy Aellen
Muhammad Ayaz Soomro|محمد اياز سومرو
Ram Punjwani|رام پنجواڻي
|سيد محمد عبدالرشيد فاضل
Thando Bula|ٿاڻو بولا خان
Ustad Bukhari|استاد بخاري
Azumi Waki|أزومي واكي
Sarmad Sindhi|سرمد سنڌي
Ustad Manzoor Ali Khan|استاد منظور علي خان
Dr. Ghulam Ali Allana|غلام علي الانا
AllahDad Bohyo|الهداد ٻوهيو
Mumtaz Mirza|ممتاز مرزا
Fozia Soomro|فوزيه سومرو
Noor Muhammad Lakhir|نور محمد لاکير
|سيد امتياز علي تاج
|ممتاز علي سومرو
|صوفي رکيل شاه
|مخدوم غلام محمد ملڪاڻي
|آدم شاهه ڪلهوڙو
|ممتاز مولائي
|سيد جيئل شاهه جيلاني
|آدم خان رند
|آصف مٺياڻوي
|آغا تاج محمد خان
|آغا تيمور خان پٺاڻ
|آغا عبدالحميد خان
|ابراهيم بلوچ
Najmuddin Abou|نجم الدين ابڙو
|ابن ھشام
|ابو نصر بن عبدالله سنڌي
|احسان دانش ڀٽو
|احمد خان گلزار
|احمد خان سھاڳ
|احمد متقي
|استاد امير خان
|استاد پيارو خان
Ishaq Samejo|اسحاق سميجو
|اسد چاچڙ
|اسد قريشي
|اسماعيل اداسي
|امام اوزاعي سنڌي
|امام بخش عاصم
|امام بخش شر
|وليم جوزف ايسٽ وڪ
|امير بخش امير قريشي
|انور علي شاھ
|صوفي باقر شاھ
|بانو محبوب
|انور وسطڙو
Aditi Bhatia|اديتي ڀاٽيا
Abul Hassan Sagheer Sindhi|مخدوم ابو الحسن ٺٽوي
Hugh Trevor Lambrick|ايڇ. ٽي. لئمبرڪ
Manuel Martínez Chumillas|Manuel Martínez Chumillas
Ángel Cadarso del Pueyo|Ángel Cadarso del Pueyo
Masood Ahmed Barkati|مسعود احمد برڪاتي
Syed Ghulam Shah Jillani|غلام شاهه جيلاني
Naseer Ahmad|ميان نصير محمد ڪلھوڙو
Naseem|نسيم راڄپر
Jethi Sipahimalani|ڄيٺي سپاھيملاڻي
Orso Orsini|Orso Orsini
Sabit Ali Shah|سيد ثابت علي شاھ
Fanny Vaucher|Fanny Vaucher
Khan Bahadur Muhammad Siddique Memon|محمد صديق ميمڻ
Helin Bölek|هيلن بوليڪ
Kate Sayer|Kate Sayer
Anna Kulikova|Anna Kulikova
Jean-Pierre Lloyd|Jean-Pierre Lloyd
Areke Hassink|Areke Hassink
Paula Fedirchuk|Paula Fedirchuk
Claudia Migliorini|Claudia Migliorini
Sylvia Debboudt|Sylvia Debboudt
Miranda De Permentier|Miranda De Permentier
Aurélie Anaise|Aurélie Anaise
Gulnara Fatkullina|Gulnara Fatkullina
Mirza Nikolajev|Mirza Nikolajev
Elīna Ieva Vītola|Elīna Ieva Vītola
Kyle Murray|Kyle Murray
Stefan Kiefer|Stefan Kiefer
Galileo Galilei|گليليئو گليليئي
Socrates|سقراط
Madonna|ميڊونا
Homer|هومر
Ibn Battuta|ابن بطوطه
Akbar|جلال الدين اڪبر
John McCain|جان مڪين
Serena Williams|سرينہ وليمز
Herodotos|هيرودوت
Averroes|ابن رشد
Julia Roberts|جوليا رابرٽس
Thomas More|ٿامس مور
Salman Rushdie|سلمان رشدي
Ibn Arabi|ابن العربي
Wangari Muta Maathai|ونگاري مئٿائي
Euripides|يوري پيڊيز
Bal Thackeray|بال ٺاڪري
Abu Hurairah|ابو ھريره
Akhenaten|اخناتون
Guru Nanak|گُرو نانِڪ
Jan van Eyck|يان وين آئيڪ
Al-Mukhtar|مختار الثقفي
Lata Mangeshkar|لتا منگيشڪر
Mohammad Ali Jinnah|محمد علي جناح
Alizée|اليزي
Fatimah|فاطمه زهرا
Abū Ḥanīfa|امام ابو حنيفه
Syed Ahmed Khan|سيد احمد خان
Alexandra Daddario|اليگزينڊرا داداريو
Hecataeus of Miletus|ھيڪتايوس
Aminah|آمنه بنت وهب
Anoushka Shankar|انوشڪا شنڪر
Safiyya bint Huyayy|صفيه بنت حيي
Mazdak|مزدڪ
Dihya|ديهيا ڪاهنا
Abbas ibn Ali|عباس بن علي
Abbas ibn Abd al-Muttalib|عباس بن عبد المطلب
Qutb-ud-din Aibak|قطب الدين ايبڪ
Jeff Bezos|جيف بيزوس
Aurel Stein|ارل اسٽين
Murtaza Bhutto|مرتضيٰ ڀٽو
Abu Ayyub al-Ansari|ابو ايوب انصاري
Abu Bakr|ابوبڪر
Mahākāśyapa|مها ڪيشپ
Abu Salama 'Abd Allah ibn 'Abd al-Asad al-Makhzumi|ابو سلمہ عبد الله مخزومي
Gilbert Elliot-Murray-Kynynmound, 4th Earl of Minto|لارڊ منٽو
Zac Goldsmith|زيڪ گولڊ سمٿ
Akhtar Hameed Khan|اختر حميد خان
Rayhana bint Zayd ibn ʿAmr|ريحانه بنت زيد
Alka Yagnik|الڪا ياگنڪ
Sonu Nigam|سونو نگم
Prithviraj Chauhan|پرٿويراج چوهاڻ
Harkishan Singh Surjeet|ھرڪشن سنگھ سرجيت
Allu Arjun|اللو ارجن
Dimitris Liantinis|گيما ڊيمتري
Ashfaq Parvez Kayani|اشفاق پرويز ڪياني
Abu Dharr al-Ghifari|ابوذر غفاري
Halimah bint Abi Dhuayb|حليمه سعديه
Usama ibn Zayd|اسامه بن زيد
David in Islam|داؤد عليہ السلام
Ibn al-Nadim|ابن النديم
Uwais Qarni|اويس قرني
Asma Jahangir|عاصمه جھانگير
Isma'il ibn Jafar|اسماعيل بن جعفر
Ma Huateng|ما ھُئا تينگ
Sawda bint Zamʿa|سوده بنت زمعه
Natascha Berg|نتاشا برگ
Govinda|گووندا
Nimr al-Nimr|نمر باقر النمر
Vidyapati|ودياپتي
Mirza Aslam Beg|مرزا اسلم بيگ
Kiran Bedi|ڪرن بيدي
Sharda Sinha|شاردا سنھا
Lucky Diamond Rich|لڪي ڊائمنڊ رچ
William Hewson|وليم ھيوسن
Ernest Cimon|ارنيسٽ سائمن
Kumar Sanu|ڪمار سانو
Ahmed Ghulamali Chagla|احمد جي چاڳلا
Joko Widodo|جوڪو ودودو
Asad Rauf|اسد رؤف
Wahiduddin Khan|مولانا وحيدالدين
J. B. Kripalani|آچاريه ڪرپالاڻي
Pathanay Khan|پٺاڻي خان
Mustansar Hussain Tarar|مستنصر حسن تارڙ
Uzair|عزير عليہ السلام
Azim Daudpota|عظيم دائودپوٽو
Dong Mingzhu|ڊونگ منگجو
Abul Khair Kashfi|ابوالخير ڪشفي
Adriaan van der Willigen|Adriaan van der Willigen
Adriaan van der Willigen Pz.|Adriaan van der Willigen Pz.
Adriaen Foly|Adriaen Foly
Ahmed Shehzad|احمد شهزاد
Akhtar Chanal Zahri|اختر چنل زھري
Muhammad Akhter Mengal|اختر مينگل
Altaf Husain|الطاف حسين قريشي
Amar Sindhu|امر سنڌو
Arbab Ghulam Rahim|ارباب غلام رحيم
Ashraf W. Tabani|اشرف ڊبليو. تاباني
Bari Imam|امام بري
Budhal Faqir|ٻڍل فقير
Dollah Darya Khan|دولھ دريا خان
Evan James|ايڇ. اي. ايم. جيمس
Ghulam Ali Allana|جي. الانا
Ghulam Hussain Hidayatullah|غلام حسين ھدايت الله
Fatemeh Rahbar|فاطما رهبر
Jalaluddin Surkh-Posh Bukhari|سيد جلال الدين شير شاھ سرخ پوش بخاري
Jaswinder Brar|جسويندر برار
|سيد شفقت حسين شاھ
Mata Tripta|ماتا ترپتا
Mustafa Qureshi|مصطفيٰ قريشي
Muzafar Bhutto|مظفر ڀٽو
Naseem Kharal|نسيم کرل
Nayakuralu Nagamma|نايڪورالو ناگما
Sawan Fakir|سانوڻ فقير
Sheila Ramani|شيلا راماڻي
Sohrab Fakir|سھراب فقير
Syed Sibghatullah Shah Rashdi III|پير پاڳارو اٺون
Thomas Penn|ٿامس پين
Sushant Singh Rajput|سوشانت سنگھ راجپوت
Anoushay Abbasi|انوشي عباسي
Khalid Mahmud Arif|خالد محمود عارف
Mahtab Kaur|مهتاب ڪور
Shah Abdul Karim Bulri|شاه ڪريم
Gullu Butt|گلو بٽ
Ahmad Khan Madhosh|احمد خان مدهوش
Iqbal Qadri|اقبال قادري
Junayd ibn Abd al-Rahman al-Murri|جنيد بن عبدالرحمٰن
Jan Pawlowski|Jan Pawlowski
Mariam Mukhtar|مريم مُختيار
Raaz Nathanshahi|راز ناٿن شاهي
Lionel Cavin|Lionel Cavin
|الياس عشقي
Tahira Naqvi|طاهره نقوي
Tanveer Abbasi|تنوير عباسي
Jalal Chandio|جلال چانڊيو
Mohammed Yousuf|محمد يوسف
Shamsuddin Bulbul|شمس الدين بلبل
Mohan Kalpana|موهن ڪلپنا
Jean-Philippe Anstett|Jean-Philippe Anstett
|سجاد يوسف
|انور فگار هڪڙو
Taj Sehrai|تاج صحرائي
|خواجه عبدالغفار نقشبندي
|ممتاز لاشاري
|آغا صوفي
|آفتاب احمد شيخ
Ibrahim Jalees|ابراهيم جليس
Syed Sulaiman Shah|سيد سليمان شاهه
|حميد ابڙو
|علامه مستانو سيھواڻي ابڙو
|مخدوم ابو محمد ھالائي
|ابو الفضل نور احمد سنڌي
|نواب احمد خان لغاري
|احمد سائين خانڳڙھي
Fida Hussain Khan|استاد فدا حسين خان
|استاد يوسف کٽي
|اشرف منصور دائودپوٽو
|امام بخش شمس
|ميرزا امام علي بيگ
|امام ڏنو فقير
|امير بھادر ثاني
|علي نواز انڙ
|انور الدين جتوئي
|نديم ميراڻي
|امام غزالي جا خط
|انور بلوچ
Mai Jindo|مائي جندو
Francisco Alonso Martos|Francisco Alonso Martos
Jesús Martínez Verón|Jesús Martínez Verón
Joaquín de la Concha Alcalde|Joaquín de la Concha Alcalde
Felipe Medina Benjumea|Felipe Medina Benjumea
|شمس سومرو
Diwan Manna|ديوان منا
Dr. Abdul Ghafoor Memon|ڊاڪٽر عبدالغفور ميمڻ
Sapna Choudhary|سپنا چوڌري
Mohammed Al-Raqad|محمد الرقاد
Mai Allah Wassai|مائي الهه وسائي
Konstantina Sintzaniki|Konstantina Syntzanaki
Tamim ibn Zaid al-Utbi|تميم بن زيد عتبي
Tahira Safdar|طاهره صفدر
Tariq Banuri|طارق بنوري
Shankar Lalwani|شنڪر لالواڻي
|محمد بخش سميجو
|قاضي فيض محمد صديقي
Pinky Maidasani|پنڪي ميداساڻي
Jyoti Yadav|جيوتي يادو
Meh Parah|مهپارا
Rubeena Qureshi|روبينا قريشي
Gjergj Zefi|Gjergj Zefi
Linus Kvist|Linus Kvist
Erki Laanemäe|Erki Laanemäe
Ingram Cuff|Ingram Cuff
Nikita Stenkovoy|Nikita Stenkovoy
Maria Ögn Gudmundsdottir|Maria Ögn Gudmundsdottir
Cornelia Cyrus|Cornelia Cyrus
Ioulia Eremeeva|Ioulia Eremeeva
Julia Bradley|Julia Bradley
Simona Wagnerova|Simona Wagnerova
Sara Savino|Sara Savino
Florian Auer|Florian Auer
Emīls Cipulis|Emīls Cipulis
Marián Skupek|Marián Skupek
Adam Dobeš|Adam Dobeš
Mara Morell|Mara Morell
Dylan Sorensen|Dylan Sorensen
Jonas Oehmichen|Jonas Oehmichen
Julian Assange|جوليان اسانج
Charlie Chaplin|چارلي چپلن
Neil Armstrong|نيل آرمسٽرانگ
Lord Byron|جارج گورڊن بائرن
Johann Wolfgang von Goethe|گوئٽي
James Cook|جيمز ڪڪ
Avicenna|ابن سينا
Saladin|صلاح الدين ايوبي
John F. Kennedy|جان ايف ڪينيڊي
Honoré de Balzac|بالزاڪ
Dwight D. Eisenhower|آئزن هاور
Xi Jinping|شي جنپنگ
Donald Trump|ڊونلڊ ٽرمپ
Sabuktigin|سبڪتگين
Zoroaster|زرتشت
Omar Khayyám|عمر خيام
Thalis|ٿيلس
Giordano Bruno|جيورادنو برونو
Abd al-Malik ibn Marwan|عبد المالڪ ابن مروان
Pol Pot|پول پاٽ
Xuanzang|هيونسانگ
Umm Salama|ام سلمه
Rumi|رومي
Hermann Göring|ھرمان گوئرنگ
Idi Amin|عيدي امين
Asif Ali Zardari|آصف علي زرداري
Elia Kazan|ايليا ڪازان
Anas ibn Malik|انس بن مالڪ
Pericles|پيريڪلس
Anna Akhmatova|ائنا اخمتووا
George Berkeley|جارج برڪلي
Harold Lloyd|ھارولڊ لايڊ
Edward III of England|ايڊورڊ ٽيون
Muslim ibn al-Hajjaj|امام مسلم
Elisabeth of Bavaria|آسٽريا جي راڻي سيسي
Thomas Carlyle|ٿامس ڪارلائل
Imran Khan|عمران خان
Sarvepalli Radhakrishnan|ڊاڪٽر راڌا ڪرشنان
Tabu|تبو (اداڪارا)
Fuzûlî|فضيولي
John Ruskin|جان رسڪن
Jane Addams|جين ايڊمز
Rani Lakshmibai|جهانسي جي راڻي
Aurobindo Ghosh|شري اروبندو
Muhammad Zia-ul-Haq|محمد ضياء الحق
Mani|حڪيم ماني
Arundhati Roy|ارون ڌتي راءِ
Dianna Agron|ڊايانا ايليز ائگرون
Holly Madison|ھالي مئڊيسن
Asia Argento|آسيہ ارجينٽو
Charlotte Rampling|Charlotte Rampling
Ertuğrul Gazi|ارطغرل
Maria al-Qibtiyya|ماريه قبطيه
Sulayman ibn Abd al-Malik|سليمان ابن عبد المالڪ
Alice Walton|الائيس والٽن
Al-Nasa'i|امام نسائي
Nizam al-Mulk|نظام الملڪ
Megasthenes|ميگئسٿنيز
Faxian|فاھيان
M. N. Roy|ايم اين رائي
Abu al-Hasan al-Ash'ari|ابوالحسن الاشعري
Abdul Sattar Edhi|عبدالستار ايڌي
Muhammad Mian Soomro|محمد ميان سومرو
Abu'l-Fazl ibn Mubarak|ابو الفضل
Ibn al-Baitar|ابن بيطار
Abu Musa Ashaari|ابو موسا اشعري
Ruby Myers|روبي مائرز
Phoolan Devi|ڦولن ديوي
Meera|ميران
Jemima Goldsmith|جمائما گولڊ سمٿ
Aurangzeb|اورنگزيب عالمگير
Ulugh Beg|مرزا الغ بيگ
Runa Laila|رُونا ليليٰ
Joseph in Islam|يوسف عليہ السلام
Dara Shikoh|دارا شڪوه
Rashid Behbudov|راشد بهبودوف
Valmiki|والميڪي
J. Willard Marriott|جان ولرڊ ميريئٽ
Charles James Napier|چارلس نيپئر
Sachal Sarmast|سچل سرمست
Jim Walton|جِم والٽن
Asfandyar Wali Khan|اسفند يار ولي
Umm Kulthum|ام ڪلثوم
Abu Hudhaifah ibn al-Mughirah|ابو حذيفہ بن المغيره
Sonam Kapoor|سونم ڪپور
Nicolás Gómez Dávila|نڪولس گومز ڊيويلا
Gregory David Roberts|رابرٽس
Ibn Abi Usaibia|ابن ابي اصيبه
Islamic view of Isaac|اسحاق عليہ السلام
Amrita Pritam|امرتا پريتم
Ruqayyah bint Muhammad|رقيه بنت محمد
Homai Vyarawalla|ھومائي وياراوالا
Yunus|يونس عليہ السلام
Sayajirao Gaekwad III|سياجي رائو گائيڪ واد
Alisha Chinai|اليشا چنائي
Amjad Ali Khan|امجد علي خان
Bhagwatikumar Sharma|بھاگوت ڪمار شرما
Edward Hamilton Aitken|ايڊورڊ ھيملٽن ائٽڪن
Kamila Shamsie|ڪاملا شمسي
Rani Durgavati|راڻي دُرڳاوتي
Raja Dahir|راجا ڏاهر
Maymunah bint al-Harith|ميمونه بنت حارث
Democrates|ڊيموڪريٽس
Shah Nawaz Bhutto|سر شاھنواز ڀٽو
Juwayriyya bint al-Harith|جويريه بنت حارث
Roopmati|روپمتي
Tufail Mohammad|ميجر طفيل محمد شهيد
Syed Ahmad Barelvi|احمد شاھ بريلوي
Rana Bhagwandas|راڻا ڀڳوان داس
Aamina Sheikh|آمنه شيخ
Abu Mashar Sindhi|ابو معشر سنڌي
Ali Mohammad Mahar|علي محمد مهر
Amar Jaleel|امر جليل
Amar Singh Chamkila|امر سنگھ چمڪيلا
Chand Kaur|چاند ڪور
Charli XCX|چارلي ايڪس‌سي ايڪس
Chiragh Ali|چراغ علي
Dolly Guleria|ڊولي گليريا
Homi Wadia|ھومي واڊيا
Imad Wasim|عماد وسيم
Jam Tamachi|ڄام تماچي
John Jacob|جان جيڪب
Khawaja Muhammad Asif|خواجا محمد آصف
|اعجاز الحق قدوسي
Zarina Baloch|زرينه بلوچ
|عبدالله محسود گروپ
Masum Shah|مير معصوم شاھ بکري
Muhammad Ilyas Qadri|محمدالياس قادري
Nasir-ud-Din Qabacha|ناصرالدين قباچو
Rukhsana Khan|رڪسانہ خان
Sami|سامي (شاعر)
Shafi Muhammad Shah|شفيع محمد شاھ
Shah Inat Rizvi|ميون شاھ عنايت رضوي
Shahzaib Hasan|شهزيب حسن
Tavleen Singh|تاولين سنگھ
Zahid Qurban Alvi|زاهد قربان علوي
Muhammad Mohsin Bekas|محمد محسن بيڪس
Mir Mukhtar Akhyar|مير مختار اخيار
Parkash Kaur|پرڪاش ڪور
Makhdoom Bilawal|مخدوم بلاول
Dr. Syed Shahzad Ali Najmi|سید شہزاد علی نجمی
Kalpana Patowary|ڪلپنا پوٽواري
Sayyid Ghulam Hussain Shah Bukhari|غلام حسين شاهه بخاري
Taslima Akhter|تسليما اختر
Mehtab|مهتاب
Mir Ejaz Khan Jakhrani|اعجاز جکراڻي
Syed Ghulam Mustafa Shah|غلام مصطفيٰ شاھ
Syed Jalal Mehmood Shah|سيد جلال محمود شاهه
Gulab Bai|گلاب ٻائي
Hajl ibn Abdul Muttalib|حجل بن عبد المطلب
Vojtech H. Lindtner|Vojtech H. Lindtner
Ahmad of Kalat|مير احمد يار خان
Mian Saqib Nisar|ميان ثاقب نثار
Philipp Wobeto|Philipp Wobeto
Baisali Mohanty|بيسالي موهنتي
|آفاق صديقي
Master Chander|ماسٽر چندر
Sonia Fisch-Muller|Sonia Fisch-Muller
|اسحاق راهي
|جارج اسٽيڪ
|جبار آزاد منگي
Razzaq Mahar|رزاق مهر
|نواب ولي محمد
|منصور الحق آرائين
|غلام محمد آريجو
|ابن الياس سومرو
|ابو البقا ملا ٺٽوي
|ابو شوڪت حمزو
|ابو الحسن جي سنڌي
|اختر مورائي
Allah Dino Noonari|استاد الھڏنو نوناري
|استاد لغاري
|اسحاق فقير ڪارو مڱڻھار
|اشرف شاھ ڪامارائي
|اشرف علي ٻرڙو
|اقبال ملاح
|الطاف جوکيو
|امام بخش صابر
|حافظ امام بخش سومرو
|بابا گوبند داس
|امير حسن
|انور بلوڇ
Manpreet Akhtar|من پريت اختر
Laurent Vallotton|Laurent Vallotton
Al-Ghaydaq ibn Abdulmuttalib|غيداق بن عبد المطلب
John Hollier|John Hollier
Bilawal Shah Noorani|سيد بلاول شاھ نوراني
Dionisio García Cortázar|Dionisio García Cortázar
Máximo Cánovas del Castillo|Máximo Cánovas del Castillo
|عبدالغفار تبسم
Hazar Khan Bijarani|ھزار خان بجاراڻي
Sobia Shahid|صوبيہ شاهد
Zartaj Gul|زرتاج گل
Tanzila Umi Habiba|تنزيلا قمبراڻي
Mai Gulan|مائي گلان
Vanessa Mark|Vanessa Mark
Alexander Bernardi|Alexander Bernardi
Khamiso Khan|خميسو خان
Mai Khairi|مائي خيري
Shams Abbasi|شمس عباسي
|فياض جتوئي
Olivia Araujo|Olivia Araujo
|مختيار ملڪ
Victor Povzner|Victor Povzner
Mantas Januskevicius|Mantas Januskevicius
Bolivar Espinosa|Bolivar Espinosa
Mattija Lojen|Mattija Lojen
Joanne Cavill|Joanne Cavill
Beata Jasińska|Beata Jasińska
Olga Mikhailoyskaia|Olga Mikhailoyskaia
Els Bauden|Els Bauden
Sabrina Arhab|Sabrina Arhab
Cecilia Bäckstedt|Cecilia Bäckstedt
Iulian Oprea|Iulian Oprea
Leon Felderer|Leon Felderer
Cezara Curmei|Cezara Curmei
Roberts Plūme|Roberts Plūme
Erica Voss|Erica Voss
Julia Słupecka|Julia Słupecka
Eric Fantazzini|Eric Fantazzini
Arnis Bebrišs|Arnis Bebrišs
Taylor Lawrence|Taylor Lawrence
Cédric Follador|Cédric Follador
Kamal Jamro|ڪمال ڄامڙو
Riaz Sohail|رياض سھيل
Erik Schmidt|Erik Schmidt
William Shakespeare|ولیم شیڪسپیئر
Aristotle|ارسطو
Carl Linnaeus|ڪارل لينيوئس
Mohamed Morsi|محمد مرسي
Anton Chekhov|انٽون چيخوف
Marco Polo|مارڪو پولو
Alexander Pushkin|اليگزينڊر پشڪن
Rabindranath Tagore|رابندرناٿ ٽئگور
Margaret Thatcher|مارگريٽ ٿيچر
Umar ibn Al-Khattāb|عمر بن خطاب
Ashoka|اشوڪا
Euclid|اقليدس
Karl Marx|ڪارل مارڪس
Queen Victoria|راڻي وڪٽوريا (برطانيا)
Robert Baden-Powell, 1st Baron Baden-Powell|لارڊ بيڊن پاول
Auguste Comte|آگسٽ ڪاميٽ
Rowan Atkinson|روون اٽڪنسن
King Porus|پورس
Bernard Arnault|برنارڊ آرنالٽ
Brad Pitt|بريڊ پٽ
Tom Cruise|ٽام ڪروز
Pervez Musharraf|پرويز مشرف
Nicholas II of Russia|نڪولس ٻيون (روس)
Ahmed Shahe Durrani|احمد شاهه ابدالي
Kahlil Gibran|خليل جبران
Khwaja Ghulam Farid|خواجہ غلام فريد
Qurratulain Hyder|قرت العين
Sukarno|سوئيڪارنو
Larry Ellison|ليري ايليسن
Sergey Brin|سرگي برن
Richard Francis Burton|رچرڊ برٽن
Sain Zahoor|سائين ظھور
Kajol|ڪاجول ديوگن مکرجي
Tamannaah|تمنا ڀاٽيا
Mohammed Rafi|محمد رفيع
Jon Voight|جان وئائيٽ
Abu Bakr al-Razi|الرازي
Saadi|شيخ سعدي
Robert Owen|رابرٽ اووين
Steve Ballmer|اسٽيو بالمر
Zeynalabdin Taghiyev|زينالعابدين طگيف
Yazid I|يزید ابن معاويہ
Sunny Leone|سني ليون
Muawiya II|معاويہ ابن يزيد
Tim Cook|ٽم ڪُڪ
Jacob|يعقوب عليہ السلام
al-Yaʿqubi|اليعقوبي
Ernesto Zedillo|ارنيسٽو زيديلو
Abd Allah ibn al-Zubayr|عبدالله بن زبير
Abdel Fattah el-Sisi|عبد الفتاح السيسى
Riaz Ahmed Gohar Shahi|ریاض احمد گوھر شاهي
Ali ibn al-Husayn Zayn al-'Abidin|زين العابدين
Will Durant|ول ڊيورانٽ
Yahya Khan|يحييٰ خان
Amr ibn Hishām|ابوجھل
Iltutmish|شمس الدين التمش
Abdul Muttalib|عبدالمطلب
Aftab Ahmad Sherpao|آفتاب شيرپائو
Agha Shahi|آغا شاھي
Surinder Kaur|سريندر ڪور
Daler Mehndi|دلير مھندي
Lal Krishna Advani|लाल कृष्ण आडवाणी
James Young Simpson|جيمس ينگ سمپسن
Hunayn ibn Ishaq|حنين بن اسحاق
Françoise Bettencourt Meyers|فرانڪوئس بيٽنڪورٽ ميئرس
Baz Bahadur|باز بھادر
Arif Lohar|عارف لوھر
Iftikhar Muhammad Chaudhry|افتخار محمد چوڌري
al-Qasim ibn Muhammad|قاسم بن محمد
Ibn Muqla|ابن مقلہ بيضاوي
Shuayb|شعيب عليہ السلام
Sheikh Muhammad Abdullah|شيخ محمد عبدالله
Sattar Bahlulzade|ستار بهلزاده
Jamiluddin Aali|جميل الدين عالي
Vikramaditya|راجا وڪرمادتيا
Ameen Faheem|مخدوم امين فھيم
Kuldip Nayar|ڪلديپ نير
Ghulam Mustafa Jatoi|غلام مصطفيٰ جتوئي
Abdullah ibn Umar|عبدالله بن عمر
Robert Jones|Robert Jones
Yahya|يحیي علیہ السلام
Mirzo Tursunzoda|مرزا ترسون زادا
Balach Marri|مير بالاچ مري
Abdul Haq|عبدالحق
José Luis Álvarez Álvarez|José Luis Álvarez
Julia Leigh|جوليا لي
Billy Bowden|بلي باؤڊن
Ram Jethmalani|رام ڄيٺملاڻي
Veer Banda Bairagi|بندہ سنگھ بهادر
Ibn-e-Insha|ابن انشا
Iftikhar Arif|افتخار عارف
Mir Chakar Rind|چاڪر خان رند
Jon Elia|جون ايليا
Azad Bilgrami|آزاد بلگرامي
Omar Eldarov|عمر ايلداروف
Ajit Pal Singh|اجيت پال سنگھ
Allah Bukhsh Karim Bukhsh Brohi|اي. ڪي. بروهي
Ameer Bux Bhutto|امير بخش ڀٽو
Anwar Pirzada|انور پيرزادو
Aqeel Jafri|عقيل عباس جعفري
Arif Alvi|عارف علوي
Ashwini Bhave|اشوني ڀاوي
Asif Nawaz|آصف نواز جنجوعا
Ayaz Latif Palijo|اياز لطيف پليجو
Az-Zubayr ibn ‘Abd al-Muttalib|زبيربن عبد المطلب
Baha-ud-din Zakariya|بهاءُ الدين زڪريا
Kartar Singh Sarabha|ڪرتار سنگھ سراڀا
Ernest Trumpp|ارنيسٽ ٽرمپ
Ghulam Mustafa Khan|غلام مصطفيٰ خان
H. M. Khoja|ايڇ. ايم. خواجہ
Habib Jalib|حبيب جالب
Hamida Khuhro|حميده کهڙو
Hassan Ali Effendi|حسن علي آفندي
Hassan Nasir|حسن ناصر
Hüma Şah Sultan|هما شاهه سلطان
Jana Begum|جانان بيگم
Kaveeta|ڪويتا نسرين رضوي
Ibrahim Munshi|ابراھيم منشي
Sibghatullah Shah Rashidi|سيد سبغت الله شاھ ثاني پير پاڳارو
Maulana Ehtisham ul Haq Thanvi|مولانا احتشام الحق ٿانوي
Mir Janullah Shah|مير جان اللہ شاھ رضوي
Muhammad Juman|استاد محمد جمن
Alhaaj Muhammad Owais Raza Qadri|محمد اويس رضا قادري
Munir Hussain|منير حسين
N M Uqaili|اين. ايم. عقيلي
Nazeer Abbasi|نذير عباسي
Nikita Lalwani|نتيڪا لالواڻي
Sikandar Khan Khoso|سڪندر خان کوسو
Sobho Gianchandani|سوڀو گيانچنداڻي
Swara Bhaskar|سوارا ڀاسڪر
Umar Bin Muhammad Daudpota|عمر بن محمد دائود پوٽو
Abdullah Haroon|عبدالله هارون
Mawra Hocane|ماورا حسين
Raheel Sharif|جنرل راحيل شريف
Ayyan|ايان
Suhaee Abro|سُھائي ابڙو
Zoya Afroz|زويا افروز
Imdad Hussaini|امداد حسيني
Shafi Muhammad Burfat|شفيع محمد برفت
Muhammad Haroon Aslam|محمد هارون اسلم
Noor Mohammad Kalhoro|ميان نور محمد ڪلھوڙو
Saif Samejo|سيف سميجو
Thara Kalyan|تارا ڪلياڻ
Sakina Samo|سڪينا سمون
Ghulam Muhammad Khan Bhurgri|بئريسٽر رئيس غلام محمد ڀرڳڙي
Abu Ishaq Ibrahim|ابو اسحاق ابراھيم بن سنان
Sheikh Noor Muhammad|شیخ نور مهمد
Sheila Bhatia|شيلا ڀاٽيا
Bibbo|بيبو (اداڪارڻ)
Naseer Soomro|نصير سومرو
Sabita Devi|سبيتا ديوي
Friederike Spitzenberger|Friederike Spitzenberger
Suhai Aziz Talpur|سهائي ٽالپر
|امام دين گجراتي
Azar Zubi|آذر زوبي
Hotchand Molchand Gurbakhshani|ڊاڪٽر هوتچند مولچند گربشاڻي
Kirat Babani|ڪيرت ٻاٻاڻي
Mangharam Udharam Malkani|منگهارام ملڪاڻي
Amjad Sabri|امجد صابري
Rukhmabai|رکماٻائي
|الهه بچايو سمون
Salahuddin Tunio|صلاح الدين تنيو
Elias Abu|الياس ابڙو
Sarkash Sindhi|سرڪش سنڌي
Akbar Jiskani|اڪبر جسڪاڻي
|محمد بن عبدالله
|احمد مغل
|آغا جعفر علي خان
|آغا غلام نبي پٺاڻ
|آغا نورمحمد پٺاڻ
|ابو طالب آگھمي
|ابو طالب اعواڻ قطب شاھي
|ابو الفضل بن طاھر ٺٽوي
|احمد رضا بروھي
|احمد سولنگي
|احمد شاھ زاڪري
|استاد عاشق علي خان
|استاد نظاماڻي
Akbar Khamiso Khan|اڪبر خميسو خان
|نواب الھداد خان صوفي
|امير علي شاھ
|انور ساگر ڪانڌڙو
Agha Nasir|آغا ناصر
Zuzana Čaputová|زوزانا چاپوتووا
Aheda Zanetti|Aheda Zanetti
Emma Beamish|ايما بيميش
Claude Vaucher|Claude Vaucher
Houda Darwish|هدا درويش
|طالب لغاري
Chakori|چڪوري
Gauri Lankesh|گوري لنڪيش
Nighat Intisar Bhatti|نگھت انتصار ڀٽي
Fazalur Rehman (bureaucrat)|فضل الرحمان (ڪامورو)
Bertrand Devouard|Bertrand Devouard
Atta Muhammad Bhanbhro|عطا محمد ڀنڀرو
Anam Goher|انم گوھر
Tandu bint Hussein|تندو خانم
|احسان دانش
Ghaos Bux Brohi|غوث بخش بروهي
Misri Khan Jamali|مصري خان جمالي
S.M. Qureshi|ايس ايم قريشي
Mariyam Sultana Noohani|مريم سلطانه نوحاڻي
Zeenat Abdullah Channa|زينت عبداللّٰه چنا
Popati Hiranandani|پوپٽي هيرا ننداڻي
Christian Hammers|Christian Hammers
Zhong Shanshan|زھونگ شنشان
Gert Kivistik|Gert Kivistik
Ilia Cota|Ilia Cota
Carlo Jurisevic|Carlo Jurisevic
Birkir Snaer Ingvason|Birkir Snaer Ingvason
Barbora Svrckova|Barbora Svrckova
Wendy Ducruex|Wendy Ducruex
Tatiana Droujinina|Tatiana Droujinina
Tatiana Bossak|Tatiana Bossak
Chantalle Gehrig|Chantalle Gehrig
Séverine Villance|Séverine Villance
Lada Koslikova|Lada Koslikova
Samanta Loschi|Samanta Loschi
Darnelle Moore|Darnelle Moore
Rachel Leroux|Rachel Leroux
Šárka Chmurová|Šárka Chmurová
Sarah Wimmer|Sarah Wimmer
Riccardo Schöpf|Riccardo Schöpf
Eduard Crăciun|Eduard Crăciun
Irina Strebel|Irina Strebel
Sara Villani|Sara Villani
Andreas Haas|Andreas Haas
Joseph Williamson|Joseph Williamson
Mika Schneider|Mika Schneider
Daniel Berlinski|Daniel Berlinski
Yanka Kupala|يانڪا ڪُپالا
Cleopatra|قلوپطرہ
Albert Einstein|البرٽ آئنسٽائن
CeeLo Green|Cee Lo Green
Joe Biden|جو بائيڊن
Jean-Jacques Rousseau|جين جيڪس روسو
Shah Rukh Khan|Shahrukh Khan
Elizabeth II|ايلزبٿ ٻين (برطانيا)
Jennifer Aniston|جينيفر اينسٽن
Akon|ايڪون
Albert Camus|البرٽ ڪامو
Muhammad Ali|محمد علي ڪلي
Mark Zuckerberg|مارڪ زوڪربرگ
Florence Nightingale|فلورينس نائيٽ انگل
Nicole Kidman|نڪول ڪڊمين
Uthman ibn Affan|عثمان
Alī ibn Abī Ṭālib|علي
Nefertiti|نيفرٽيٽي
Strabo|اسٽرابو
Sheikh Hasina|حسينه واجد
Edvard Grieg|ايڊورڊ گريئگ
Shah Jahan|شاهجهان
Jagjit Singh|جگجيت سنگهه
Hatice Muazzez|خديجه معزز سلطان
Henry David Thoreau|ٿوريو
Zafarullah Khan Jamali|ظفر الله خان جمالي
Zaynab bint Khuzayma|زينب بنت خزيمه
Jabir ibn Hayyan|جابر بن حيان
Osman II|عثمان ٻيون
Muhammad al-Idrisi|ادريسي
Vin Diesel|ون ڊيزل
Muawiyah I|امير معاويہ
Zoe Saldana|زوئي سلدانا
Abul Kalam Azad|ابو الڪلام آزاد
Anggun|ڪرڻ
Śuddhodana|سڌو ڌن
George V|جارج پنجون (برطانيا)
Aleksandr Kuprin|اليڪساندرڪوپرن
Mukesh Ambani|مڪيش امباڻي
Guru Gobind Singh|گرو گوبند سنگھ
Mustafa Balel|مصطفي باليل
Ahmad al-Qalqashandi|احمد القشندي
Akbar Bugti|اڪبر بگٽي
Onesicritus|اوني سيڪرٽيوس
Rukmini Devi Arundale|رڪمڻي ديوي اروندويلي
Ovadia Yosep|اوويديا يوسيف
Divya Dutta|ديويا دتا
Husain Haqqani|حسين حقاني
Umm Kulthum bint Ali ibn Abi Talib|ام ڪلثوم بنت علي
Hashim ibn 'Abd Manaf|هاشم
Gara Garayev|گارا گرائيوف
Sir James Outram, 1st Baronet|جيمس آئوٽرام
Turhan Hatice|تورخان خديجه سلطان
Habib Bourguiba|حبيب بورقيبہ
Arthur Lapworth|آرٿر ليپ ورٿ
S. Robson Walton|روب والٽن
Zaynab bint Ali|زینب
Mary in Islam|بيبي مريم
Shreya Ghoshal|شريا گهوشال
Habib ibn al-Muhallab|حبيب بن المهلب
Aram Shah|آرام شاهه
Rukn ud din Firuz|رڪن الدين فيروز
Al-Khansa|خنساء بنت عمرو
Asmā' bint Abu Bakr|بيبي اسماء رضہ
Shikaripura Ranganatha Rao|ايس. آر. رائو
Raja Birbal|بيربل
Gargi Vachaknavi|گارگي واچڪنوي
Bade Ghulam Ali Khan|استاد بڙي غلام علي خان
Félix du Temple de la Croix|فيلڪس ڊو ٽيمپل
Kader Khan|قادر خان
Mohammad Amir|محمد عامر
Ashfaq Ahmad|اشفاق احمد
Rajkumar Hirani|راجڪمار هيراڻي
Jaswant Singh|جسونت سنگهه
Mangammal|منگامل
Sobha Singh|سوڀا سنگھ
Asad ibn Hashim|اسد
Sind ibn Ali|سند بن علي
Shemr|شمر
Agha Hasan Abedi|آغا حسن عابدي
Ahfazur Rahman|احفاظ الرحمان
Ahmad Salim|احمد سليم
Alam Channa|عالم چنا
Allan Fakir|علڻ فقير
Altaf Shaikh|الطاف شيخ
Asadullah Bhutto|اسدالله ڀٽو
Aslam Farrukhi|ڊاڪٽر اسلم فرخي
Ben Goldsmith|بين گولڊ سمٿ
Bhagat Kanwar Ram|ڀڳت ڪنور رام
Fahad Mustafa|فهد مصطفيٰ
Habib Ibrahim Rahimtoola|حبيب ابراهيم رحمت الله
Izhar Qazi|اظھار قاضي
Jam Sadiq Ali|ڄام صادق علي
Jan Muhammad Junejo|جان محمد جوڻيجو
Khalid M. Ishaq|خالد اسحاق
Tajal Bewas|تاجل بيوس
Abdallah ibn Uthman ibn Affan|عبدالله بن عثمان
Mir Babar Ali Anis|مير انيس
Mir Sher Muhammad Talpur|مير شير محمد ٽالپور
Mirza Kalich Beg|مرزا قليچ بيگ
Mohammad Hayya Al-Sindhi|محمد حيات سنڌي مدني
Mumtaz Bhutto|ممتاز ڀٽو
Nanda|نندا
Qadir Magsi|قادر مڱسي
Rasul Bux Palejo|رسول بخش پليجو
Robin Birley|روبن برلي
Rooplo Kolhi|روپلو ڪولهي
Sassui Palijo|سسئي پليجو
Satinder Satti|ستيندرستي
Shahryar|شھزادو شھريار خان
Sher Singh|شير سنگھ
Qutbuddin Bakhtiar Kaki|قطب الدين بختيار ڪاڪي
|محمد دوم
Sri Chand|بابا سريچند
Sultan Rahi|سلطان راهي
Sundri Uttamchandani|سُندري اُتمچنداڻي
Sadhumal Surendar Valasi|سريندر ولاسائي
Syed Ata Ullah Shah Bukhari|سيد عطاءُ الله شاهه بخاري
Trevor Beattie|Trevor Beattie
Varun Dhawan|وارن ڌاون
Zainab Tari|زينب سومرو
Mir Hazar Khan Khoso|جسٽس مير ھزار خان کوسو
Saeeduzzaman Siddiqui|سعيدالزمان صديقي
Kamala Harris|ڪاملا هيرس
Junaid Jamshed|جنيد جمشيد
Masako Nakata|مساڪو نڪاتا
Layal Abboud|ليال عبود
Shazia Manzoor|شازيہ منظور
Mamnoon Hussain|ممنون حسين
Meraj Muhammad Khan|معراج محمد خان
Muhammad Tahir|خواجه محمد طاهر بخشي
Humaira Channa|حميره چنا
James Heilman|جيمس هائلمين
Reham Khan|ريحام خان
Natasja Nobels|Natasja Nobels
Hazrat Khawaja Muhammad Zaman Luari Sharif|محمد زمان پھريون
'Umar ibn Hafs Hazarmard|عمر بن حفص
Mir Muhammad Soomro|مير محمد سومرو
Ghulam Rabbani Agro|غلام رباني آگرو
Mujeeb Rahman Chandio Hussaini|مجيب الرحمان
Manzoor Sakhirani|منظور سخيراڻي
Natania Lalwani|نتانيا لالواڻي
Sakhi Sarwar Saint|سيد سلطان احمد
|صابر آفاقي
Al-Muqawwim ibn Abdul-muttalib|مقوم بن عبد المطلب
Sana Javed|ثناء جاويد
Adnan|عدنان
Molai Sheedai|رحيمداد خان مولائي شيدائي
Gobind Malhi|گوبند مالهي
Molvi Ahmed Mallah|احمد ملاح
Muneer Ahmed Manik|ماڻڪ
Atta Mohammad Hami|عطا محمد حامي
Tariq Alam Abro|طارق عالم ابڙو
Ayaz Jani|اياز جاني
Neha Dixit|نيها ڊڪشت
Sarfaraz Rajar|سرفراز راڄڙ
Akbar Laghari|اڪبر لغاري
Husna Bai|حسنا ٻائي
Yazid ibn Abi Kabsha al-Saksaki|يزيد بن ابي ڪبشہ
|قمر شهباز
|صوفي وريل فقير
|غلام نبي گل
|محمد جمن چارڻ
|ذوالفقار علي ڀٽي
|محمد صديق پرهيار
|سيد پپو شاه
|آدم شاهه جو تڪيو
|آصف بالادي
|آصف هالائي
|آفتاب سومرو
|ابو عطا سنڌي
|ابو محمد سالم سنڌي
|ابو اسحاق ابراھيم سنڌي موصلي
|ابو القاسم سلطان ٺٽوي
|ابو بڪر شبلي
|احمد بخش احمد مورائي
Mullah Ahmad Bhatawi|ملا احمد ٺٽوي
|احمد سلطان چانڊيو
|احمد شيخ
|اختر بلوچ
|استاد احمد خان
|استاد گلزار علي خان
|استاد وريلداس
|استاد نبي بخش مڱڻھار
|اسحاق آھنگر
|اسماعيل شاھ بخاري
|الطاف اثيم
|الطاف عباسي
|الطاف ملڪاڻي
|امام بخش خادم
|امام بخش خان مير
|صوفي امداد عباس
|امر ساھڙ
Amar Fayaz Buriro|امر فياض
|امير حيدر شاھ
|نور محمد انڍڙ
|انور علي سرھيو
|بابا بنکنڊي مھراج
Dipali Barthakur|ديپالي برٺاڪر
Mohsin|سيد مراد علي شاهہ
Rahila Magsi|راحيلا مگسي
Jagjit Kaur|جگجيت ڪور
Ahmed Mian Soomro|احمد ميان سومرو
Nighat Chaodhry|نگھت چوڌري
|عزیز کنگرانی
Miguel López González|Miguel López González
Rodrigo Medina Benjumea|Rodrigo Medina Benjumea
Alfonso Toro Buiza|Alfonso Toro Buiza
José Jiménez Jimena|José Jiménez Jimena
Jam Raidhan|ڄام راءَ ڏنو
Giacomo Tocci|Giacomo Tocci
Choithram Gidwani|ڊاڪٽر چوئٿرام گدواڻي
Attiya Dawood|عطيا دائود
Jahan Dad Khan|جهان داد خان
Emily Hauze|ايملي هاز
Murtaza Wahab|مرتضى وهاب
Syed Samsuddin Ahmed|سيد شمس الدين
Ali Akash|علي آڪاش
Antonio Fresco|انتونيو فريسوڪو
Bhupen Lalwani|ڀپين لالواڻي
Fabienne Lupo Magnaudet|Fabienne Lupo Magnaudet
Allah Bachayo Khoso|ﷲ بچايو کوسو
|نوشي گيلاني
Noor Bano|نور بانو (ڳائڻي)
Ali Gul Sangi|علي گل سانگي
Taj Baloch|تاج بلوچ
Mitha khan Zardari|گهڙي نواز مٺا خان زرداري
Kelly Vedovelli|Kelly Vedovelli
Yanina Kuskova|Yanina Kuskova
Greta Karasiovaite|Greta Karasiovaite
Joseph Samudio|Joseph Samudio
Dimitrios Christakos|Dimitrios Christakos
Muhammad Shahmir Aiman Abdul Halim|Muhammad Shahmir Aiman Abdul Halim
Sakchai Phodingam|Sakchai Phodingam
Karina Louise Sørensen|Karina Louise Sørensen
Mira Peeters|Mira Peeters
Cybil Di Guistini|Cybil Di Guistini
Anna-Sophia Czilwik|Anna-Sophia Czilwik
Myriam Desrosiers|Myriam Desrosiers
Adéla Vlnova|Adéla Vlnova
Monika Richterova|Monika Richterova
Nicholas Timmings|Nicholas Timmings
Ruth Demeijer|Ruth Demeijer
Chantal Polansky|Chantal Polansky
Liliano Leenknegi|Liliano Leenknegi
Kim Van Gastel|Kim Van Gastel
Nicole Peitzmeier|Nicole Peitzmeier
Jonathan Eric Gustafson|Jonathan Eric Gustafson
Qazi Qadan|قاضي قاضن
Dominik Hufschmid|Dominik Hufschmid
Lorenz Hollenbach|Lorenz Hollenbach
Matthias Grahé|Matthias Grahé
Bruno Schiemann|Bruno Schiemann
Justin Jacob|Justin Jacob
Hakim Ali Shah Bukhari|حاڪم علي شاھ بخاري
François Hollande|فرانڪو اولاند
Carl Sagan|ڪارل سيگن
Salvador Allende|آلندي سيلويڊار
Isaac Newton|آئزڪ نيوٽن
Charles Darwin|چارلس ڊاروِن
Nebuchadnezzar II|بخت نصر
Angelina Jolie|اينجلينا جولي
Amancio Ortega|امانسيئو اورٽيگا
Atropates|آتروپات
Muhammad bin Qasim|محمد بن قاسم
Yasser Arafat|ياسر عرفات
Muhammad Rafiq Tarar|رفيق تارڙ
Ho Chi Minh|ھو چي منھ
Rasul Gamzatov|رسول حمزه توف
Warren Buffett|وارن بفيٽ
Emma Goldman|ايما گولڊمين
Husayn ibn Ali|حسين ابن علي
Kristen Stewart|ڪرسٽين اسٽيورٽ
Stamford Raffles|سرٿامس اسٽئمفورڊ رئفلس
Lee Kuan Yew|لي ڪوان يئو
George Stephenson|جارج اسٽيفنسن
Zaynab bint Jahsh|زينب بنت جحش
Adnan Oktar|هارون يحيٰ
Mohammed Amin al-Husseini|امين الحسيني
Zeb-un-Nisa|زيب النساء بيگم
Pedro Calderón de la Barca|پيڊرو ڪليڊرون
Mansur Al-Hallaj|منصور الحلاج
Bodhidharma|ٻوڌيڌرما
Sirimavo Bandaranaike|سريماوو بندرانائڪي
Félix Houphouët-Boigny|فيلڪس ھوفوئي بوئني
Ismail I|شاهه اسماعيل
Corinna|ڪورينا
Rabia of Basri|رابعہ بصري
Estakhri|اصطخري
Abu Isa at-Tirmidhi|امام ترمذي
Abdul Qadir Gilani|عبدالقادر جيلاني
A. Q. Khan|عبدالقدير خان
Kabir|ڀڳت ڪبير
Uzeyir Hajibeyov|عزير حاجيبايوف
Komitas|ڪوميتاس
Abul Ala Maududi|ابوالاعليٰ مودودي
Bismillah Khan|استاد بسم الله خان
Bayazid Bastami|بايزيد بسطامي
Muhammad bin Tughluq|محمد شاھ تغلق
Razia Sultana|رضيا سلطانا
Dhirubhai Ambani|ڌيرو ڀائي امباڻي
Muhammad Iqbal|علامه اقبال
Alp Tigin|الپتگين
Qutb-ud-Din Bakhtiar Kaki|خواجہ معين الدين چشتي
Sanam Baloch|صنم بلوچ
Maya|مايا
Sohail Khan|سهيل خان
Uqbah ibn Amir|عقبه بن عامر
Viola Paulitz|Viola Müller-Paulitz
John Marshall|سر جان مارشل
Alla Rakha|الھه رکا
Deepika Kumari|ديپيڪا ڪماري
Solomon in Islam|سليمان عليہ السلام
Maryam Mirzakhani|مريم ميرزاخاني
Ibrahim Ismail Chundrigar|آءِ آءِ چندريگر
Zubaidah bint Ja`far|زبيده
Abd-Allah ibn Muhammad|عبد الله بن محمد
Abida Parveen|عابده پروين
Asko Parpola|آسڪو پارپولا
Abul-Fazl Bayhaqi|ابو الفضل بيھقي
Altaf Hussain|الطاف حسين
Edd Kalehoff|Edd Kalehoff
James Goldsmith|جيمز گولڊ سمٿ
Ibrahim ibn Muhammad|ابراهيم بن محمد
Rajnath Singh|راجناٿ سنگھ
Sudha Murthy|سوڌا مورتي
Nanda|نند
Muhammad Sarwar|ڪيپٽن محمد سرور شهيد
Abdul Hafiz Pirzada|عبدالحفيظ پيرزادو
Abdul Jabbar Junejo|عبدالجبار جوڻيجو
Adal Soomro|ادل سومرو
Adeebul Hasan Rizvi|ڊاڪٽر اديب رضوي
Adriaen Honich|Adriaen Honich
Amjad Hyderabadi|امجد حيدرآبادي
Anwar Solangi|انور سولنگي
Asghar Khan|اصغر خان
Badi' ud-Din Shah al-Rashidi|سيد بديع الدين شاھ راشدي
Binodini Dasi|بنودني داسي
Bridget Allchin|برجيٽ آلچن
Dodo Bin Khafef Soomro III|دودو بن خفيف سومرو ٽيون
Dulla Bhatti|دلا ڀٽي
Elsa Kazi|ايلسا قاضي
Eshita Mehboob|اشيتا محبوب
Farman Fatehpuri|فرمان فتح پوري
Haleem Brohi|حليم بروھي
Huma Bhabha|هما ڀاڀا
Hyder Bux Jatoi|حيدر بخش جتوئي
Ishrat Hussain Usmani|ڊاڪٽر آءِ ايڇ عثماني
Ishtiaq Hussain Qureshi|اشتياق حسين قريشي
Jam Unar|ڄام انڙ فيروزالدين
Liaquat Ali Jatoi|لياقت علي جتوئي
Nadeem Sarwar|سيد نديم رضا سرور
Long Jeanne Silver|لانگ جين سلور
Badshah Begum|بادشاھ بيگم (اول)
Mazhar Abro|مظهر ابڙو
Mir Ali Sir Thattvi|مير علي شير قانع ٺٽوي
Syed Muzafar Hussain Shah|مظفر حسين شاهه
Nasim Zehra|نسيم زهرا
Nau Nihal Singh|نو نهال سنگھ
Qadir Bux Bedil|فقير قادر بخش بيدل
Raziuddin Siddiqui|رضي الدين صديقي
Sahle-Work Zewde|سهالي ورڪ زيوڊي
Samyukta|سنجوگيتا
Teejan Bai|تيجن ٻائي
Tridev Roy|راجا تري ديو راءِ
Savitha Sastry|ساوٿا سيستري
Rawh ibn Hatim al-Muhallabi|روح بن حاتم مھلبي
Anicia Proba|Anicia Proba
Menaka Lalwani|مينيڪا لالواڻي
Jam Nizamuddin II|ڄام نظام الدين سمو
Parvathy Baul|پاروتي بول
Aleksandr Zakharchenko|اليگزينڊر زاخارچنڪو
Roshan Atta|روشن عطا
Waseem Akhtar|وسيم اختر
Syed Ayaz Ali Shah Sheerazi|اياز علي شاھ شيرازي
Jürg Stäubli|Jürg Stäubli
Rana Dajani|رانا دجاني
Jamshed Nusserwanjee Mehta|جمشيد نسروانجي مهتا
Jagjeet Singh|جگجيت سنگهه
Laksh Lalwani|لڪش لالواڻي
Jeevni Bai|جيوڻي ٻائي
Shadab Khan|شاداب خان
Kalyan Bulchand Advani|ڪلياڻ آڏواڻي
Shaikh Abdul Majeed Sindhi|شيخ عبدالمجيد سنڌي
Shamsher-ul-Hyderi|شمشير الحيدري
Hassan Dars|حسن درس
Ali Baba|علي بابا
|آغا عبدالحميد خان اسپتال
Mir Abdul Hussain Sangi|مير عبدالحسين
|نور محمد لاشاري
|امام راشدي
|عبدالوهاب سڪندري
|آدم خان پنهور
|رام ڪرشن ھيرانند راھي آڏواڻي
|آزاد انور ڪانڌڙو
|آزاد بخاري
|محمد رمضان آزاد
|آصف قاضي
|آغا شمشاد مغل
|شيخ موسيٰ آھيداڻي
|احمد ابڙو
|ابو علي سنڌي
|ابو البشير ميمڻ
|ابو القاسم نمڪين
|احسان علي
|احسان ايڇ نديم
Ahmad Raza Shah Jilani|احمد رضا شاھ جيلاني
|احمد علي شاھ
|احمد مجتبيٰ غالب
|اختر جھوناڳڙھي
|استاد ھدو خان
|اسدالله شاھ حسيني
|اسماعيل شيخ
|الطاف پيرزادو
|امام علي شاھ
|امام ضامن
|امجد شاھ جيلاني
|امر اقبال
|امر لعل ھنڱوراڻي
|مخدوم امين محمد ثاني ھالائي
|آغا حامد علي احمد زئي
|ابراهيم پتافي
|احسان علي شاھ
|امير بخاري
Alain de Chambrier|Alain de Chambrier
Saeed Ghani|سعيد غني
Shah Aqeeq Baba|شاھ عقیق بابا
Eusebio Calonge Francés|Eusebio Calonge Francés
Joaquín Pla Laporta|Joaquín Pla Laporta
Gaji Shah|سيد گاجي شاهه
|عبدالرحيم ڀرچونڊي
|حافظ محمد احسن چنا
|شبير ڪنڀار
Shaukat Shoro|شوڪت شورو
Jiten Lalwani|جتن لالواڻي
Tariq Masood Arain|طارق مسعود آرائين
Muhammad Sadiq Sanjrani|صادق سنجراڻي
Yashika Aannand|ياشيڪا آنند
Nazo Dharejo|نازو ڌاريجو
Jacopo Orsini|Jacopo Orsini
Kaleemullah Lashari|ڪليم الله لاشاري
Victor-Charles-Émile Dain|Victor-Charles-Émile Dain
Ilene Marckx|Ilene Marckx
Noora Mengal|نورا مينگل
Saloni Gaur|سلوني گور
Geeta Khanwani|گيتا کانواڻي
Mir Abdul Rasool Mir|مير عبدالرسول مير
|شهناز ڀٽي
Hyder Ali Leghari|حيدر علي لغاري
|فقير محمد سومرو
Lianne Witkin|Lianne Witkin
Pushpa Kumari Kohli|پشپا ڪماري ڪوهلي
Teodor Rusev|Teodor Rusev
Rokas Kmieliauskas|Rokas Kmieliauskas
Marc Oliver Pritzen|Marc Oliver Pritzen
Tsveta Nesheva|Tsveta Nesheva
Doreen Weise|Doreen Weise
Nele Van Den Bossche|Nele Van Den Bossche
Sandra Degueldre|Sandra Degueldre
Claudia Marietta|Claudia Marietta
Karry Ellen Hellmuth|Karry Ellen Hellmuth
Patricia Hempel|Patricia Hempel
Ann Roegiers|Ann Roegiers
Saskia Van Duuren|Saskia Van Duuren
Marieke Haverdings|Marieke Haverdings
Luisiana Pegoraro|Luisiana Pegoraro
Erika Schertl|Erika Schertl
Deira Mari|Deira Mari
Nadia Zuccherelli|Nadia Zuccherelli
Silvia Zoller|Silvia Zoller
Elfie Kunz|Elfie Kunz
Karin Avenant|Karin Avenant
Ljudmilla Corneo|Ljudmilla Corneo
Cornelia Dreher|Cornelia Dreher
Mārtiņš Bots|Mārtiņš Bots
Detelina Marinova|Detelina Marinova
Dawn Richardson Wilson|Dawn Richardson Wilson
Mike Evelyn|Mike Evelyn
Kenny Weyh|Kenny Weyh
Joyce Echaquan|Joyce Echaquan
Jimmy Wales|جمي ويلس
Adolf Hitler|هٽلر
Genghis Khan|چنگيز خان
Leonardo da Vinci|ليونارڊو ڊي ونچي
Mahatma Gandhi|موهنداس ڪرمچند گانڌي
Hafez|حافظ شيرازي
Christopher Columbus|ڪرسٽوفر ڪولمبس
Vasco da Gama|واسڪو ڊيگاما
Irène Joliot-Curie|آئرين جوليٽ ڪيوري
Vladimir Putin|ولاديمير پيوتن
Alexander the Great|سڪندر اعظم
Timur|تيمور لنگ
Thomas Alva Edison|ٿامس ايڊيسن
Ibn Khaldun|ابن خلدون
Gautama Buddha|گوتم ٻڌ
Dadabhai Naoroji|دادا ڀائي نائوروجي
Pythagoras|پئٿاگورس
Ibn al-Haytham|ابن ھيثم
Ibn Bajjah|ابن باجه
Esther David|ايستر ڊيوڊ
George Bernard Shaw|جارج برنارڊشا
Mir Qamar-ud-din Siddiqui, Chin Quilich  Khan, Nizam-ul-Mulk Asaf Jah|نواب آصف جاه
J. K. Rowling|جي .ڪي.رولنگ
Benedictus de Spinoza|برووخ اسپنوزا
Heinrich Heine|هينرڪ هائين
Oprah Winfrey|اوپرا ونفري
Muhammad ibn Abd al-Wahhab|محمد بن عبدالوهاب
Megawati Sukarnoputri|ميگا وتي سئڪارنو پوتري
Ruth Pfau|ڊاڪٽر رُٿ فائو
Niels Henrik Abel|نيئلس ھينرڪ ايبل
George Eliot|جارج ايليٽ
Rajneesh|اوشو
Deepika Padukone|ديپيڪا پدوڪون
Robert Clive|رابرٽ ڪلائيو
Al-Kindi|الڪندي
Margaret Mead|margret mead
Sheikh Mujibur Rahman|شيخ مجيب الرحمٰن
Ahmad ibn Hanbal|امام احمد بن حنبل
Edward Said|ايڊورڊ سعيد
Harsha|هرشورڌن
Gloria Gaynor|Gloria Gaynor
Muhammad al-Bukhari|امام بخاري
Al-Walid I|الوليد ابن عبد المالڪ
Liaquat Ali Khan|لياقت علي خان
Shahid Kapoor|شاهد ڪپور
Nusrat Bhutto|نصرت ڀٽو
Ibn Ishaq|ابن اسحاق
George Gissing|جارج گسنگ
Ahmad Faraz|احمد فراز
Fatima Jinnah|فاطمہ جناح
Jahanara Begum Sahib|جھان آرا بيگم
Kishore Kumar|ڪشور ڪمار
Fethullah Gülen|فتح الله گولن
Sultan Bahu|سلطان باھو
Aristobulus of Cassandreia|ارسطو بيولس
Muhammad Khan Junejo|محمد خان جوڻيجو
Abu'l-Faraj ibn al-Jawzi|ابن الجوزي
Lal Shahbaz Qalandar|لال شهباز قلندر
Atiqa Odho|عتيقه اوڍو
Qasem Soleimani|قاسم سليماني
Waraka ibn Nawfal|ورقا بن نوفل
Dr. Zakir Naik|ذاڪر نائيڪ
Kishore Mahbubani|किशोर महबूबानी
Malik Muhammad Jayasi|ملڪ محمد جائسي
Umm ul-Banin|ام البنين
Sergey Nikolayevich Lazarev|سرجي نيڪوولوچ لزاريف
Urvashi Butalia|اروشي بٽاليا
Yo Yo Honey Singh|يو يو هني سنگ
Ali Hujwiri|داتا گنج بخش
Hatim al-Tai|حاتم طائي
Manubhai Pancholi|منوڀائي پنچولي
Kate Grenville|ڪيٽ گرينول
Emraan Hashmi|عمران هاشمي
Rehmat Aziz Chitrali|رحمت عزیز چترالی
Syed Qaim Ali Shah|قائم علي شاهہ
Aitzaz Ahsan|اعتزاز احسن
Tarabai|تاراٻائي ڀوسلي
Ila Arun|ايلا ارون
Anarkali|انارڪلي
Reshma|ريشما
Ali Zafar|علي ظفر
Gurdas Maan|گرداس مان
Hadiqa Kiani|حديقه ڪياني
Hoshu Sheedi|هوش محمد شيدي
Ibrahim Zakzaky|شيخ ابراهيم زڪزڪي
Arif Yunus|عارف يونس
Abdul-Majid Bhurgri|عبدالماجد ڀرڳڙي
Abdullah Kadwani|عبدالله ڪڊواني
Adriaen Cornelisz Beeldemaker|Adriaen Cornelisz Beeldemaker
Aftab Shahban Mirani|آفتاب شعبان ميراڻي
Ahmad Hasan Dani|احمد حسن داني
Faqir Abdul Raheem Garhori|عبدالرحيم گرهوڙي
Imdad Ali Imam Ali Kazi|علامه آءِ آءِ قاضي
G. M. Syed|جي ايم سيد
Aiza Khan|عائزہ خان
Ali Muhammad Rashdi|علي محمد شاهه راشدي
Allama Ali Khan Abro|علامه علي خان ابڙِو
Annapurna Maharana|انا پرنا مھارانا
Asad Umer|اسد عمر
Babar Azam|بابر اعظم
Bano Qudsia|بانو قدسيه
Deen Mohammad|دين محمد وفائي
Elahi Bux Soomro|الاھي بخش سومرو
Ghous Ali Shah|غوث علي شاهه
Haseena Moin|حسينه معين
Akhtar Husain|ڊاڪٽر اختر حسين رائيپوري
Mir Bandeh Ali Khan Talpur|مير بنده علي خان ٽالپر
Muhammad Hafeez Qureshi|حفيظ قريشي
Nabi Bux Khan Baloch|نبي بخش خان بلوچ
Pir Ilahi Bux|پير الاھي بخش
Sabitri Chatterjee|سبيتري چيترجي
Sadruddin Hashwani|صدر الدين ھاشواڻي
Shah Inayat Shaheed|شاه عنايت
|شيخ حميدالدين ناگوري
Inayatullah Khan Mashriqi|علامہ عنايت الله مشرقي
Sucheta Dalal|سوچيتا دلال
Swaraj Prakash Gupta|ايس. پي. گپتا
Toru Dutt|تورو دت
Ubaidullah Sindhi|مولانا عبيدالله سنڌي
Umm Hakim bint Abdul Muttalib|بيضاء بنت عبد المطلب
'Awana ibn al-Hakam|حڪم بن عوانه ڪلبي
Jean-François Jarrige|زان فرانسوا جاريج
Zubaida Khanum|زبيده خانم
Tufail Niazi|طفيل نيازي
Belli Lalitha|بيلي لليٿا
Malini Awasthi|مالني اواسٿي
Asad Qaiser|اسد قیصر
Maia Makhateli|مايا مکاتلي
Thomas Velley|Thomas Velley
Ahmed Salim|احمد سليم
Sayyid Muhammad Al-Makki|سيد محمد مڪي
Ernest J. H. Mackay|ڊاڪٽر ارنيسٽ مئڪي
Sadiq Fakir|صادق فقير راڳي
Muhammad Mian Mansoor Ansari|مولانا منصور انصاري
Ashraf Abbasi|اشرف عباسي
Fazil Rahu|فاضل راهُو
Dirar ibn Abdul-Muttalib|ضراربن عبد المطلب
|آخوند احمد سانوڻي ھالائي
Mai Dhai|مائي ڌائي
Qandeel Baloch|قنديل بلوچ
Durr-e-Shahwar Syed|درشهوار سيد
Megha Akash|ميگها آڪاش
Qadir Bux Mitho|قادر بخش مٺو
Abdul Qadir Junejo|عبدالقادر جوڻيجو
|عزيز قاسماڻي
Taj Joyo|تاج جويو
|درويش محمد اسماعيل نظاماڻي
Taj Mahmood Amroti|مولانا تاج محمود امروٽي
|آغا ابراهيم شاهه
|آغا جان محمد خان
|ابراهيم خليل
|ابراهيم شاهه وڄڙي
|بدر ابڙو
|غلام ھالائي ابڙو
|ابو الحسن ڏاھري
|ابو العباس محمد بن محمد بن عبدالله وراق ديبلي
|اثير عبدالقادر شاھواڻي
|احمد بن محمد المنصوري
|احمد محمد قاضي
Akhtar Rind|اختر رند
Khalifa Muhammad Omar Waleed Khalifa Hafiz Abdulrahman Memon|اختر ھالائي
|استاد انور علي سانگي
|استاد امير علي خان
|استاد رسول بخش ڪلھوڙو
|استاد گامڻ خان
Ishaque Ahmed Ansari|اسحاق انصاري
|اسماعيل موندرو
Asghar Sindhi|اصغر سنڌي
|امام الدين ضامن
|امبر مھڪ
|امير بخش نظر سنڌي
|رفيق احمد انڍڙ
|محمد ملوڪ انڙ
|انور حسين صديقي
|انور ضياء عباسي
Anita Ghulam Ali|انيتا غلام علي
|اي. ايم. مسلم جيخانہ
|بابا نيڀراج
|باقر سنائي
|انور شاھ
sher miandad|شير ميانداد خان
Syed Abdullah Ali Shah|عبدالله شاهه
Sheema Kermani|شيما ڪرماني
Pablo Pintado|Pablo Pintado
Bodla Bahar|بودلو بهار
Abdullah Magsi|عبدالله مگسي
Nadir Alvarez|Nadir Alvarez
Arbab Zakaullah|ارباب ذڪاء الله
Frank Hauenschild|Frank Hauenschild
Sardar Ahmed Ali Khan Pitafi|احمد علي خان پتافي
Bahadur Khan Dahri|بھادر خان ڏاھري
Syed Nasir Hussain Shah|ناصر حسين شاهه
Fred Minnick|فريڊ منڪ
Manzoor Pashteen|منظور پشتین
Noor ul Huda Shah|نورالهدىٰ شاهه
Sylvia Hoffman|Sylvia Hoffman
Zainab Abbas|زينب عباس
Sayed Zulfiqar Abbas Bukhari|سيد ذلفي بخاري
Vasundhara Sirnate|وسنڌارا سرنيٽ
Natasha Badhwar|نتاشا بڌوار
Zeb-un-Nissa|زيب النسا (ڳائڻي)
Muhammad Siddique Musafir|محمد صديق مسافر
Liam Christie|Liam Christie
Keaan Van Venrooij|Keaan Van Venrooij
Cristina Michelle Mata Pitti|Cristina Michelle Mata Pitti
Nikola Levkov|Nikola Levkov
Virag Buzsaki|Virag Buzsaki
Jennifer Manefield|Jennifer Manefield
Caroline Payot-Podevin|Caroline Payot-Podevin
Rhonda Quick|Rhonda Quick
Letizia Giardinelli|Letizia Giardinelli
Valentina Poli|Valentina Poli
Maya Escolar|Maya Escolar
Simone Trafelet|Simone Trafelet
Tara Mulder|Tara Mulder
Cindy Bauwens|Cindy Bauwens
Gitana Gruodyte|Gitana Gruodyte
Ruth Ellway|Ruth Ellway
Moira Tarraran|Moira Tarraran
Carolyn Maxwell|Carolyn Maxwell
Juri Gatt|Juri Gatt
Ionuț Șișcanu|Ionuț Șișcanu
Natalia Jamróz|Natalia Jamróz
Sebastian Mitterer|Sebastian Mitterer
Phil Harres|Phil Harres
Jannis Maul|Jannis Maul
Barack Obama|بارڪ اوباما
Napoleon|نيپولين
Joseph Stalin|جوزف اسٽالن
Jawaharlal Nehru|جواهر لال نهرو
Michael Jackson|Michael Jackson
Miley Cyrus|مائلي سائرس
Larry Page|ليري پيج
Mustafa Kemal Atatürk|ڪمال اتاترڪ
Bill Gates|بل گيٽس
Voltaire|والٽئر
Al-Ghazali|امام غزالي
Andrew Cuomo|آندريو ڪيومو
Al-Biruni|البيروني
Maxim Gorki|ميڪسم گورڪي
Linus Torvalds|لينس ٽورويلڊس
Abdullah ibn Abdul-Muttalib|عبد الله بن عبد المطلب
Benazir Bhutto|بينظير ڀٽو
Friedrich Engels|فريڊرڪ اينگلس
Francis Bacon|فرانسس بيڪن
Emiliano Zapata|ايميليانو زاپاٽا
Khadija bint Khuwaylid|خديجه بنت خويلد
Rambhadracharya|رامڀڌرآچاريه
Vishwas Patil|وشواس پاٽيل
Anand Yadav|آنند يادو
Raja Pervaiz Ashraf|راجا پرویز اشرف
Sharon Stone|شيرون اسٽون
Stefan Zweig|اسٽيفن زويگ
John Keats|جان ڪيٽس
Empedocles|ايمپيڊوڪليز
Russell Crowe|رسل ڪرو
Amrita Sher-Gil|امريتا شير-گل
Iskander Mirza|اسڪندر مرزا
Lope de Vega|لوپ دي ويگا
Al-Masudi|ابو الحسن مسعودي
Batu Khan|باتو خان
Hasan ibn Ali|حسن ابن علي
Felipe VI of Spain|فيليپي ششم
Muhammad ibn Jarir al-Tabari|ابن جریر طبری
Nader Shah|نادر شاھ
Carrie Underwood|ڪيِري اَنڊَروُڊ
Rāhula|راهل
Jenny Shipley|جيني شپلي
Bilawal Bhutto Zardari|بلاول ڀٽو زرداري
Ameesha Patel|اميشا پٽيل
Eli Whitney|ايلاء وٽني
Abu Talib ibn ‘Abd al-Muttalib|ابو طالب
Marwan I|مروان ابن حاڪم
Nusrat Fateh Ali Khan|استاد نصرت فتح علي خان
Nasir al-Din al-Tusi|ابو جعفر طوسي
Muhammad al-Baqir|محمد باقر
C. Wright Mills|رائٽ ملز
Giovanni Pisano|جيوواني پيزانو
Elon Musk|ايلون مسڪ
Ranjit Singh Sandhu|رنجيت سنگھ
Duleep Singh|دليپ سنگھ
Abu Dawood|امام ابو دائود
Ashraf Ali Thanwi|مولانا اشرف علي ٿانوي
Aga Khan III|آغا خان ٽيون
Alexander Burnes|اليگزينڊر برنس
Rebel Wilson|ريبل ولسن
Ibn Hišām|عبدالملڪ بن ھشام
Annie Besant|ايني بيسنت
Ismail in Islam|اسماعيل عليہ السلام
Ebn Meskavayh|ابن مسڪويہ
Zhou Youguang|چائو يو گوانگ
Ansar Burney|انصار برني
Ernst Stojaspal|Ernst Stojaspal
Shibli Nomani|علامه شبلي نعماني
Babur|بابر بادشاهه
Sigmund Schenkling|سگمنڊ فرائيڊ
Henry Bartle Frere|بارٽل فريئر
Muhammad Husain Azad|محمد حسين آزاد
Zaynab bint Muhammad|زينب بنت محمد
Nergis Mavalvala|نرگس ماولوالا
Ramla bint Abi Sufyan|ام حبيبه
Ibn al-Faqih|ابن فقيھہ
Job in Islam|ايوب عليہ السلام
Amrita Singh|امرتا سنگھ
Qusai ibn Kilab|قصي
Emetullah Rabia Gülnûş Sultan|رابعه گلنوش سلطان
Bholabhai Patel|ڀولاڀائي پٽيل
Raghuveer Chaudhari|رگھووير چوڌري
Imrat Khan|امرت خان
Farid-ud-din Ganj Shakar|بابا فريد الدين گنج شڪر
Juan de Arespacochaga|Juan de Arespacochaga
Shoaib Malik|شعيب ملڪ
Zarina Wahab|زرينا وهاب
Hakim Ajmal Khan|حڪيم اجمل خان
Mushtaq Ahmad Yusufi|مشتاق احمد يوسفي
Hari Singh Nalwa|ھري سنگھ نلوه
Elīza Tīruma|Elīza Tīruma
Fatima Bhutto|فاطمه ڀٽو
Al-Qàssim ibn Issa|ابو دلف
Aarathi|آرتي (اداڪاره)
Abdul Rahim Nagori|عبدالرحيم ناگوري
Abol Hassan Ispahani|ابوالحسن اصفهاني
Allah Bux Soomro|الله بخش سومرو
Allah Jilai Bai|اللہ جلئي ٻائي
Aisha|عائشه
Arfana Mallah|عرفانه ملاح
Barkat Ali Khan|برڪت علي خان
Bebe Nanaki|بيبي نانڪي
Bedar Mnagrio|بيدار مڱريو محمد پريل
Dada Lekhraj|ﺩﺍﺩﺍ ﻟﻴﮑﺮﺍﺝ
Fahmida Hussain|ڊاڪٽر فهميده حسين
Farooq Sheikh|فاروق شيخ
Gopal Rai|گوپال راءِ ديشمک
Halimah Yacob|حليمہ بنت يعقوب
Hassam-ud-Din Rashidi|حسام الدين راشدي
Hayme Hatun|خيما خاتون
J. B. H. Wadia|جمشيد واڊيا
Jam Saqi|ڄام ساقي
Jamal Abro|جمال ابڙو
Kharak Singh|کڙڪ سنگھ
Mai Bhaghi|مائي ڀاڳي
Makhdoom Muhammad Zaman Talib-ul-Mola|طالب الموليٰ
|محمد ارشد القادري
Mian Ghulam Shah Kalhoro|ميان غلام شاهه
Abul Lais Siddiqui|پروفيسر ڊاڪٽر ابوالليث صديقي
Muhammad Ayub Khuhro|محمد ايوب کھڙو
Muhammad Ibrahim Joyo|محمد ابراهيم جويو
Nadia Gamal|ناديہ جمال
Qazi Fazlullah Ubaidullah|قاضي فضل الله
Riad Higazy|رياض حجازي
Roshan Ara Begum|روشن آرا
Sanam Marvi|صنم ماروي
Shafi Inamdar|شفيع انعامدار
Shahid Khaqan Abbasi|شاهد خاقان عباسي
Shaikh Ayaz|شيخ اياز
Shaina NC|شائينا نانا چوداساما
Shoma Chaudhury|شوما چوڌري
Tahira Syed|طاهره سيد
Tariq Jameel|طارق جميل
Tehmina Janjua|تهمينا جنجوعا
Usman Ali Isani|عثمان علي عيساڻي
Yar Muhammad Kalhoro|يار محمد ڪلهوڙو
Yousuf Salahuddin|يوسف صلاح الدين
Muhammad al-Mahdi.|محمد المھدي
Henry George Raverty|ايڇ. جي. راورٽي
Kamran Mirza|ڪامران مرزا
Azhar Ali|اظھر علي
Nalini Malani|ناليني ملاڻي
|حامد رضا
Abu Bakr Ahmad Haleem|پروفيسر ابوبڪر احمد حليم
Pedrito Martinez|Pedrito Martínez
Fatima Sana Shaikh|فاطما ثنا شيخ
Sajjad Shar|سجاد شر
Indira Kanwar|اندرا ڪنور
Nani Gopal Majumdar|اين. جي. مجمدار
Motilal Jotwani|موتي لال جوتواڻي
Bakhtawar Zardari Bhutto|بختاور ڀٽو زرداري
Alan Kurdi|آلان ڪردي
Akhtar Ali Ghulam Kazi|اختر علي جي قاضي
Quthum ibn Abdul-Muttalib|قثم بن عبد المطلب
Nikola Tvrtković|Nikola Tvrtković
Nadia Murad Basee|ناديه مراد
Agha Saleem|آغا سليم
Sikandar Ali Jogi|سڪندر علي جوڳي
José María Mendoza Ussía|José María Mendoza Ussía
Hakeem Fateh Mohammad Sehwani|فتح محمد سيوهاڻي
Mohammad Khan Majeedi|محمد خان مجيدي
Peter Schuchert|Peter Schuchert
|خير النساء جعفري
|نادر بيگ مرزا
|سجاد حيدر يلدرم
|مير فتح علي شاه
|عبدالرزاق سومرو
|نصرت ابڙو
|ممتاز بخاري
Zafar Kazmi|ظفر ڪاظمي
|آغا عبدالنبي عليگ
Ghulam Mustafa Abu|غلام مصطفيٰ ابڙو
|ابو البقا بکري
|ابو البقا
|مرزا اجمل بيگ
|احمد ابراھيم
|احمد خان اختر
|احمد خان گويو
|استاد مبارڪ علي خان
|اسحاق منڱريو
|اسلام ۽ عقليات
|اسماعيل راھو
Iqbal Jogi|اقبال جوڳي
|اقبال دل
|امام بخش امام زرداري
|امام بخش شاھ فدوي
Amjad Siraj|امجد سراج ميمڻ
|امر لغاري
|انور ھالائي
|بابا حاجي مير محمد
|بابا رامداس
|آزاد صوفي
|آزاد صوفي
Agha Siraj Khan Durrani|آغا سراج دراني
|ڪيهر شوڪت
|اختر انصاري اڪبر آبادي
Aziz Kingrani|عزيز ڪنگراڻي
José López Zanón|José López Zanón
Juan de Haro Piñar|Juan de Haro Piñar
Lucky Shah Sadar|لڪي شاھ صدر
Giovanni Battista Tocci|Giovanni Battista Tocci
Gaston Lecreux|Gaston Lecreux
Yasmine Gooneratne|ياسمين گوناريٽ
Ahed Al-Tamimi|عهد التميمي
Mian Ghulam Siddique Mekan|ميان غلام صديق
Prem Nath Bazaz|پريم ناٿ بزاز
Imran Ismail|عمران اسماعيل
Colin Huang|ڪولن ھئانگ
Mangla Sharma|منگلا شرما
Ayaz Gul|اياز گل
Naseem Thebo|نسيم ٿيٻو
Mumtaz Rashidi|ممتاز راشدي
Fakir Muhammad Lashari|فقير محمد لاشاري
Asad Ali Palijo|اسد علي پليجو
Luciano Méndez|Luciano Méndez
Anila Naz Soomro|انيلا ناز سومرو
Alekss Krasts|Alekss Krasts
Panagiotis Christopoulos-Cheller|Panagiotis Christopoulos-Cheller
Anastasios Kourmpetis|Anastasios Kourmpetis
Neftali Martinez|Neftali Martinez
Julie Hutsebaut|Julie Hutsebaut
Marina Khodchenkova|Marina Khodchenkova
Clarissa Breuer|Clarissa Breuer
Alena Popadova|Alena Popadova
Caroline Orens|Caroline Orens
Elisa Neri|Elisa Neri
Negringa Raudonite|Negringa Raudonite
Laurence Restoin|Laurence Restoin
Deborah Geentjens|Deborah Geentjens
Delphine Deschamps|Delphine Deschamps
Marie Kolarikova|Marie Kolarikova
Natascha Klewitz|Natascha Klewitz
Jozef Hušla|Jozef Hušla
Krists Lindenblats|Krists Lindenblats
Jung Hyun-woo|Jung Hyun-woo
Dominic Meinel|Dominic Meinel
